time,edge,old node,current node,probability (value_exp),value_coeff,expect,true,expect-true,no.of neighbours
32,13to14,13,14,0.25,0,32,32,0,4
47,14to9,14,9,0.333333333333333,0,47,47,0,3
62,9to4,9,4,0.333333333333333,0,62,62,0,3
78,4to3,4,3,0.5,0,78,78,0,2
95,3to2,3,2,0.301426203451853,-0.147368421052632,95,81,14,3
111,2to1,2,1,0.333333333333333,0,111,111,0,3
128,1to6,1,6,0.333333333333333,0,128,128,0,3
144,6to11,6,11,0.119787330657796,-0.895833333333333,144,15,129,4
161,11to16,11,16,0.142550683308543,-0.695652173913043,161,49,112,4
177,16to21,16,21,0.25,0,177,177,0,4
193,21to20,21,20,0.333333333333333,0,193,193,0,3
209,20to15,20,15,0.2852309486652,-0.91866028708134,209,17,192,2
226,15to10,15,10,0.186652743762172,-0.778761061946903,226,50,176,3
242,10to5,10,5,0.204494539795657,-0.665289256198347,242,81,161,3
258,5to0,5,0,0.333333333333333,0,258,258,0,3
275,0to1,0,1,0.5,0,164,164,0,2
292,1to2,1,2,0.333333333333333,0,197,197,0,3
308,2to7,2,7,0.312050633619721,-0.097402597402597,308,278,30,3
324,7to8,7,8,0.224333722475677,-0.141975308641975,324,278,46,4
340,8to13,8,13,0.222887314759831,-0.150306748466258,326,277,49,4
355,13to18,13,18,0.210627442743673,-0.222535211267606,355,276,79,4
371,18to19,18,19,0.133599381664422,-0.77088948787062,371,85,286,4
386,19to24,19,24,0.198163798917894,-0.704663212435233,386,114,272,3
401,24to23,24,23,0.345607408683186,-0.638403990024938,401,145,256,2
418,23to22,23,22,0.219718107473786,-0.574162679425837,418,178,240,3
434,22to17,22,17,0.285641076479146,-0.223502304147465,434,337,97,3
451,17to12,17,12,0.25,0,451,451,0,4
466,12to11,12,11,0.25,0,322,322,0,4
482,11to6,11,6,0.142543735186366,-0.878531073446328,354,43,311,4
498,6to5,6,5,0.169956053958058,-0.70703125,256,75,181,4
514,5to10,5,10,0.333333333333333,0,288,288,0,3
531,10to15,10,15,0.397752730102172,0,322,322,0,3
547,15to10,15,10,0.186652743762172,-0.778761061946903,33,33,0,3
564,10to15,10,15,0.397752730102172,0,33,33,0,3
579,15to20,15,20,0.396092061151014,-0.044041450777202,386,369,17,3
595,20to21,20,21,0.690792678252811,-0.114832535885167,418,370,48,2
609,21to16,21,16,0.333333333333333,0,448,448,0,3
624,16to17,16,17,0.25,0,190,190,0,4
641,17to18,17,18,0.25,0,286,286,0,4
657,18to13,18,13,0.201909182352093,-0.473186119873817,317,167,150,4
673,13to14,13,14,0.116752100859514,-0.993759750390016,641,4,637,4
688,14to9,14,9,0.169797522439255,-0.893915756630265,641,68,573,3
703,9to4,9,4,0.245899213234262,-0.427457098283931,641,367,274,3
718,4to3,4,3,0.311029112442666,-0.7953125,640,131,509,2
734,3to8,3,8,0.213717178994976,-0.680487804878049,410,131,279,3
750,8to7,8,7,0.200076151029953,-0.334841628959276,442,294,148,4
766,7to2,7,2,0.227908823918373,-0.166666666666667,474,395,79,4
782,2to1,2,1,0.29515372800959,-0.224852071005917,507,393,114,3
799,1to6,1,6,0.333333333333333,0,317,317,0,3
814,6to5,6,5,0.169956053958058,-0.70703125,316,316,0,4
831,5to0,5,0,0.27824532955537,-0.260034904013962,573,424,149,3
846,0to1,0,1,0.5,0,64,64,0,2
863,1to2,1,2,0.333333333333333,0,97,97,0,3
879,2to3,2,3,0.369573043742644,0,161,161,0,3
895,3to4,3,4,0.42205741207084,0,192,192,0,3
910,4to9,4,9,0.688970887557334,0,222,222,0,2
927,9to14,9,14,0.200371108769867,-0.881889763779527,254,30,224,3
942,14to19,14,19,0.225729557742504,-0.889667250437828,571,63,508,3
959,19to18,19,18,0.358005569596234,-0.182389937106918,318,260,58,3
974,18to23,18,23,0.180431979897506,-0.778359511343804,573,127,446,4
990,23to24,23,24,0.225053665186266,-0.789735099337748,604,127,477,3
1004,24to19,24,19,0.654392591316814,0,62,62,0,2
1021,19to14,19,14,0.429636061159366,0,94,94,0,3
1037,14to13,14,13,0.531854157523722,-0.071052631578947,380,353,27,3
1053,13to14,13,14,0.116752100859514,-0.993759750390016,32,32,0,4
1068,14to9,14,9,0.230193823660052,-0.912903098402417,158,155,3,3
1084,9to8,9,8,0.329015824400732,-0.648571428571429,350,123,227,3
1099,8to7,8,7,0.115449307697673,-0.98527142838621,349,122,227,4
1115,7to12,7,12,0.262482006551724,-0.034638554216868,664,641,23,4
1130,12to11,12,11,0.179417489107875,-0.421686746987952,664,384,280,4
1148,11to10,11,10,0.267566104407843,-0.357737104825291,601,386,215,4
1163,10to15,10,15,0.315664332343917,-0.358931552587646,599,384,215,3
1179,15to20,15,20,0.313578579879036,-0.405708117443869,600,383,217,3
1194,20to21,20,21,0.608630041644517,-0.47710298663642,599,382,217,2
1210,21to20,21,20,0.333333333333333,0,31,31,0,3
1225,20to15,20,15,0.391369958355483,-0.91866028708134,62,62,0,2
1242,15to16,15,16,0.423270488824444,-0.191153238546603,633,512,121,3
1259,16to21,16,21,0.25,0,65,65,0,4
1274,21to20,21,20,0.333333333333333,0,64,64,0,3
1289,20to15,20,15,0.391369958355483,-0.91866028708134,64,64,0,2
1306,15to10,15,10,0.235192329957637,-0.778761061946903,158,158,0,3
1322,10to5,10,5,0.161947596268924,-1.11410815383614,508,280,228,3
1339,5to6,5,6,0.271262824351991,-0.416666666666667,540,315,225,3
1355,6to1,6,1,0.251521599601866,-0.447937131630648,509,281,228,4
1371,1to0,1,0,0.246871221640913,-0.422222222222222,540,312,228,3
1386,0to5,0,5,0.338077124150006,-0.671875,64,21,43,2
1403,5to10,5,10,0.31198626331693,-0.432989690721649,97,55,42,3
1419,10to11,10,11,0.327000400833524,-0.695501730103806,289,88,201,3
1434,11to12,11,12,0.309093284327453,-0.326018808777429,319,215,104,4
1449,12to17,12,17,0.152362258823217,-0.739393939393939,825,215,610,4
1464,17to22,17,22,0.130786406617965,-0.795411089866157,1046,214,832,4
1479,22to23,22,23,0.357179461760427,0,505,505,0,3
1495,23to18,23,18,0.391176594236493,-0.425373134328358,536,308,228,3
1511,18to13,18,13,0.185616562984264,-0.825506794979302,474,307,167,4
1527,13to8,13,8,0.169393199729724,-0.81489841986456,443,82,361,4
1542,8to3,8,3,0.157093374640696,-0.8763197586727,663,82,581,4
1558,3to4,3,4,0.232872623135444,-0.877828054298642,663,81,582,3
1573,4to9,4,9,0.488434148926972,-0.841584158415841,505,80,425,2
1590,9to14,9,14,0.124349156662467,-1.79064209152627,537,49,488,3
1605,14to19,14,19,0.114509969289308,-1.75821966308342,601,79,522,3
1620,19to24,19,24,0.2123583692444,-0.704663212435233,630,630,0,3
1637,24to23,24,23,0.345607408683186,-0.638403990024938,158,158,0,2
1654,23to22,23,22,0.337096608234656,-0.574162679425837,190,190,0,3
1671,22to21,22,21,0.353842738093738,-0.014563106796117,412,406,6,3
1687,21to16,21,16,0.314150158595076,-0.087640449438202,445,406,39,3
1702,16to15,16,15,0.246385654636297,-0.019370460048426,413,405,8,4
1718,15to20,15,20,0.341537181217918,-0.405708117443869,444,444,0,3
1734,20to21,20,21,0.608630041644517,-0.47710298663642,63,63,0,2
1749,21to22,21,22,0.342924920702462,0,95,95,0,3
1764,22to17,22,17,0.146369685959939,-1.07747055811572,315,46,269,3
1781,17to12,17,12,0.158558644067504,-0.772334293948127,347,79,268,4
1795,12to17,12,17,0.152362258823217,-0.739393939393939,31,31,0,4
1811,17to18,17,18,0.167347912485001,-0.955696202531646,316,14,302,4
1828,18to13,18,13,0.080807213650375,-1.77818818299192,317,15,302,4
1844,13to8,13,8,0.125291662477499,-1.16821072270368,317,205,112,4
1860,8to7,8,7,0.073193325653356,-1.7158890367962,761,205,556,4
1877,7to2,7,2,0.147969018930717,-0.709072978303747,1014,464,550,4
1893,2to1,2,1,0.279550660246316,-0.301060249444579,538,497,41,3
1910,1to0,1,0,0.246871221640913,-0.422222222222222,539,539,0,3
1926,0to5,0,5,0.338077124150006,-0.671875,540,540,0,2
1943,5to6,5,6,0.211367027534339,-0.966335540838852,604,272,332,3
1959,6to11,6,11,0.104404698716188,-1.39212962962963,540,272,268,4
1974,11to10,11,10,0.299443222806561,-0.357737104825291,571,571,0,4
1990,10to15,10,15,0.265083100078436,-1.20962599703209,288,43,245,3
2005,15to16,15,16,0.23497468748442,-1.06222242093654,318,41,277,3
2020,16to21,16,21,0.151669344393577,-0.629370629370629,286,106,180,4
2037,21to22,21,22,0.237909377093822,-0.513888888888889,288,140,148,3
2052,22to23,22,23,0.295731532982991,-0.585542168674699,415,172,243,3
2069,23to24,23,24,0.178094815781125,-1.33316494343574,449,205,244,3
2084,24to19,24,19,0.533247065138865,-0.505219206680585,479,237,242,2
2100,19to14,19,14,0.319966795527487,-0.470588235294118,510,270,240,3
2116,14to13,14,13,0.618828960541521,-0.071052631578947,288,288,0,3
2131,13to18,13,18,0.32256989151805,-0.222535211267606,320,320,0,4
2147,18to17,18,17,0.352161709350091,-0.522727272727273,352,168,184,4
2163,17to12,17,12,0.125924690030358,-1.32992591698478,382,169,213,4
2178,12to7,12,7,0.225738428015756,-0.474842767295598,318,167,151,4
2196,7to8,7,8,0.260890450666286,-0.141975308641975,352,352,0,4
2214,8to9,8,9,0.388761647284424,-0.076443057722309,641,592,49,4
2230,9to4,9,4,0.468216042484099,-0.498885669712503,672,624,48,3
2246,4to3,4,3,0.494167610975724,-0.864914772727273,704,655,49,2
2265,3to2,3,2,0.483451623705829,-0.147368421052632,388,388,0,3
2283,2to1,2,1,0.279550660246316,-0.301060249444579,390,390,0,3
2299,1to6,1,6,0.322979763921023,-0.235955056179775,356,272,84,3
2315,6to5,6,5,0.162050406136924,-1.00780245822622,389,272,117,4
2330,5to0,5,0,0.428331199170619,-0.260034904013962,420,420,0,3
2349,0to1,0,1,0.661922875849994,0,66,66,0,2
2365,1to2,1,2,0.209425932215825,-0.96,100,4,96,3
2384,2to7,2,7,0.1655739501061,-1.06342201487833,206,7,199,3
2399,7to12,7,12,0.29045171364563,-0.034638554216868,236,236,0,4
2415,12to11,12,11,0.193988898298737,-0.682651659268654,456,337,119,4
2433,11to10,11,10,0.261247817815827,-0.547279588485422,459,372,87,4
2448,10to15,10,15,0.216515419397417,-1.47600154288362,458,336,122,3
2464,15to20,15,20,0.323154556191577,-0.956646455245477,746,335,411,3
2480,20to21,20,21,0.542352809784017,-0.748842117071202,460,335,125,2
2495,21to16,21,16,0.322966987395429,-0.271313918825957,490,400,90,3
2511,16to17,16,17,0.267579569234206,-0.085164835164835,364,333,31,4
2527,17to22,17,22,0.174984157166529,-1.05051313068248,490,365,125,4
2543,22to23,22,23,0.220488898188131,-0.980654184967978,491,297,194,3
2558,23to18,23,18,0.367723911456049,-0.732164703415009,427,296,131,3
2575,18to19,18,19,0.226318198055136,-1.02954529235127,491,364,127,4
2593,19to14,19,14,0.240216974653677,-0.86815415821501,493,297,196,3
2609,14to13,14,13,0.538412141812109,-0.401681434824383,493,330,163,3
2624,13to12,13,12,0.244816756106797,-0.733333333333333,225,60,165,4
2641,12to7,12,7,0.112843926489794,-1.37756650270416,257,25,232,4
2658,7to8,7,8,0.12077956867116,-1.08569825236492,462,26,436,4
2674,8to9,8,9,0.198451805613726,-1.01992131859187,460,26,434,4
2689,9to4,9,4,0.254449608519381,-1.44659808801316,459,24,435,3
2705,4to3,4,3,0.274238818624797,-1.8148058402654,459,23,436,2
2721,3to2,3,2,0.267522504384044,-1.08837965700769,356,21,335,3
2737,2to1,2,1,0.175275901292379,-1.25209117727963,388,19,369,3
2753,1to6,1,6,0.225855327836241,-1.19410483591546,454,19,435,3
2769,6to5,6,5,0.12706176663577,-1.29194342738922,454,325,129,4
2786,5to6,5,6,0.211367027534339,-0.966335540838852,33,33,0,3
2803,6to7,6,7,0.462486213139483,0,162,162,0,4
2819,7to12,7,12,0.345511813751996,-0.034638554216868,195,195,0,4
2835,12to13,12,13,0.447453304685956,0,226,226,0,4
2851,13to18,13,18,0.213507552757688,-1.15427582560208,293,20,273,4
2866,18to17,18,17,0.352219321950237,-0.624135723431498,355,319,36,4
2881,17to16,17,16,0.33161909216032,-0.702072538860104,386,115,271,4
2897,16to11,16,11,0.17026116829072,-0.695020746887967,482,147,335,4
2913,11to10,11,10,0.249756807001383,-0.607696255152089,480,451,29,4
2929,10to5,10,5,0.310926066365534,-1.11410815383614,160,160,0,3
2944,5to0,5,0,0.390159091627108,-0.41801536004002,614,517,97,3
2959,0to1,0,1,0.661922875849994,0,222,222,0,2
2975,1to2,1,2,0.285430762882906,-0.96,254,254,0,3
2992,2to3,2,3,0.613053672084048,0,287,287,0,3
3008,3to2,3,2,0.267522504384044,-1.08837965700769,33,33,0,3
3023,2to3,2,3,0.613053672084048,0,31,31,0,3
3039,3to8,3,8,0.402258752087029,-0.680487804878049,381,381,0,3
3055,8to13,8,13,0.420744277185371,-0.363943112102621,220,173,47,4
3071,13to14,13,14,0.159224194932334,-1.56279740729378,478,206,272,4
3087,14to9,14,9,0.322919370832439,-0.912903098402417,413,413,0,3
3104,9to4,9,4,0.254449608519381,-1.44659808801316,415,415,0,3
3119,4to3,4,3,0.274238818624797,-1.8148058402654,96,96,0,2
3134,3to8,3,8,0.402258752087029,-0.680487804878049,95,95,0,3
3149,8to7,8,7,0.108861812949723,-1.7158890367962,346,346,0,4
3165,7to6,7,6,0.35768953520286,0,379,379,0,4
3181,6to1,6,1,0.153015063761165,-1.29027947397299,222,35,187,4
3197,1to0,1,0,0.31424878986636,-1.15740008783487,253,67,186,3
3213,0to5,0,5,0.210272531544131,-1.32328345070423,284,99,185,2
3229,5to10,5,10,0.257974136823419,-1.01843272869633,316,131,185,3
3246,10to15,10,15,0.110999131958521,-2.27048775842247,798,164,634,3
3263,15to20,15,20,0.183884069653252,-1.70758512858715,799,199,600,3
3279,20to21,20,21,0.368520924937101,-1.45722759892352,799,233,566,2
3294,21to22,21,22,0.166604232912764,-1.04322396059684,767,361,406,3
3311,22to23,22,23,0.097981986904909,-1.93768543496798,768,33,735,3
3329,23to24,23,24,0.089228530760447,-2.27999034026114,1260,67,1193,3
3345,24to19,24,19,0.323672530051498,-1.37534907681045,770,100,670,2
3361,19to18,19,18,0.276659345406001,-1.05101738808731,510,67,443,3
3377,18to17,18,17,0.185702074084725,-1.49302026354891,511,67,444,4
3393,17to16,17,16,0.154862071330329,-1.6981662888601,512,2,510,4
3411,16to11,16,11,0.074900652112375,-1.62498183638213,514,36,478,4
3427,11to12,11,12,0.176662927605543,-1.1615451245669,608,100,508,4
3444,12to13,12,13,0.447453304685956,0,389,389,0,4
3460,13to8,13,8,0.202675315852786,-1.36452974110858,326,262,64,4
3475,8to7,8,7,0.063301956136257,-2.3079135766735,326,133,193,4
3492,7to6,7,6,0.234740083474356,-0.596330275229358,327,132,195,4
3507,6to1,6,1,0.153015063761165,-1.29027947397299,326,326,0,4
3522,1to2,1,2,0.314509677598261,-1.26155642023346,514,359,155,3
3538,2to3,2,3,0.578003222734784,-0.145584725536993,419,358,61,3
3555,3to4,3,4,0.330218743528927,-0.877828054298642,451,451,0,3
3572,4to9,4,9,0.670702928180373,-1.10343982851893,485,358,127,2
3587,9to14,9,14,0.139203280220404,-2.09878162640999,516,357,159,3
3603,14to13,14,13,0.538412141812109,-0.401681434824383,159,159,0,3
3619,13to12,13,12,0.381000877040594,-0.733333333333333,192,192,0,4
3634,12to17,12,17,0.213615623001888,-0.739393939393939,257,257,0,4
3650,17to22,17,22,0.210532506590142,-1.50556931045776,356,194,162,4
3666,22to21,22,21,0.552649631451981,-0.513271117132034,387,194,193,3
3682,21to20,21,20,0.379227530469258,-0.384248210023866,419,258,161,3
3700,20to15,20,15,0.49257188993074,-1.48694222540733,454,196,258,2
3717,15to10,15,10,0.323759549571097,-1.37712171768461,488,196,292,3
3733,10to5,10,5,0.225538670597565,-1.74103123075922,520,194,326,3
3749,5to0,5,0,0.316983703216458,-1.0665660846777,552,194,358,3
3765,0to1,0,1,0.721354519570944,-0.372093023255814,258,162,96,2
3781,1to6,1,6,0.336455679905451,-1.19410483591546,289,289,0,3
3799,6to7,6,7,0.556026439665003,0,324,324,0,4
3814,7to12,7,12,0.411648815085058,-0.034638554216868,195,195,0,4
3830,12to13,12,13,0.309753035873842,-0.590308370044053,227,93,134,4
3846,13to18,13,18,0.250099586563921,-1.15427582560208,485,485,0,4
3863,18to23,18,23,0.199938391760802,-1.67328704757569,552,58,494,4
3879,23to22,23,22,0.491287011024876,-0.574162679425837,229,229,0,3
3896,22to21,22,21,0.552649631451981,-0.513271117132034,230,230,0,3
3912,21to16,21,16,0.38057795156753,-0.45435823481825,519,424,95,3
3929,16to17,16,17,0.193282177807333,-0.891944496181784,295,57,238,4
3944,17to18,17,18,0.34615917153914,-1.03732885559287,98,90,8,4
3959,18to19,18,19,0.216140372411606,-1.83084822394736,614,122,492,4
3974,19to24,19,24,0.230553341896718,-1.46745391010965,645,153,492,3
3992,24to19,24,19,0.323672530051498,-1.37534907681045,33,33,0,2
4009,19to14,19,14,0.327542111314161,-1.26388875537141,422,255,167,3
4024,14to9,14,9,0.27699548789639,-1.13192964707498,452,353,99,3
4040,9to8,9,8,0.356974125571397,-1.61581280788177,580,19,561,3
4056,8to3,8,3,0.207679082029697,-1.19485257720552,518,353,165,4
4072,3to4,3,4,0.275988262413097,-1.1350814392116,517,384,133,3
4087,4to9,4,9,0.623637572764242,-1.30978903486814,63,50,13,2
4103,9to14,9,14,0.14892952856764,-2.57750503066531,94,49,45,3
4119,14to19,14,19,0.084733061847241,-2.38814092292594,127,47,80,3
4136,19to18,19,18,0.212361787742805,-1.97810072142064,192,14,178,3
4153,18to13,18,13,0.102093175239777,-2.73174855450895,323,15,308,4
4168,13to12,13,12,0.273521709989261,-1.22485875706215,354,180,174,4
4185,12to11,12,11,0.16030611835284,-1.40616587115496,774,214,560,4
4203,11to10,11,10,0.307382353123649,-0.607696255152089,486,486,0,4
4219,10to15,10,15,0.088438417382031,-2.7271351572664,519,282,237,3
4235,15to16,15,16,0.411774082881853,-1.19225338068886,323,281,42,3
4253,16to21,16,21,0.247648149502932,-0.648978472507884,357,350,7,4
4268,21to20,21,20,0.314863079325718,-0.790391554733764,586,348,238,3
4284,20to15,20,15,0.49257188993074,-1.48694222540733,65,65,0,2
4301,15to10,15,10,0.342272265890649,-1.37712171768461,98,98,0,3
4316,10to5,10,5,0.237083022930495,-1.74103123075922,583,583,0,3
4332,5to6,5,6,0.178236155947664,-1.87740632123813,551,49,502,3
4349,6to7,6,7,0.361773147311871,-0.792727272727273,550,114,436,4
4366,7to2,7,2,0.100508264579421,-1.57400188825635,844,114,730,4
4381,2to3,2,3,0.491723121012419,-0.4932770332293,325,212,113,3
4397,3to8,3,8,0.317870033936199,-1.18188836510214,357,178,179,3
4413,8to13,8,13,0.476707682692167,-0.363943112102621,260,260,0,4
4429,13to18,13,18,0.293525326999963,-1.15427582560208,293,293,0,4
4444,18to17,18,17,0.179260823671265,-2.40564162277222,515,45,470,4
4461,17to22,17,22,0.098925918205863,-2.42996793588732,582,44,538,4
4478,22to21,22,21,0.354914311094668,-1.32216000602092,225,43,182,3
4495,21to16,21,16,0.233497427722574,-1.40435823481825,260,13,247,3
4512,16to15,16,15,0.281049718475554,-0.817616074083514,228,46,182,4
4529,15to10,15,10,0.329554186747701,-1.43413926154426,228,215,13,3
4546,10to11,10,11,0.464735016505952,-1.56530782428663,361,47,314,3
4564,11to12,11,12,0.111102753077008,-1.70194916497094,396,182,214,4
4581,12to13,12,13,0.362470368229349,-0.590308370044053,168,168,0,4
4597,13to14,13,14,0.195086362838268,-1.56279740729378,494,494,0,4
4614,14to9,14,9,0.254071075247119,-1.35014596586056,527,412,115,3
4631,9to4,9,4,0.411772850874762,-1.64874477853194,559,446,113,3
4647,4to3,4,3,0.376362427235757,-1.8148058402654,266,266,0,2
4665,3to2,3,2,0.207119053109975,-1.80744320215819,299,84,215,3
4682,2to1,2,1,0.11100821074928,-2.1255917225359,917,116,801,3
4698,1to0,1,0,0.187669608224553,-1.99933897086964,949,150,799,3
4713,0to5,0,5,0.18350900551146,-1.86484516355057,397,182,215,2
4729,5to10,5,10,0.420768576209656,-1.01843272869633,200,200,0,3
4745,10to11,10,11,0.464735016505952,-1.56530782428663,199,199,0,3
4761,11to6,11,6,0.181146211698745,-1.30510450001975,429,246,183,4
4777,6to7,6,7,0.241016308236746,-1.37216652506372,428,180,248,4
4792,7to2,7,2,0.100508264579421,-1.57400188825635,127,127,0,4
4808,2to3,2,3,0.567884957501654,-0.4932770332293,161,161,0,3
4825,3to8,3,8,0.276093729083703,-1.6865612622984,428,212,216,3
4842,8to3,8,3,0.207679082029697,-1.19485257720552,34,34,0,4
4859,3to4,3,4,0.47924896834703,-1.1350814392116,228,228,0,3
4875,4to9,4,9,0.623637572764242,-1.30978903486814,261,261,0,2
4892,9to14,9,14,0.116259419988127,-2.96733553913988,295,180,115,3
4909,14to13,14,13,0.622209892963006,-0.548022898239018,328,280,48,3
4924,13to18,13,18,0.180245209498652,-1.79063946196571,495,180,315,4
4940,18to23,18,23,0.205557003361927,-2.50522762324885,1077,181,896,4
4957,23to22,23,22,0.338962743836761,-1.20722719555487,496,182,314,3
4972,22to17,22,17,0.299787589352502,-1.73845540660057,528,179,349,3
4988,17to12,17,12,0.191414626303062,-1.91011459623006,424,178,246,4
5005,12to11,12,11,0.122245375181923,-1.72155048653957,260,178,82,4
5020,11to16,11,16,0.204486108066944,-1.36041407867495,525,176,349,4
5035,16to21,16,21,0.200124892871193,-1.33838601290286,557,173,384,4
5052,21to20,21,20,0.258453268860863,-1.56845277922356,784,174,610,3
5069,20to15,20,15,0.328773809307878,-2.17096376939297,557,176,381,2
5085,15to10,15,10,0.228177800801113,-1.94256622783639,356,175,181,3
5101,10to5,10,5,0.269543190343317,-2.29000030292417,388,175,213,3
5119,5to0,5,0,0.40099526784268,-1.0665660846777,421,421,0,3
5134,0to1,0,1,0.81649099448854,-0.372093023255814,452,452,0,2
5151,1to6,1,6,0.31271477024881,-1.65820740001802,390,209,181,3
5167,6to7,6,7,0.166775550724394,-1.83370498660218,390,210,180,4
5183,7to12,7,12,0.365474329790637,-0.460279579857893,195,112,83,4
5198,12to13,12,13,0.269057450113222,-1.09549868146274,289,143,146,4
5216,13to8,13,8,0.181070700035939,-1.90928677435667,391,178,213,4
5231,8to7,8,7,0.068233320363535,-2.3079135766735,64,64,0,4
5247,7to2,7,2,0.083918993478572,-1.97180408605855,455,274,181,4
5264,2to3,2,3,0.481821875435424,-0.839248597210343,422,276,146,3
5281,3to4,3,4,0.394359559699486,-1.48105300319264,422,276,146,3
5297,4to9,4,9,0.539088965484275,-1.65813026709563,422,275,147,2
5313,9to14,9,14,0.116259419988127,-2.96733553913988,421,421,0,3
5330,14to19,14,19,0.043452960731002,-3.26923093118358,1211,144,1067,3
5345,19to24,19,24,0.182651765427058,-2.3638798765575,1371,142,1229,3
5361,24to23,24,23,0.517957760480939,-1.30348712541686,421,141,280,2
5378,23to18,23,18,0.411251934257886,-1.27181228050752,454,209,245,3
5395,18to17,18,17,0.130801019716838,-3.07467235563274,423,140,283,4
5412,17to16,17,16,0.140433744982099,-2.33847241130908,392,141,251,4
5429,16to15,16,15,0.17476122992242,-1.69261607408351,360,45,315,4
5448,15to20,15,20,0.143881897753874,-2.58889825990029,396,47,349,3
5465,20to21,20,21,0.45645164023315,-2.34559969194677,430,48,382,2
5483,21to22,21,22,0.313104077558502,-1.57554335223182,526,246,280,3
5498,22to23,22,23,0.245634377502411,-1.93768543496798,137,137,0,3
5515,23to18,23,18,0.411251934257886,-1.27181228050752,137,137,0,3
5532,18to19,18,19,0.248541742465702,-2.75164030315528,202,16,186,4
5549,19to14,19,14,0.355051530737489,-2.05626163672734,236,49,187,3
5564,14to13,14,13,0.470977197657273,-1.32944366326634,366,80,286,3
5581,13to12,13,12,0.21529722015023,-1.93842659625813,398,114,284,4
5598,12to13,12,13,0.269057450113222,-1.09549868146274,34,34,0,4
5614,13to8,13,8,0.221663244754463,-1.90928677435667,398,398,0,4
5630,8to9,8,9,0.247379914914601,-1.01992131859187,333,333,0,4
5646,9to4,9,4,0.43459511778582,-1.64874477853194,365,365,0,3
5662,4to3,4,3,0.460911034515725,-1.8148058402654,398,398,0,2
5678,3to2,3,2,0.284539727133044,-1.80744320215819,431,431,0,3
5694,2to7,2,7,0.385060734980641,-1.06342201487833,463,463,0,3
5711,7to6,7,6,0.274465743878673,-0.869544560943643,560,407,153,4
5726,6to11,6,11,0.158893217542441,-2.00932796527457,721,276,445,4
5742,11to10,11,10,0.332702095345848,-1.03844206945955,657,374,283,4
5758,10to5,10,5,0.201172698988316,-2.67203987674456,657,406,251,3
5773,5to0,5,0,0.324509528264182,-1.39837036602327,654,437,217,3
5790,0to1,0,1,0.638173935830367,-1.29739790130459,656,49,607,2
5805,1to2,1,2,0.371395782400471,-1.64738319188701,127,78,49,3
5821,2to3,2,3,0.481821875435424,-0.839248597210343,159,159,0,3
5837,3to4,3,4,0.394359559699486,-1.48105300319264,191,191,0,3
5854,4to9,4,9,0.484486374442284,-1.87688026709563,224,175,49,2
5869,9to8,9,8,0.373355238481705,-1.92953829807785,255,175,80,3
5884,8to13,8,13,0.476707682692167,-0.363943112102621,286,286,0,4
5900,13to14,13,14,0.249156755122082,-1.8818857263821,351,239,112,4
5915,14to13,14,13,0.470977197657273,-1.32944366326634,31,31,0,3
5931,13to12,13,12,0.235460075230708,-1.93842659625813,350,350,0,4
5946,12to17,12,17,0.307601010532649,-1.07877687950283,551,364,187,4
5963,17to18,17,18,0.487988546878778,-1.14893599845001,448,398,50,4
5980,18to23,18,23,0.268625310976771,-2.74381683486711,482,367,115,4
5997,23to22,23,22,0.238507305617583,-2.1216240827144,514,44,470,3
6012,22to21,22,21,0.259819523614741,-2.18687664221836,547,74,473,3
6028,21to16,21,16,0.214461218303533,-2.17708550754552,616,140,476,3
6044,16to15,16,15,0.08897330160683,-2.46659981392091,615,139,476,4
6060,15to20,15,20,0.071895855418459,-3.36340806382185,612,138,474,3
6075,20to21,20,21,0.45645164023315,-2.34559969194677,63,63,0,2
6089,21to22,21,22,0.391376916661647,-1.57554335223182,92,92,0,3
6104,22to17,22,17,0.3737168671308,-1.87769591292968,158,136,22,3
6120,17to18,17,18,0.401703179566403,-1.49925446978759,157,102,55,4
6136,18to19,18,19,0.130704921468616,-3.63409063428111,604,71,533,4
6154,19to24,19,24,0.128888817980486,-3.23409001252783,809,105,704,3
6171,24to23,24,23,0.448774125798218,-1.58097403641163,191,138,53,2
6187,23to18,23,18,0.557917857959018,-1.27181228050752,67,67,0,3
6204,18to13,18,13,0.260272488167496,-3.03278661679269,289,202,87,4
6222,13to8,13,8,0.11765785272694,-2.78464088200539,353,44,309,4
6238,8to7,8,7,0.030048202249601,-3.16820769432056,544,76,468,4
6253,7to6,7,6,0.257892232316392,-0.95441540965213,542,496,46,4
6269,6to5,6,5,0.325582838915566,-1.29194342738922,511,511,0,4
6285,5to10,5,10,0.423513296467103,-1.22469423882525,543,431,112,3
6301,10to11,10,11,0.367351759852969,-2.54965565037359,575,9,566,3
6317,11to16,11,16,0.107274071254312,-2.33273241777529,289,8,281,4
6333,16to17,16,17,0.42965890964248,-0.891944496181784,229,229,0,4
6350,17to12,17,12,0.138026454591699,-2.72873034802003,419,76,343,4
6365,12to13,12,13,0.237830063097398,-1.42469122804659,161,108,53,4
6380,13to14,13,14,0.176795455603182,-2.5256357263821,480,171,309,4
6398,14to9,14,9,0.314319647107676,-1.97514596586056,544,204,340,3
6414,9to4,9,4,0.377357672782838,-2.12708100036903,577,301,276,3
6429,4to3,4,3,0.390276703708137,-2.32302952447593,608,299,309,2
6445,3to2,3,2,0.284539727133044,-1.80744320215819,640,640,0,3
6462,2to1,2,1,0.053621321138984,-3.12261553205971,672,2,670,3
6478,1to0,1,0,0.120550941028329,-2.9468567013661,705,37,668,3
6494,0to5,0,5,0.220839546306449,-2.55817849688391,225,69,156,2
6510,5to10,5,10,0.298377921834291,-1.77136090549191,225,102,123,3
6525,10to15,10,15,0.177900012253708,-3.44646987660112,481,135,346,3
6543,15to16,15,16,0.630411828912414,-1.19225338068886,226,226,0,3
6560,16to21,16,21,0.174920435487167,-1.91982931187193,485,203,282,4
6577,21to20,21,20,0.261690367153792,-2.17580287593536,517,203,314,3
6592,20to15,20,15,0.54354835976685,-2.17096376939297,67,67,0,2
6607,15to16,15,16,0.630411828912414,-1.19225338068886,64,64,0,3
6623,16to17,16,17,0.488928387474459,-0.891944496181784,290,290,0,4
6639,17to18,17,18,0.26130094755088,-2.42624562023007,452,33,419,4
6655,18to23,18,23,0.173364798569457,-3.67563501668529,484,33,451,4
6672,23to22,23,22,0.108681827136118,-3.0650203091295,583,33,550,3
6687,22to21,22,21,0.274326154030771,-2.18687664221836,127,127,0,3
6703,21to20,21,20,0.261690367153792,-2.17580287593536,126,126,0,3
6719,20to15,20,15,0.54354835976685,-2.17096376939297,127,127,0,2
6734,15to16,15,16,0.509479108053074,-1.68831637281485,127,64,63,3
6751,16to11,16,11,0.115436098874985,-2.48053739193769,450,65,385,4
6767,11to6,11,6,0.143546940395885,-2.24284769068123,514,32,482,4
6784,6to7,6,7,0.083530829710822,-2.77509692799412,546,32,514,4
6801,7to12,7,12,0.422706304905117,-0.460279579857893,451,451,0,4
6816,12to13,12,13,0.237830063097398,-1.42469122804659,451,451,0,4
6832,13to8,13,8,0.060645885770795,-3.67972284921851,610,64,546,4
6848,8to9,8,9,0.206959034689619,-1.30436576303632,450,322,128,4
6865,9to4,9,4,0.377357672782838,-2.12708100036903,451,451,0,3
6882,4to3,4,3,0.226214031355712,-3.10669398363707,453,98,355,2
6898,3to2,3,2,0.154007375774225,-2.58890015580057,453,99,354,3
6915,2to7,2,7,0.420372107219141,-1.06342201487833,131,131,0,3
6931,7to12,7,12,0.422706304905117,-0.460279579857893,130,130,0,4
6948,12to17,12,17,0.157828383932529,-2.07262303334899,325,2,323,4
6964,17to18,17,18,0.26130094755088,-2.42624562023007,325,325,0,4
6980,18to19,18,19,0.114113062204743,-4.17200532622424,844,390,454,4
6995,19to14,19,14,0.356136212594694,-2.31967627087368,615,453,162,3
7011,14to9,14,9,0.314319647107676,-1.97514596586056,163,163,0,3
7027,9to8,9,8,0.268494149758029,-2.77056393910349,195,31,164,3
7041,8to13,8,13,0.352377928278369,-1.09283200099151,225,61,164,4
7058,13to12,13,12,0.291362524000082,-2.19039510019513,127,95,32,4
7075,12to11,12,11,0.104451912087853,-2.62895789394698,324,30,294,4
7090,11to10,11,10,0.33316949831113,-1.64706275911472,580,227,353,4
7107,10to5,10,5,0.261088941680316,-3.24789632046398,613,260,353,3
7124,5to0,5,0,0.306830600573707,-1.94480999450624,646,293,353,3
7140,0to1,0,1,0.676702044089623,-1.8195217951099,678,324,354,2
7156,1to6,1,6,0.283322934061405,-2.33429994500517,389,126,263,3
7173,6to7,6,7,0.058681468464099,-3.15494188923443,258,160,98,4
7191,7to12,7,12,0.422706304905117,-0.460279579857893,133,133,0,4
7208,12to13,12,13,0.348275370005297,-1.42469122804659,167,167,0,4
7224,13to14,13,14,0.114844245519705,-3.23305930716813,229,67,162,4
7240,14to9,14,9,0.183652985065572,-2.68693635887366,229,66,163,3
7257,9to4,9,4,0.312105500307778,-2.96126467383842,392,65,327,3
7275,4to3,4,3,0.112857988298932,-3.93875505233936,393,66,327,2
7290,3to8,3,8,0.203361743518061,-2.5610859771273,263,33,230,3
7306,8to13,8,13,0.352377928278369,-1.09283200099151,98,98,0,4
7323,13to18,13,18,0.485897000722444,-1.79063946196571,359,359,0,4
7339,18to17,18,17,0.341901505930562,-3.07467235563274,391,391,0,4
7356,17to22,17,22,0.159795480960394,-3.04546501191071,684,263,421,4
7372,22to23,22,23,0.223802679339374,-2.57087929828736,717,263,454,3
7389,23to24,23,24,0.124732648578559,-3.06622515807491,1235,264,971,3
7404,24to19,24,19,0.456586587195565,-1.75506605794253,424,263,161,2
7419,19to14,19,14,0.282795812323385,-2.65813780933522,195,129,66,3
7434,14to13,14,13,0.644140875307906,-1.64975616326634,128,87,41,3
7450,13to12,13,12,0.198569346240991,-2.8583487681488,259,86,173,4
7465,12to7,12,7,0.312973021262699,-1.61044321503293,292,224,68,4
7480,7to6,7,6,0.257892232316392,-0.95441540965213,324,324,0,4
7496,6to5,6,5,0.378086286130883,-1.29194342738922,389,389,0,4
7511,5to10,5,10,0.191552553200477,-2.65734665371044,421,48,373,3
7527,10to11,10,11,0.311710747558219,-3.44124857072757,452,49,403,3
7542,11to16,11,16,0.081726402526616,-3.15080172470599,808,147,661,4
7559,16to21,16,21,0.099408674206293,-2.75125133022055,872,147,725,4
7575,21to20,21,20,0.133568326058331,-3.00837168327481,872,146,726,3
7591,20to15,20,15,0.341461939647356,-3.00238578774159,872,147,725,2
7606,15to10,15,10,0.395100037368784,-1.94256622783639,95,95,0,3
7620,10to5,10,5,0.352038460189181,-3.36079954627043,124,110,14,3
7637,5to0,5,0,0.226462947737033,-2.72843572550039,513,111,402,3
7653,0to1,0,1,0.488272564512221,-2.60509684384285,513,110,403,2
7669,1to2,1,2,0.353847175781859,-2.50341432029168,771,111,660,3
7685,2to3,2,3,0.329485297587459,-1.65388274355181,410,76,334,3
7701,3to4,3,4,0.39403442503053,-2.31213408427373,444,75,369,3
7717,4to9,4,9,0.771537122688099,-2.72174399875181,477,74,403,2
7733,9to8,9,8,0.234443476236195,-3.45453685106738,443,140,303,3
7749,8to13,8,13,0.352377928278369,-1.09283200099151,315,315,0,4
7766,13to18,13,18,0.573168381110667,-1.80869815271063,443,435,8,4
7783,18to17,18,17,0.173935968075964,-3.97782550878589,444,43,401,4
7799,17to16,17,16,0.324046606991799,-2.33847241130908,257,257,0,4
7816,16to11,16,11,0.130314832849418,-2.48053739193769,289,289,0,4
7831,11to12,11,12,0.348009463626981,-1.70194916497094,381,381,0,4
7846,12to7,12,7,0.147447764559928,-2.5789471520408,381,12,369,4
7863,7to6,7,6,0.250958612588372,-0.990968934456308,383,369,14,4
7880,6to5,6,5,0.378086286130883,-1.29194342738922,260,260,0,4
7896,5to10,5,10,0.243148025710645,-2.65734665371044,290,290,0,3
7913,10to15,10,15,0.323134970478515,-3.44646987660112,322,322,0,3
7929,15to16,15,16,0.352462409378701,-2.33447021896869,130,46,84,3
7946,16to17,16,17,0.638132670711778,-0.891944496181784,163,163,0,4
7963,17to22,17,22,0.089718106445648,-3.70279614864876,607,208,399,4
7980,22to21,22,21,0.178783673920198,-2.99685288924924,421,80,341,3
7997,21to20,21,20,0.064294483552735,-3.81642855531272,422,81,341,3
8013,20to15,20,15,0.302212100811791,-3.18238578774159,100,82,18,2
8030,15to10,15,10,0.521572333518161,-1.94256622783639,134,134,0,3
8046,10to11,10,11,0.278198091789496,-3.66298770116235,230,179,51,3
8063,11to12,11,12,0.328713985437451,-1.78815606152267,232,212,20,4
8079,12to13,12,13,0.427220862361162,-1.58832759168295,330,276,54,4
8094,13to18,13,18,0.411528773286287,-2.46113717710088,328,114,214,4
8110,18to23,18,23,0.11216203144119,-4.56587891912432,738,81,657,4
8127,23to24,23,24,0.057729167626636,-3.91039859980932,738,115,623,3
8143,24to19,24,19,0.27385030391495,-2.55614860192088,739,147,592,2
8158,19to14,19,14,0.221533553665157,-2.98425418281289,739,498,241,3
8174,14to9,14,9,0.228317512084542,-2.68693635887366,457,457,0,3
8190,9to4,9,4,0.383940155947506,-2.96126467383842,489,489,0,3
8205,4to3,4,3,0.2284628773119,-3.93875505233936,520,520,0,2
8221,3to2,3,2,0.298769450418034,-2.58890015580057,552,552,0,3
8238,2to7,2,7,0.594661574425061,-1.06342201487833,392,392,0,3
8254,7to8,7,8,0.200813924462144,-1.24884604507125,521,436,85,4
8271,8to13,8,13,0.172653574039513,-2.05116533432484,192,8,184,4
8287,13to18,13,18,0.411528773286287,-2.46113717710088,193,193,0,4
8304,18to17,18,17,0.193963621425844,-4.02810483839483,358,340,18,4
8321,17to16,17,16,0.270038991360163,-2.71857445212541,392,243,149,4
8338,16to17,16,17,0.638132670711778,-0.891944496181784,34,34,0,4
8355,17to12,17,12,0.267310382662213,-2.72873034802003,292,292,0,4
8370,12to11,12,11,0.132534676939245,-2.78019246184822,324,275,49,4
8386,11to10,11,10,0.186861471606005,-2.62178186023831,356,9,347,4
8402,10to5,10,5,0.183960627208044,-4.34547387577234,522,8,514,3
8418,5to6,5,6,0.296529450577827,-2.86299190682371,555,8,547,3
8435,6to1,6,1,0.204121533082468,-2.15600837422874,782,105,677,4
8451,1to0,1,0,0.109632901132447,-3.81663557114497,814,106,708,3
8467,0to5,0,5,0.511727435487778,-2.55817849688391,65,65,0,2
8482,5to0,5,0,0.339238270134003,-2.72843572550039,31,31,0,3
8498,0to1,0,1,0.488272564512221,-2.60509684384285,63,63,0,2
8514,1to2,1,2,0.40762954056961,-2.50341432029168,293,293,0,3
8529,2to7,2,7,0.545008085899331,-1.2661711557718,291,232,59,3
8545,7to12,7,12,0.332508675712546,-0.923437474594735,190,102,88,4
8562,12to17,12,17,0.175845525800119,-2.61726589049184,224,102,122,4
8578,17to18,17,18,0.174491701906072,-3.41249991576272,291,4,287,4
8594,18to13,18,13,0.524785099580003,-3.03278661679269,323,323,0,4
8611,13to14,13,14,0.162341072678125,-3.42511228730058,453,366,87,4
8627,14to9,14,9,0.228317512084542,-2.68693635887366,453,453,0,3
8643,9to4,9,4,0.383940155947506,-2.96126467383842,453,453,0,3
8658,4to3,4,3,0.2284628773119,-3.93875505233936,453,453,0,2
8673,3to8,3,8,0.294149966308523,-2.62313848309388,419,393,26,3
8688,8to9,8,9,0.364339707936534,-1.30436576303632,61,61,0,4
8703,9to14,9,14,0.239284495642764,-3.64124858261815,92,30,62,3
8718,14to19,14,19,0.056516503090349,-4.16140484422706,575,62,513,3
8735,19to24,19,24,0.082311303681757,-4.07784001252783,608,95,513,3
8752,24to23,24,23,0.543140934190543,-2.38315472176988,642,127,515,2
8768,23to18,23,18,0.807827761942884,-1.27181228050752,190,190,0,3
8784,18to13,18,13,0.524785099580003,-3.03278661679269,190,190,0,4
8800,13to12,13,12,0.286134799889656,-2.8583487681488,255,255,0,4
8815,12to11,12,11,0.134110154633534,-2.90603515847743,445,389,56,4
8831,11to6,11,6,0.137713734407022,-3.09756924031804,413,60,353,4
8848,6to5,6,5,0.484336790903023,-1.29194342738922,381,381,0,4
8863,5to10,5,10,0.36423227928817,-2.65734665371044,477,477,0,3
8878,10to15,10,15,0.419345300471013,-3.57941785347973,865,750,115,3
8894,15to16,15,16,0.293439161658428,-2.60497632717114,573,418,155,3
8910,16to17,16,17,0.617998539438341,-0.978151392733509,348,318,30,4
8927,17to22,17,22,0.053795924656993,-4.67375050549524,964,28,936,4
8942,22to21,22,21,0.113259167038058,-3.53011692251328,962,449,513,3
8959,21to20,21,20,0.055745758628628,-3.96819570707987,962,816,146,3
8976,20to15,20,15,0.302212100811791,-3.18238578774159,98,98,0,2
8993,15to10,15,10,0.569113809860478,-1.94256622783639,130,130,0,3
9008,10to11,10,11,0.385725061198162,-3.66298770116235,193,193,0,3
9025,11to12,11,12,0.505648287775451,-1.80593383930045,225,221,4,4
9041,12to13,12,13,0.466883128851581,-1.72451436211097,257,222,35,4
9056,13to18,13,18,0.296192735304769,-3.0271093993231,288,125,163,4
9072,18to19,18,19,0.095609063390049,-4.81889798159147,354,125,229,4
9089,19to14,19,14,0.187511586461541,-3.32881376830512,386,253,133,3
9104,14to9,14,9,0.246457683148121,-2.68934020502751,416,415,1,3
9120,9to4,9,4,0.472310737499985,-2.96126467383842,477,477,0,3
9135,4to3,4,3,0.205334747585391,-4.07502339615488,477,412,65,2
9150,3to2,3,2,0.235294231605332,-2.94110141366221,636,412,224,3
9165,2to7,2,7,0.443951698610583,-1.67183153313029,636,378,258,3
9180,7to2,7,2,0.116547549582812,-1.97180408605855,30,30,0,4
9197,2to1,2,1,0.074524251938381,-3.48885301417702,699,443,256,3
9213,1to6,1,6,0.482737558297943,-2.33429994500517,382,382,0,3
9228,6to5,6,5,0.484336790903023,-1.29194342738922,380,380,0,4
9245,5to0,5,0,0.339238270134003,-2.72843572550039,763,763,0,3
9260,0to1,0,1,0.488272564512221,-2.60509684384285,63,63,0,2
9275,1to2,1,2,0.40762954056961,-2.50341432029168,95,95,0,3
9292,2to3,2,3,0.271676152567824,-2.50738592826518,157,23,134,3
9308,3to8,3,8,0.154190774523973,-3.58691801065294,635,23,612,3
9324,8to9,8,9,0.237638815132443,-1.91345667212723,220,86,134,4
9339,9to14,9,14,0.156486489596301,-4.16924858261815,250,118,132,3
9356,14to13,14,13,0.501904809583765,-2.47515298866317,315,55,260,3
9371,13to18,13,18,0.216239585642307,-3.44933162154532,315,182,133,4
9386,18to17,18,17,0.149836361215516,-4.44407122494945,476,278,198,4
9403,17to16,17,16,0.31942573632104,-2.98576502187001,509,373,136,4
9420,16to15,16,15,0.12162426319747,-2.62425747157857,444,374,70,4
9437,15to10,15,10,0.372018910620478,-2.74436802963819,444,88,356,3
9454,10to11,10,11,0.232541210714913,-4.39168725273186,446,121,325,3
9470,11to12,11,12,0.347207105313274,-2.45986642357011,445,154,291,4
9485,12to7,12,7,0.097176214405872,-3.4133221520408,320,53,267,4
9500,7to6,7,6,0.182910411546023,-1.69131736651206,287,86,201,4
9516,6to5,6,5,0.368567358095138,-1.76763787183366,288,151,137,4
9532,5to0,5,0,0.242858009068131,-3.19881900076172,287,152,135,3
9549,0to1,0,1,0.372626193685068,-3.07914528674942,289,152,137,2
9563,1to2,1,2,0.273300702259793,-3.10758098695834,288,114,174,3
9579,2to3,2,3,0.170026680088759,-3.10668906415368,287,115,172,3
9595,3to4,3,4,0.481351128419746,-2.59423934743162,475,341,134,3
9613,4to9,4,9,0.794665252414609,-2.72174399875181,289,289,0,2
9630,9to8,9,8,0.216569960039662,-3.98559275168849,322,151,171,3
9645,8to13,8,13,0.139409410937668,-2.52867398484387,289,151,138,4
9660,13to12,13,12,0.390477300851643,-2.8583487681488,190,190,0,4
9676,12to17,12,17,0.11925911719185,-3.32416244221598,290,85,205,4
9693,17to16,17,16,0.156566747783369,-3.91335122876656,290,21,269,4
9708,16to21,16,21,0.046938113320066,-3.64159075580802,766,84,682,4
9724,21to22,21,22,0.409568311961434,-2.38859228573245,797,149,648,3
9739,22to23,22,23,0.156289766092896,-3.38850847761867,987,180,807,3
9755,23to18,23,18,0.807827761942884,-1.27181228050752,384,384,0,3
9771,18to19,18,19,0.056504563680671,-5.46982788144841,699,244,455,4
9788,19to24,19,24,0.043213284353153,-4.84517144652594,1053,245,808,3
9804,24to23,24,23,0.543140934190543,-2.38315472176988,65,65,0,2
9820,23to18,23,18,0.807827761942884,-1.27181228050752,65,65,0,3
9836,18to13,18,13,0.646363909553453,-3.03278661679269,191,191,0,4
9851,13to14,13,14,0.16901168346103,-3.76104978730058,512,340,172,4
9865,14to9,14,9,0.280167068274762,-3.24886401455132,252,111,141,3
9882,9to4,9,4,0.451542108036517,-3.57450509195688,287,111,176,3
9896,4to3,4,3,0.11854553009283,-4.72802024158075,317,110,207,2
9911,3to2,3,2,0.206053595837416,-3.62788302285761,348,109,239,3
9927,2to7,2,7,0.593498506795869,-2.20803062815291,442,205,237,3
9943,7to12,7,12,0.356939518079051,-1.08244807530145,283,238,45,4
9958,12to11,12,11,0.085989916904695,-3.76119388863616,504,73,431,4
9973,11to10,11,10,0.13443548155385,-3.61431917367115,536,4,532,4
9989,10to5,10,5,0.136610944165094,-5.05583328380617,473,137,336,3
10004,5to6,5,6,0.198702290759165,-3.59315063698244,504,136,368,3
10020,6to1,6,1,0.158139344873882,-2.72925678187206,471,201,270,4
10036,1to0,1,0,0.078350614275261,-4.41981017431957,504,200,304,3
10053,0to5,0,5,0.627373806314932,-2.55817849688391,64,64,0,2
10070,5to10,5,10,0.506544238531149,-2.65734665371044,97,97,0,3
10086,10to15,10,15,0.400530108450102,-4.37971815378003,666,133,533,3
10103,15to16,15,16,0.260646622513846,-3.35619583936626,410,102,308,3
10119,16to17,16,17,0.488411292721332,-1.74790308573577,443,102,341,4
10134,17to12,17,12,0.51188669576114,-2.72873034802003,191,191,0,4
10151,12to13,12,13,0.442874974079432,-2.61340325099986,315,35,280,4
10167,13to12,13,12,0.416825998357201,-2.8583487681488,33,33,0,4
10184,12to7,12,7,0.199012692404306,-3.4133221520408,257,257,0,4
10200,7to8,7,8,0.264161678518454,-1.43656534331687,570,463,107,4
10214,8to3,8,3,0.52913119881941,-1.19485257720552,318,318,0,4
10230,3to4,3,4,0.579276542440736,-2.59423934743162,348,348,0,3
10245,4to9,4,9,0.88145446990717,-2.72174399875181,380,380,0,2
10262,9to14,9,14,0.143438200749545,-4.85294687945513,411,130,281,3
10277,14to13,14,13,0.607345075858645,-2.47515298866317,126,126,0,3
10294,13to8,13,8,0.183331278904667,-3.67972284921851,94,94,0,4
10311,8to3,8,3,0.52913119881941,-1.19485257720552,97,97,0,4
10326,3to2,3,2,0.206053595837416,-3.62788302285761,415,415,0,3
10341,2to7,2,7,0.392494303499378,-3.02331725235673,157,29,128,3
10358,7to6,7,6,0.204754010763505,-1.69131736651206,354,354,0,4
10373,6to11,6,11,0.180965083459276,-2.78764121828662,415,92,323,4
10389,11to12,11,12,0.291860156365432,-3.0499565136602,222,91,131,4
10406,12to17,12,17,0.217571669989191,-3.32416244221598,287,287,0,4
10422,17to18,17,18,0.180002392443024,-3.87429393569627,602,324,278,4
10438,18to13,18,13,0.646363909553453,-3.03278661679269,161,161,0,4
10454,13to8,13,8,0.153626197391156,-3.89222284921851,160,126,34,4
10472,8to3,8,3,0.52913119881941,-1.19485257720552,161,161,0,4
10489,3to4,3,4,0.579276542440736,-2.59423934743162,259,259,0,3
10506,4to9,4,9,0.835753573166345,-3.1010543435794,261,162,99,2
10523,9to14,9,14,0.102814843135917,-5.23225722428272,261,162,99,3
10540,14to19,14,19,0.046354905870023,-5.11979236048193,769,32,737,3
10557,19to18,19,18,0.596114412946584,-2.74106368438361,135,32,103,3
10573,18to23,18,23,0.058618561890204,-5.52296604526216,769,33,736,4
10589,23to22,23,22,0.056036617289033,-4.02687002011216,865,33,832,3
10606,22to17,22,17,0.668401707909526,-2.06269591292968,200,163,37,3
10622,17to12,17,12,0.565965843850432,-2.72873034802003,233,233,0,4
10637,12to13,12,13,0.442874974079432,-2.61340325099986,199,199,0,4
10654,13to8,13,8,0.153626197391156,-3.89222284921851,200,200,0,4
10671,8to3,8,3,0.52913119881941,-1.19485257720552,199,199,0,4
10688,3to4,3,4,0.579276542440736,-2.59423934743162,199,199,0,3
10703,4to9,4,9,0.835753573166345,-3.1010543435794,197,197,0,2
10719,9to14,9,14,0.102814843135917,-5.23225722428272,196,196,0,3
10736,14to13,14,13,0.652601382262927,-2.47515298866317,99,99,0,3
10752,13to12,13,12,0.431987409512442,-2.8583487681488,130,130,0,4
10769,12to7,12,7,0.089666797218979,-4.33855579690061,428,32,396,4
10785,7to6,7,6,0.114284110569556,-2.3821838770507,427,132,295,4
10803,6to5,6,5,0.50185310133461,-1.76763787183366,750,750,0,4
10821,5to10,5,10,0.506544238531149,-2.65734665371044,751,751,0,3
10838,10to15,10,15,0.250725597382067,-5.07120751548216,752,232,520,3
10856,15to20,15,20,0.128800723617936,-4.22265951347921,1897,267,1630,3
10872,20to21,20,21,0.523397635838196,-3.0887268397131,1164,299,865,2
10888,21to16,21,16,0.345925932598252,-2.83823200436081,785,266,519,3
10903,16to17,16,17,0.329673354322168,-2.41120274903543,297,100,197,4
10918,17to12,17,12,0.513638397191131,-2.93957372151401,166,131,35,4
10933,12to13,12,13,0.459009568846627,-2.79106822561915,197,162,35,4
10950,13to18,13,18,0.119826799977302,-4.28648174877179,393,64,329,4
10967,18to19,18,19,0.029523849076507,-6.24266160510181,427,97,330,4
10983,19to24,19,24,0.031153880965693,-5.73638483564727,1195,130,1065,3
10999,24to23,24,23,0.354502351225065,-3.15545519125345,426,97,329,2
11015,23to18,23,18,0.881004819857071,-1.27181228050752,65,65,0,3
11030,18to13,18,13,0.731482552361755,-3.03278661679269,97,97,0,4
11048,13to8,13,8,0.143930283712349,-4.1434918847515,394,295,99,4
11065,8to3,8,3,0.508224399981377,-1.27860892238318,394,361,33,4
11080,3to4,3,4,0.579276542440736,-2.59423934743162,392,392,0,3
11096,4to9,4,9,0.835753573166345,-3.1010543435794,393,393,0,2
11113,9to14,9,14,0.102814843135917,-5.23225722428272,394,394,0,3
11128,14to13,14,13,0.652601382262927,-2.47515298866317,98,98,0,3
11143,13to12,13,12,0.520334647806717,-2.8583487681488,225,225,0,4
11158,12to11,12,11,0.086558516116709,-4.55992000328584,785,158,627,4
11173,11to6,11,6,0.152406663094642,-3.86045583825618,388,92,296,4
11190,6to1,6,1,0.088500548767868,-3.62327387588915,1170,124,1046,4
11206,1to2,1,2,0.143722545800795,-4.00189916877652,880,93,787,3
11221,2to7,2,7,0.238212730054948,-3.74898096917089,452,124,328,3
11237,7to12,7,12,0.419231531204878,-1.08244807530145,94,94,0,4
11253,12to17,12,17,0.297846494063204,-3.32416244221598,350,350,0,4
11269,17to16,17,16,0.157232850673713,-4.16794440461958,381,284,97,4
11284,16to15,16,15,0.212677206678337,-2.92022159713911,446,314,132,4
11300,15to10,15,10,0.463506513924815,-3.15146615072379,479,284,195,3
11316,10to5,10,5,0.179091149605821,-5.5041763637282,513,283,230,3
11331,5to0,5,0,0.160377806693261,-3.9818305837733,1295,281,1014,3
11348,0to1,0,1,0.372626193685068,-3.07914528674942,158,158,0,2
11364,1to6,1,6,0.761647537507581,-2.33429994500517,191,191,0,3
11379,6to11,6,11,0.204106396706138,-2.78764121828662,221,221,0,4
11394,11to12,11,12,0.342767264595944,-3.0499565136602,157,157,0,4
11410,12to13,12,13,0.451009869368546,-3.01801858022907,282,218,64,4
11426,13to14,13,14,0.164855859172994,-4.06456416429738,313,218,95,4
11442,14to9,14,9,0.263046494805314,-3.43672528622762,346,281,65,3
11457,9to4,9,4,0.496500306981561,-3.74691888506033,377,312,65,3
11473,4to3,4,3,0.143831017759545,-4.88488298667878,408,344,64,2
11489,3to8,3,8,0.169770830375363,-3.87716744375952,441,313,128,3
11506,8to7,8,7,0.034955763575428,-3.99978664168898,285,48,237,4
11523,7to2,7,2,0.172270744816406,-1.97180408605855,317,317,0,4
11539,2to1,2,1,0.308984790252682,-3.48885301417702,191,191,0,3
11554,1to6,1,6,0.642917410987489,-2.90798415553148,190,81,109,3
11571,6to5,6,5,0.399189464156003,-2.44214767575523,255,83,172,4
11585,5to10,5,10,0.426154307924715,-3.37313612739465,285,81,204,3
11601,10to11,10,11,0.495351966672271,-4.58988545093006,222,178,44,3
11616,11to16,11,16,0.232283465154508,-3.54561440482126,347,210,137,4
11633,16to17,16,17,0.330724088099022,-2.5138343279828,380,341,39,4
11648,17to18,17,18,0.090685108350036,-4.8600759262176,633,9,624,4
11664,18to13,18,13,0.731482552361755,-3.03278661679269,254,254,0,4
11679,13to12,13,12,0.316106298242534,-3.83378736464003,285,7,278,4
11695,12to7,12,7,0.120415950807813,-4.33855579690061,189,189,0,4
11712,7to8,7,8,0.137685518460388,-2.39620659892225,223,9,214,4
11728,8to3,8,3,0.300818389304527,-2.24723637336358,255,8,247,4
11744,3to4,3,4,0.612395041743915,-2.59423934743162,287,287,0,3
11759,4to3,4,3,0.143831017759545,-4.88488298667878,31,31,0,2
11775,3to2,3,2,0.107206083637637,-4.46915286412745,252,40,212,3
11790,2to1,2,1,0.160639797876249,-4.33745859186626,251,38,213,3
11806,1to6,1,6,0.435079270682777,-3.75719050473783,252,38,214,3
11821,6to5,6,5,0.399189464156003,-2.44214767575523,250,250,0,4
11837,5to0,5,0,0.231853811330228,-3.9818305837733,506,506,0,3
11853,0to1,0,1,0.372626193685068,-3.07914528674942,63,63,0,2
11870,1to2,1,2,0.340637745228646,-4.00189916877652,95,95,0,3
11886,2to3,2,3,0.55000870533038,-3.10668906415368,127,127,0,3
11902,3to2,3,2,0.107206083637637,-4.46915286412745,32,32,0,3
11918,2to7,2,7,0.289351496793371,-3.74898096917089,223,223,0,3
11935,7to12,7,12,0.512207981542675,-1.08244807530145,256,256,0,4
11950,12to13,12,13,0.431186764651866,-3.09843816064866,286,263,23,4
11965,13to14,13,14,0.250962052942817,-4.06456416429738,539,539,0,4
11982,14to9,14,9,0.263046494805314,-3.43672528622762,540,540,0,3
11998,9to4,9,4,0.496500306981561,-3.74691888506033,254,254,0,3
12014,4to3,4,3,0.143831017759545,-4.88488298667878,128,128,0,2
12029,3to8,3,8,0.081712352044403,-4.87085829549453,317,2,315,3
12043,8to9,8,9,0.420013320436458,-1.91345667212723,61,61,0,4
12059,9to4,9,4,0.496500306981561,-3.74691888506033,61,61,0,3
12073,4to3,4,3,0.143831017759545,-4.88488298667878,59,59,0,2
12090,3to2,3,2,0.056340221918173,-5.31489754497852,188,29,159,3
12106,2to7,2,7,0.173155107649698,-4.41387458619217,188,63,125,3
12121,7to12,7,12,0.512207981542675,-1.08244807530145,186,186,0,4
12137,12to17,12,17,0.333835855177456,-3.3697973628509,504,481,23,4
12153,17to22,17,22,0.049435289395447,-5.53180677147989,1564,222,1342,4
12170,22to23,22,23,0.08763871102163,-4.19807295242653,1171,223,948,3
12186,23to18,23,18,0.823071312818484,-1.73649629537741,538,288,250,3
12203,18to13,18,13,0.681581820633696,-3.27389333616027,253,192,61,4
12219,13to14,13,14,0.228029355070605,-4.19054841626589,254,222,32,4
12235,14to19,14,19,0.022575265605886,-5.91947690306868,1268,254,1014,3
12251,19to24,19,24,0.014617272065093,-6.51004414164097,1268,287,981,3
12268,24to23,24,23,0.273515747359032,-3.53300621166161,98,61,37,2
12283,23to18,23,18,0.823071312818484,-1.73649629537741,97,97,0,3
12299,18to13,18,13,0.681581820633696,-3.27389333616027,96,96,0,4
12315,13to8,13,8,0.239016097325767,-4.1434918847515,286,286,0,4
12330,8to9,8,9,0.420013320436458,-1.91345667212723,287,287,0,4
12346,9to4,9,4,0.496500306981561,-3.74691888506033,287,287,0,3
12362,4to3,4,3,0.143831017759545,-4.88488298667878,289,289,0,2
12379,3to2,3,2,0.056340221918173,-5.31489754497852,289,289,0,3
12395,2to1,2,1,0.132195732200918,-4.74889770625741,542,319,223,3
12411,1to6,1,6,0.312505899601719,-4.28446323201056,605,286,319,3
12427,6to5,6,5,0.292330739054238,-2.9173952005077,606,318,288,4
12443,5to10,5,10,0.426154307924715,-3.37313612739465,858,858,0,3
12458,10to11,10,11,0.343020061877252,-5.2211573295765,857,316,541,3
12474,11to16,11,16,0.121335426372569,-4.32999668920355,858,185,673,4
12491,16to15,16,15,0.188280581044983,-3.11740469573066,1207,969,238,4
12508,15to20,15,20,0.074752809633349,-5.07132779435088,1652,250,1402,3
12524,20to21,20,21,0.319730773376492,-3.93739512058477,1652,250,1402,2
12539,21to22,21,22,0.497089203863201,-2.56993943599152,386,316,70,3
12555,22to17,22,17,0.527101429272368,-3.00767198948471,418,23,395,3
12571,17to12,17,12,0.447611592655639,-3.81512927706957,450,56,394,4
12587,12to13,12,13,0.4379079037307,-3.09843816064866,288,288,0,4
12604,13to14,13,14,0.228029355070605,-4.19054841626589,385,385,0,4
12621,14to9,14,9,0.242179766968129,-3.58449160925167,291,248,43,3
12639,9to4,9,4,0.46074502538253,-3.89026359495794,293,251,42,3
12655,4to3,4,3,0.127442821180386,-5.02481472729312,293,252,41,2
12672,3to8,3,8,0.079057654247174,-4.98570423386988,357,316,41,3
12689,8to7,8,7,0.035515612883999,-4.40115885438194,583,349,234,4
12706,7to2,7,2,0.190868179609507,-2.09412824507996,327,287,40,4
12720,2to1,2,1,0.118382603067953,-4.87505155241125,325,284,41,3
12737,1to0,1,0,0.220257249574871,-4.70425461876402,900,644,256,3
12754,0to5,0,5,0.59836149394511,-2.68050265590531,327,287,40,2
12771,5to10,5,10,0.396633950215399,-3.49508734690685,328,288,40,3
12788,10to15,10,15,0.270755738129931,-5.65033209460674,297,125,172,3
12803,15to16,15,16,0.254628469951104,-4.08871863571884,329,88,241,3
12819,16to11,16,11,0.330363060351494,-2.5941107991399,361,320,41,4
12837,11to12,11,12,0.436417347562331,-3.0499565136602,266,266,0,4
12853,12to13,12,13,0.238770595897757,-4.00821259673888,266,24,242,4
12870,13to18,13,18,0.095932436208687,-5.18767425303073,587,58,529,4
12887,18to17,18,17,0.135987657851645,-4.97720375506993,332,155,177,4
12903,17to22,17,22,0.046938296169317,-6.10598259565572,364,155,209,4
12921,22to21,22,21,0.226839366301386,-3.96840407616567,397,223,174,3
12938,21to20,21,20,0.085784504675407,-4.36819570707987,430,258,172,3
12953,20to15,20,15,0.680269226623508,-3.18238578774159,165,165,0,2
12969,15to10,15,10,0.650055658146347,-3.15146615072379,198,198,0,3
12986,10to5,10,5,0.179876156100888,-6.23693498441785,232,62,170,3
13003,5to6,5,6,0.186829100994715,-4.48673171806352,592,63,529,3
13020,6to7,6,7,0.150839228272166,-3.67760049950634,331,158,173,4
13035,7to2,7,2,0.122365829756406,-2.61996411134136,329,156,173,4
13051,2to3,2,3,0.693869752488614,-3.10668906415368,396,396,0,3
13068,3to4,3,4,0.864060053995214,-2.59423934743162,429,429,0,3
13085,4to9,4,9,0.872557178819614,-3.1010543435794,464,464,0,2
13100,9to8,9,8,0.324310270771741,-4.39213480776326,428,254,174,3
13115,8to13,8,13,0.231009138162698,-2.52867398484387,262,262,0,4
13131,13to14,13,14,0.260022974601539,-4.19054841626589,527,527,0,4
13148,14to19,14,19,0.012806815077884,-6.5350300246459,913,351,562,3
13164,19to18,19,18,0.63345204912924,-2.74106368438361,294,294,0,3
13181,18to23,18,23,0.036174943009855,-6.34662431470356,913,161,752,4
13197,23to24,23,24,0.055638187727133,-4.47170938205034,946,415,531,3
13212,24to19,24,19,0.726484252640968,-2.55614860192088,64,64,0,2
13228,19to18,19,18,0.63345204912924,-2.74106368438361,64,64,0,3
13244,18to13,18,13,0.78140819930231,-3.27389333616027,129,129,0,4
13259,13to18,13,18,0.095932436208687,-5.18767425303073,31,31,0,4
13276,18to17,18,17,0.097457625411555,-5.40650966766633,389,222,167,4
13291,17to12,17,12,0.341226428405902,-4.3283451361004,454,221,233,4
13307,12to11,12,11,0.107086961135131,-4.84475606885961,488,349,139,4
13323,11to10,11,10,0.157247149342697,-4.1849406425977,354,152,202,4
13339,10to15,10,15,0.206357027750737,-6.25914038476218,386,151,235,3
13354,15to16,15,16,0.20029972723023,-4.39906346330505,551,380,171,3
13371,16to21,16,21,0.063191778926881,-4.30603520025247,450,151,299,4
13387,21to22,21,22,0.292280749474335,-3.52655100623945,484,21,463,3
13403,22to17,22,17,0.592869445992129,-3.00767198948471,127,127,0,3
13418,17to12,17,12,0.341226428405902,-4.3283451361004,127,127,0,4
13433,12to7,12,7,0.154545060965099,-4.50562601481829,413,344,69,4
13449,7to6,7,6,0.127778281170675,-2.60864127615384,446,345,101,4
13464,6to5,6,5,0.250996749472847,-3.26885963565415,478,310,168,4
13480,5to0,5,0,0.207187449904921,-4.52153448686886,743,342,401,3
13496,0to1,0,1,0.285634060620011,-3.59718652386282,776,374,402,2
13511,1to6,1,6,0.335153141520956,-4.28446323201056,62,62,0,3
13527,6to11,6,11,0.406123948998114,-2.78764121828662,220,220,0,4
13541,11to6,11,6,0.217522778019429,-3.86045583825618,30,30,0,4
13558,6to5,6,5,0.250996749472847,-3.26885963565415,94,94,0,4
13574,5to10,5,10,0.377309009168647,-4.31182041463593,251,46,205,3
13590,10to15,10,15,0.1150409743548,-6.95236747639564,251,77,174,3
13606,15to10,15,10,0.697437004470863,-3.15146615072379,32,32,0,3
13623,10to11,10,11,0.608402610382962,-5.39824066290983,96,79,17,3
13638,11to12,11,12,0.48921540630235,-3.0499565136602,220,220,0,4
13653,12to17,12,17,0.405361358150691,-3.6777973628509,250,173,77,4
13669,17to12,17,12,0.341226428405902,-4.3283451361004,31,31,0,4
13686,12to13,12,13,0.258415016229279,-4.17337096777961,442,369,73,4
13703,13to8,13,8,0.123629491504229,-5.12027463765366,603,14,589,4
13718,8to9,8,9,0.218643387479463,-2.89449932615566,633,12,621,4
13733,9to4,9,4,0.535698710742184,-3.89026359495794,665,665,0,3
13748,4to3,4,3,0.056457334843507,-5.91721071007648,697,75,622,2
13763,3to2,3,2,0.025056921286733,-6.16791952300049,728,107,621,3
13779,2to7,2,7,0.112170610727522,-5.01792082896674,346,137,209,3
13794,7to12,7,12,0.587860564434599,-1.08244807530145,125,125,0,4
13809,12to17,12,17,0.4241726168058,-3.6777973628509,156,156,0,4
13824,17to16,17,16,0.330677862596307,-4.47007206419405,470,328,142,4
13841,16to11,16,11,0.35005791545864,-2.5941107991399,218,218,0,4
13857,11to6,11,6,0.175209273264287,-4.12944318002833,316,231,85,4
13873,6to5,6,5,0.221799894562594,-3.43076439755891,315,264,51,4
13891,5to0,5,0,0.250378011112812,-4.79890674964258,411,297,114,3
13907,0to1,0,1,0.247169798995095,-3.79426681583363,411,330,81,2
13924,1to2,1,2,0.444589608904174,-4.00189916877652,161,161,0,3
13940,2to3,2,3,0.758431729218555,-3.10668906415368,192,192,0,3
13956,3to4,3,4,0.893217635373611,-2.59423934743162,223,223,0,3
13972,4to9,4,9,0.943542665156493,-3.1010543435794,254,254,0,2
13988,9to14,9,14,0.0754284188488,-5.92303902124888,857,265,592,3
14004,14to13,14,13,0.742374990232186,-2.47515298866317,318,318,0,3
14020,13to12,13,12,0.258126513828114,-4.67892010800286,226,35,191,4
14035,12to17,12,17,0.237927711075782,-4.53620444249692,226,32,194,4
14051,17to18,17,18,0.124253431730354,-5.56967188581356,792,230,562,4
14066,18to13,18,13,0.822241381883683,-3.27389333616027,62,62,0,4
14083,13to8,13,8,0.166017847685816,-5.12027463765366,380,380,0,4
14099,8to3,8,3,0.41767557203112,-2.24723637336358,159,159,0,4
14116,3to4,3,4,0.893217635373611,-2.59423934743162,160,160,0,3
14133,4to9,4,9,0.943542665156493,-3.1010543435794,161,161,0,2
14148,9to8,9,8,0.348656893446813,-4.39213480776326,65,65,0,3
14164,8to13,8,13,0.315218918316722,-2.52867398484387,98,98,0,4
14179,13to14,13,14,0.420658575520422,-4.19054841626589,191,191,0,4
14195,14to19,14,19,0.00540134146833,-7.40583368690429,983,127,856,3
14211,19to24,19,24,0.006343117821432,-7.35323940791315,1014,159,855,3
14227,24to23,24,23,0.135346970331369,-4.41063527475913,1046,128,918,2
14243,23to18,23,18,0.835241103991597,-1.90837129537741,192,159,33,3
14261,18to13,18,13,0.822241381883683,-3.27389333616027,97,97,0,4
14277,13to12,13,12,0.124056815449582,-5.57775279282777,257,26,231,4
14292,12to7,12,7,0.117881835650722,-5.39451490370718,513,57,456,4
14308,7to6,7,6,0.06186302868837,-3.40686744023366,451,91,360,4
14324,6to11,6,11,0.257687235468421,-3.53091243981871,483,124,359,4
14340,11to10,11,10,0.110190087284593,-4.65769268619443,734,387,347,4
14356,10to5,10,5,0.262996974796893,-6.23693498441785,483,483,0,3
14373,5to0,5,0,0.250378011112812,-4.79890674964258,482,482,0,3
14389,0to1,0,1,0.247169798995095,-3.79426681583363,482,482,0,2
14404,1to2,1,2,0.444589608904174,-4.00189916877652,480,480,0,3
14422,2to3,2,3,0.758431729218555,-3.10668906415368,323,323,0,3
14437,3to4,3,4,0.893217635373611,-2.59423934743162,321,321,0,3
14453,4to9,4,9,0.943542665156493,-3.1010543435794,320,320,0,2
14470,9to8,9,8,0.348656893446813,-4.39213480776326,322,322,0,3
14486,8to13,8,13,0.30949132171632,-2.55534065151054,225,219,6,4
14501,13to14,13,14,0.496679041801514,-4.19054841626589,322,322,0,4
14516,14to9,14,9,0.246654709272492,-3.58449160925167,63,63,0,3
14532,9to4,9,4,0.575914687704387,-3.89026359495794,95,95,0,3
14548,4to9,4,9,0.943542665156493,-3.1010543435794,32,32,0,2
14563,9to8,9,8,0.348656893446813,-4.39213480776326,93,93,0,3
14578,8to3,8,3,0.42116906396661,-2.24723637336358,156,156,0,4
14594,3to2,3,2,0.009970824783672,-7.10476162826365,190,12,178,3
14608,2to7,2,7,0.045915545770072,-5.98311070238446,316,11,305,3
14625,7to12,7,12,0.626252924189531,-1.10831014426697,348,339,9,4
14642,12to17,12,17,0.198546393108449,-4.97772009323827,607,339,268,4
14657,17to16,17,16,0.211895709336197,-5.26478995134891,833,171,662,4
14673,16to15,16,15,0.104134436333479,-3.92903904476113,1083,204,879,4
14690,15to10,15,10,0.581615425039658,-3.65718043643807,350,173,177,3
14705,10to11,10,11,0.492697102695746,-5.86805693587571,381,202,179,3
14720,11to6,11,6,0.186878083957904,-4.12944318002833,412,412,0,4
14736,6to5,6,5,0.199560123431713,-3.89918545019049,380,202,178,4
14753,5to0,5,0,0.173681785776454,-5.26206464437942,380,204,176,3
14770,0to1,0,1,0.171031970383031,-4.25883374496749,381,204,177,2
14786,1to2,1,2,0.444589608904174,-4.00189916877652,192,192,0,3
14802,2to3,2,3,0.77822549624831,-3.33436763558226,224,173,51,3
14818,3to4,3,4,0.867944101497623,-2.98934424253652,286,173,113,3
14834,4to9,4,9,0.918156199389221,-3.4996557421808,286,172,114,2
14849,9to8,9,8,0.310073993261079,-4.56695998258844,286,236,50,3
14864,8to13,8,13,0.30949132171632,-2.55534065151054,378,378,0,4
14880,13to14,13,14,0.382180697326112,-4.65756688592288,379,202,177,4
14896,14to13,14,13,0.747943949259178,-2.47515298866317,32,32,0,3
14910,13to18,13,18,0.106004370967864,-6.08272672679385,667,70,597,4
14926,18to19,18,19,0.017516422848229,-7.14827036023176,731,69,662,4
14942,19to14,19,14,0.354885803385146,-3.32881376830512,62,62,0,3
14957,14to13,14,13,0.747943949259178,-2.47515298866317,61,61,0,3
14974,13to12,13,12,0.175643129419872,-5.57775279282777,349,349,0,4
14990,12to17,12,17,0.127720416687642,-5.50358216220379,348,165,183,4
15006,17to22,17,22,0.037859758762703,-7.04421607311094,1619,100,1519,4
15023,22to21,22,21,0.101153132768583,-4.92663652168625,1652,69,1583,3
15039,21to20,21,20,0.052725361126412,-5.31964739675146,2101,102,1999,3
15056,20to15,20,15,0.608040372835582,-3.49831268069198,383,262,121,2
15072,15to10,15,10,0.581615425039658,-3.65718043643807,382,382,0,3
15088,10to11,10,11,0.317452028936032,-6.60434936407414,383,101,282,3
15105,11to6,11,6,0.099491074271423,-4.86191071249587,385,103,282,4
15120,6to7,6,7,0.12293221751373,-4.53892862450634,512,71,441,4
15138,7to12,7,12,0.490325450669209,-1.66318819304745,164,73,91,4
15154,12to13,12,13,0.483018437003712,-4.17337096777961,197,197,0,4
15170,13to14,13,14,0.440821560866383,-4.65756688592288,228,228,0,4
15185,14to9,14,9,0.246654709272492,-3.58449160925167,351,351,0,3
15203,9to4,9,4,0.610029517028035,-3.89026359495794,385,385,0,3
15218,4to3,4,3,0.081843800610779,-5.91721071007648,416,416,0,2
15235,3to8,3,8,0.117891807945778,-4.98570423386988,386,386,0,3
15251,8to13,8,13,0.30949132171632,-2.55534065151054,97,97,0,4
15266,13to18,13,18,0.054758248998317,-6.79901886162531,356,101,255,4
15282,18to23,18,23,0.016169083313329,-7.25183758484574,1055,100,955,4
15297,23to24,23,24,0.028636976517871,-5.3188548700798,1086,166,920,3
15312,24to19,24,19,0.782340327416001,-3.13127813559964,386,164,222,2
15327,19to14,19,14,0.354885803385146,-3.32881376830512,157,157,0,3
15342,14to13,14,13,0.747943949259178,-2.47515298866317,91,91,0,3
15357,13to12,13,12,0.18571144400784,-5.57775279282777,219,219,0,4
15372,12to11,12,11,0.142865961763491,-5.52081240688778,284,92,192,4
15388,11to16,11,16,0.078295349139479,-5.20550968509958,731,91,640,4
15404,16to17,16,17,0.375392422212871,-2.73605655020502,414,322,92,4
15421,17to12,17,12,0.572355161808608,-4.3283451361004,64,64,0,4
15436,12to7,12,7,0.16209853053853,-5.39451490370718,316,316,0,4
15452,7to2,7,2,0.138220748346311,-2.98933348071073,666,420,246,4
15468,2to3,2,3,0.77822549624831,-3.33436763558226,250,250,0,3
15486,3to4,3,4,0.867944101497623,-2.98934424253652,283,283,0,3
15502,4to9,4,9,0.918156199389221,-3.4996557421808,317,317,0,2
15519,9to8,9,8,0.185525487611052,-5.24653744737717,284,91,193,3
15534,8to13,8,13,0.237382863618268,-2.91992398484387,192,122,70,4
15550,13to14,13,14,0.46609058315391,-4.65756688592288,223,223,0,4
15567,14to13,14,13,0.747943949259178,-2.47515298866317,33,33,0,3
15581,13to12,13,12,0.18571144400784,-5.57775279282777,160,160,0,4
15597,12to11,12,11,0.142865961763491,-5.52081240688778,225,225,0,4
15612,11to10,11,10,0.098900082539833,-5.01324824174999,540,348,192,4
15629,10to5,10,5,0.269174587283798,-7.06896186011774,893,150,743,3
15646,5to6,5,6,0.238696310189022,-5.1447723834979,541,185,356,3
15661,6to1,6,1,0.161607034005699,-4.45604604199465,891,149,742,4
15677,1to0,1,0,0.112218236765516,-5.50836717287657,924,181,743,3
15693,0to5,0,5,0.828968029616969,-2.68050265590531,64,64,0,2
15708,5to0,5,0,0.212278653393602,-5.26206464437942,31,31,0,3
15724,0to5,0,5,0.828968029616969,-2.68050265590531,31,31,0,2
15741,5to10,5,10,0.549025036417376,-4.31182041463593,129,129,0,3
15758,10to15,10,15,0.248303165871255,-7.22444724847542,702,511,191,3
15773,15to16,15,16,0.159652435702774,-5.10036216460375,385,115,270,3
15788,16to17,16,17,0.375392422212871,-2.73605655020502,384,384,0,4
15806,17to12,17,12,0.522850740445806,-4.5283451361004,225,180,45,4
15822,12to13,12,13,0.507693659188782,-4.34199841876,255,212,43,4
15838,13to14,13,14,0.430042065865497,-4.80340021925621,288,246,42,4
15855,14to9,14,9,0.210264283257074,-3.7912904761072,353,280,73,3
15871,9to4,9,4,0.720154753656491,-3.89026359495794,385,385,0,3
15888,4to3,4,3,0.069234546636223,-6.09816309102886,420,344,76,2
15903,3to8,3,8,0.10748288543443,-5.08987090053655,384,344,40,3
15918,8to7,8,7,0.024128579975679,-5.23725843944419,482,79,403,4
15934,7to2,7,2,0.064868720015155,-3.82750775456965,482,78,404,4
15948,2to1,2,1,0.087525846594516,-5.61024319004192,287,76,211,3
15963,1to6,1,6,0.223357334677244,-5.04787017207365,317,75,242,3
15980,6to11,6,11,0.378957620495405,-3.651016878461,383,337,46,4
15998,11to12,11,12,0.686798322299739,-3.13328984699353,192,176,16,4
16014,12to13,12,13,0.507693659188782,-4.34199841876,192,192,0,4
16032,13to14,13,14,0.430042065865497,-4.80340021925621,194,194,0,4
16047,14to9,14,9,0.210264283257074,-3.7912904761072,192,192,0,3
16062,9to4,9,4,0.720154753656491,-3.89026359495794,191,191,0,3
16076,4to9,4,9,0.930765453363778,-3.4996557421808,29,29,0,2
16092,9to8,9,8,0.185525487611052,-5.24653744737717,189,189,0,3
16107,8to3,8,3,0.479823868084011,-2.24723637336358,219,219,0,4
16123,3to4,3,4,0.878185887004264,-2.98934424253652,61,61,0,3
16138,4to9,4,9,0.930765453363778,-3.4996557421808,62,62,0,2
16153,9to4,9,4,0.720154753656491,-3.89026359495794,30,30,0,3
16169,4to9,4,9,0.930765453363778,-3.4996557421808,31,31,0,2
16183,9to8,9,8,0.185525487611052,-5.24653744737717,91,91,0,3
16199,8to13,8,13,0.244870985876803,-2.91992398484387,185,185,0,4
16215,13to14,13,14,0.430042065865497,-4.80340021925621,183,183,0,4
16231,14to13,14,13,0.784073462888859,-2.47515298866317,32,32,0,3
16246,13to18,13,18,0.027931655264919,-7.56942702489061,980,225,755,4
16262,18to17,18,17,0.099104641919243,-5.44237464656929,474,457,17,4
16279,17to12,17,12,0.522850740445806,-4.5283451361004,281,281,0,4
16294,12to7,12,7,0.177214656724163,-5.39451490370718,376,376,0,4
16309,7to6,7,6,0.098790935029278,-3.40686744023366,346,346,0,4
16325,6to5,6,5,0.237309512128082,-4.19868628213724,601,421,180,4
16340,5to10,5,10,0.47408109970415,-4.61232124936047,599,419,180,3
16356,10to5,10,5,0.290073932741544,-7.06896186011774,31,31,0,3
16372,5to0,5,0,0.247555551780854,-5.26206464437942,664,664,0,3
16387,0to1,0,1,0.171031970383031,-4.25883374496749,439,439,0,2
16403,1to2,1,2,0.635710893449421,-4.00189916877652,469,469,0,3
16419,2to3,2,3,0.852190159524534,-3.33436763558226,312,312,0,3
16436,3to4,3,4,0.878185887004264,-2.98934424253652,283,283,0,3
16452,4to9,4,9,0.930765453363778,-3.4996557421808,283,283,0,2
16469,9to8,9,8,0.185525487611052,-5.24653744737717,286,286,0,3
16487,8to13,8,13,0.244870985876803,-2.91992398484387,256,256,0,4
16502,13to14,13,14,0.44398352176497,-4.80340021925621,287,287,0,4
16519,14to13,14,13,0.784073462888859,-2.47515298866317,32,32,0,3
16534,13to12,13,12,0.134787721165895,-6.07971357714149,255,127,128,4
16550,12to11,12,11,0.078416591963957,-6.29800538934392,570,127,443,4
16566,11to16,11,16,0.042528822766068,-5.96213011385115,793,193,600,4
16583,16to21,16,21,0.032000847123263,-5.24706084127811,1560,92,1468,4
16600,21to22,21,22,0.153045169080875,-4.46883456960206,1594,92,1502,3
16617,22to23,22,23,0.094625071596246,-5.12915909474863,1335,92,1243,3
16633,23to18,23,18,0.858250292182153,-1.9833066958942,387,358,29,3
16649,18to19,18,19,0.007171083205553,-8.07945958985031,1337,92,1245,4
16666,19to14,19,14,0.260619103038236,-3.77393571952463,164,91,73,3
16682,14to13,14,13,0.658735136375797,-3.10705482915396,163,60,103,3
16698,13to8,13,8,0.229058083323009,-5.7228947249899,229,91,138,4
16713,8to3,8,3,0.479823868084011,-2.24723637336358,294,294,0,4
16729,3to4,3,4,0.878185887004264,-2.98934424253652,293,293,0,3
16745,4to9,4,9,0.893549114097536,-3.97064550327295,293,155,138,2
16761,9to4,9,4,0.720154753656491,-3.89026359495794,32,32,0,3
16775,4to9,4,9,0.893549114097536,-3.97064550327295,30,30,0,2
16790,9to8,9,8,0.185525487611052,-5.24653744737717,92,92,0,3
16806,8to3,8,3,0.479823868084011,-2.24723637336358,93,93,0,4
16821,3to4,3,4,0.878185887004264,-2.98934424253652,60,60,0,3
16837,4to9,4,9,0.893549114097536,-3.97064550327295,62,62,0,2
16853,9to14,9,14,0.094319758732457,-5.92303902124888,187,187,0,3
16870,14to13,14,13,0.658735136375797,-3.10705482915396,188,188,0,3
16885,13to18,13,18,0.016672986058016,-8.36307781854141,252,52,200,4
16900,18to17,18,17,0.042425094760956,-6.36400474061317,638,50,588,4
16917,17to12,17,12,0.522850740445806,-4.5283451361004,383,383,0,4
16935,12to7,12,7,0.193548092723537,-5.39451490370718,641,641,0,4
16950,7to6,7,6,0.098790935029278,-3.40686744023366,641,641,0,4
16966,6to11,6,11,0.410359929383746,-3.651016878461,416,416,0,4
16981,11to6,11,6,0.1277916789843,-4.86191071249587,31,31,0,4
16996,6to5,6,5,0.237309512128082,-4.19868628213724,640,640,0,4
17012,5to10,5,10,0.437189033235537,-4.76113077316999,672,572,100,3
17028,10to15,10,15,0.10980621701103,-8.20948661855416,1270,19,1251,3
17043,15to20,15,20,0.070126211763539,-6.02991062868222,2004,83,1921,3
17060,20to21,20,21,0.22046101716191,-4.76129449165395,477,84,393,2
17075,21to16,21,16,0.607324818989311,-3.67713180789716,509,82,427,3
17092,16to17,16,17,0.394163842246525,-2.73605655020502,192,192,0,4
17109,17to12,17,12,0.522850740445806,-4.5283451361004,192,192,0,4
17126,12to13,12,13,0.554486526341726,-4.34199841876,256,256,0,4
17141,13to14,13,14,0.586086510582842,-4.80340021925621,288,288,0,4
17158,14to13,14,13,0.658735136375797,-3.10705482915396,32,32,0,3
17175,13to8,13,8,0.233684730630449,-5.7228947249899,385,385,0,4
17191,8to3,8,3,0.479823868084011,-2.24723637336358,385,385,0,4
17208,3to4,3,4,0.878185887004264,-2.98934424253652,387,387,0,3
17224,4to9,4,9,0.893549114097536,-3.97064550327295,387,387,0,2
17240,9to4,9,4,0.720154753656491,-3.89026359495794,32,32,0,3
17256,4to9,4,9,0.893549114097536,-3.97064550327295,32,32,0,2
17273,9to8,9,8,0.185525487611052,-5.24653744737717,98,98,0,3
17290,8to3,8,3,0.479823868084011,-2.24723637336358,99,99,0,4
17305,3to4,3,4,0.878185887004264,-2.98934424253652,65,65,0,3
17321,4to9,4,9,0.893549114097536,-3.97064550327295,65,65,0,2
17338,9to14,9,14,0.094319758732457,-5.92303902124888,197,197,0,3
17354,14to13,14,13,0.658735136375797,-3.10705482915396,196,196,0,3
17371,13to12,13,12,0.163555772728692,-6.07971357714149,262,262,0,4
17388,12to7,12,7,0.149519264116827,-5.70577318185287,453,312,141,4
17403,7to2,7,2,0.033656232277201,-4.51650775456965,1000,311,689,4
17419,2to3,2,3,0.852190159524534,-3.33436763558226,129,129,0,3
17435,3to4,3,4,0.878185887004264,-2.98934424253652,130,130,0,3
17451,4to9,4,9,0.893549114097536,-3.97064550327295,130,130,0,2
17466,9to8,9,8,0.185525487611052,-5.24653744737717,193,193,0,3
17480,8to13,8,13,0.244870985876803,-2.91992398484387,126,126,0,4
17495,13to14,13,14,0.586086510582842,-4.80340021925621,157,157,0,4
17510,14to9,14,9,0.332315855710835,-3.7912904761072,59,59,0,3
17527,9to4,9,4,0.720154753656491,-3.89026359495794,92,92,0,3
17543,4to9,4,9,0.893549114097536,-3.97064550327295,33,33,0,2
17559,9to8,9,8,0.185525487611052,-5.24653744737717,93,93,0,3
17576,8to3,8,3,0.479823868084011,-2.24723637336358,157,157,0,4
17592,3to4,3,4,0.878185887004264,-2.98934424253652,65,65,0,3
17608,4to9,4,9,0.893549114097536,-3.97064550327295,65,65,0,2
17624,9to4,9,4,0.720154753656491,-3.89026359495794,32,32,0,3
17638,4to9,4,9,0.893549114097536,-3.97064550327295,30,30,0,2
17652,9to8,9,8,0.185525487611052,-5.24653744737717,93,93,0,3
17668,8to13,8,13,0.244870985876803,-2.91992398484387,188,188,0,4
17683,13to8,13,8,0.233684730630449,-5.7228947249899,31,31,0,4
17700,8to9,8,9,0.251176566063506,-2.89449932615566,62,62,0,4
17716,9to4,9,4,0.720154753656491,-3.89026359495794,92,92,0,3
17733,4to3,4,3,0.106450885902464,-6.09816309102886,157,157,0,2
17748,3to4,3,4,0.878185887004264,-2.98934424253652,32,32,0,3
17764,4to9,4,9,0.893549114097536,-3.97064550327295,64,64,0,2
17780,9to14,9,14,0.094319758732457,-5.92303902124888,285,285,0,3
17795,14to13,14,13,0.658735136375797,-3.10705482915396,127,127,0,3
17812,13to12,13,12,0.163555772728692,-6.07971357714149,441,441,0,4
17828,12to17,12,17,0.142638274518349,-5.80113651002987,736,517,219,4
17845,17to22,17,22,0.018087840001176,-7.91730844258885,1245,158,1087,4
17860,22to23,22,23,0.042878053748373,-5.97630310118467,1243,190,1053,3
17876,23to18,23,18,0.748464444962349,-2.6937002377711,991,287,704,3
17892,18to13,18,13,0.932483492717726,-3.27389333616027,97,97,0,4
17908,13to14,13,14,0.586086510582842,-4.80340021925621,128,128,0,4
17924,14to9,14,9,0.332315855710835,-3.7912904761072,160,160,0,3
17941,9to4,9,4,0.720154753656491,-3.89026359495794,193,193,0,3
17957,4to3,4,3,0.106450885902464,-6.09816309102886,224,224,0,2
17972,3to8,3,8,0.10748288543443,-5.08987090053655,289,289,0,3
17988,8to13,8,13,0.244870985876803,-2.91992398484387,96,96,0,4
18004,13to14,13,14,0.586086510582842,-4.80340021925621,96,96,0,4
18019,14to9,14,9,0.184341910186455,-4.58076416031773,95,20,75,3
18034,9to4,9,4,0.534638862808498,-4.69671520786117,93,18,75,3
18050,4to9,4,9,0.893549114097536,-3.97064550327295,31,31,0,2
18067,9to8,9,8,0.165536255798715,-6.05706376316664,95,18,77,3
18082,8to3,8,3,0.334311561413772,-2.85523637336358,125,49,76,4
18099,3to4,3,4,0.878185887004264,-2.98934424253652,65,65,0,3
18114,4to9,4,9,0.893549114097536,-3.97064550327295,64,64,0,2
18130,9to14,9,14,0.111673662792163,-6.54208664029649,126,48,78,3
18145,14to13,14,13,0.713595683444191,-3.61023954252976,157,78,79,3
18160,13to12,13,12,0.162379834800878,-6.08833426679666,348,345,3,4
18176,12to7,12,7,0.082139116165928,-6.43800668439094,788,211,577,4
18192,7to6,7,6,0.051299090094471,-4.15005488862342,1211,311,900,4
18208,6to11,6,11,0.2623141482275,-4.32251446300207,1242,408,834,4
18223,11to10,11,10,0.061188931819864,-5.65156368353364,1211,438,773,4
18239,10to5,10,5,0.202084652173064,-7.7946255769319,1243,341,902,3
18254,5to0,5,0,0.137001792524653,-6.08193712046869,1882,339,1543,3
18269,0to1,0,1,0.083269216450442,-5.07923757068481,1882,338,1544,2
18284,1to2,1,2,0.484266647154477,-4.62164945254497,881,335,546,3
18298,2to3,2,3,0.852190159524534,-3.33436763558226,216,216,0,3
18313,3to4,3,4,0.878185887004264,-2.98934424253652,214,214,0,3
18330,4to9,4,9,0.893549114097536,-3.97064550327295,216,216,0,2
18346,9to8,9,8,0.181381721698866,-6.05706376316664,279,279,0,3
18362,8to7,8,7,0.030878227092332,-5.23725843944419,186,186,0,4
18378,7to12,7,12,0.616796847170953,-1.66318819304745,218,218,0,4
18394,12to13,12,13,0.668089812271977,-4.34199841876,249,249,0,4
18408,13to14,13,14,0.586910476287074,-4.80340021925621,278,278,0,4
18424,14to19,14,19,0.006190320118422,-8.36752382774936,1775,68,1707,3
18439,19to18,19,18,0.545617492144943,-3.56344379095554,563,100,463,3
18455,18to13,18,13,0.932483492717726,-3.27389333616027,61,61,0,4
18472,13to14,13,14,0.586910476287074,-4.80340021925621,64,64,0,4
18488,14to9,14,9,0.273074996034087,-4.58076416031773,158,158,0,3
18502,9to4,9,4,0.706944615508971,-4.69671520786117,189,189,0,3
18518,4to3,4,3,0.106450885902464,-6.09816309102886,220,220,0,2
18534,3to8,3,8,0.10748288543443,-5.08987090053655,188,188,0,3
18551,8to13,8,13,0.313370364847355,-2.91992398484387,96,96,0,4
18567,13to14,13,14,0.586910476287074,-4.80340021925621,95,95,0,4
18582,14to9,14,9,0.273074996034087,-4.58076416031773,94,94,0,3
18598,9to4,9,4,0.706944615508971,-4.69671520786117,96,96,0,3
18614,4to9,4,9,0.893549114097536,-3.97064550327295,32,32,0,2
18629,9to8,9,8,0.181381721698866,-6.05706376316664,95,95,0,3
18645,8to3,8,3,0.334311561413772,-2.85523637336358,127,127,0,4
18661,3to4,3,4,0.878185887004264,-2.98934424253652,63,63,0,3
18677,4to9,4,9,0.893549114097536,-3.97064550327295,63,63,0,2
18693,9to14,9,14,0.111673662792163,-6.54208664029649,126,126,0,3
18709,14to13,14,13,0.720734683847491,-3.61023954252976,158,158,0,3
18726,13to12,13,12,0.162379834800878,-6.08833426679666,348,348,0,4
18741,12to17,12,17,0.096478944653179,-6.34440047498059,913,417,496,4
18755,17to16,17,16,0.113781987008227,-6.25407566563462,1680,18,1662,4
18772,16to11,16,11,0.41810489952449,-2.74127391970728,564,481,83,4
18787,11to6,11,6,0.134776694165542,-4.86191071249587,595,595,0,4
18803,6to5,6,5,0.296892762740767,-4.19868628213724,564,564,0,4
18820,5to10,5,10,0.491916182156536,-4.84655790884839,597,546,51,3
18837,10to15,10,15,0.056057268606777,-9.1624993327609,1809,85,1724,3
18853,15to20,15,20,0.027759557703367,-7.00118134691426,1810,52,1758,3
18869,20to21,20,21,0.096717879550783,-5.73254932858043,1809,52,1757,2
18884,21to22,21,22,0.127917206322995,-5.41974891031428,1039,51,988,3
18900,22to17,22,17,0.834632275394012,-3.00767198948471,159,159,0,3
18915,17to12,17,12,0.639070484261203,-4.5283451361004,189,189,0,4
18931,12to13,12,13,0.714602790551886,-4.34199841876,222,222,0,4
18947,13to14,13,14,0.586910476287074,-4.80340021925621,254,254,0,4
18963,14to9,14,9,0.273074996034087,-4.58076416031773,286,286,0,3
18979,9to4,9,4,0.706944615508971,-4.69671520786117,318,318,0,3
18995,4to3,4,3,0.106450885902464,-6.09816309102886,350,350,0,2
19010,3to8,3,8,0.10748288543443,-5.08987090053655,381,381,0,3
19026,8to13,8,13,0.313370364847355,-2.91992398484387,95,95,0,4
19042,13to18,13,18,0.007453104562075,-9.17899821655136,603,111,492,4
19059,18to23,18,23,0.006922623501473,-8.1876174013595,1199,77,1122,4
19076,23to24,23,24,0.021252931200275,-6.2894820201195,3779,111,3668,3
19092,24to19,24,19,0.621266183891014,-3.91570927332419,668,144,524,2
19109,19to14,19,14,0.442051432234323,-3.77393571952463,162,162,0,3
19124,14to13,14,13,0.720734683847491,-3.61023954252976,98,98,0,3
19140,13to12,13,12,0.163906249517059,-6.08833426679666,225,225,0,4
19156,12to7,12,7,0.087857710965577,-6.43800668439094,794,794,0,4
19173,7to8,7,8,0.296344107594283,-2.39620659892225,163,163,0,4
19190,8to9,8,9,0.321439846646541,-2.89449932615566,227,227,0,4
19205,9to4,9,4,0.706944615508971,-4.69671520786117,226,226,0,3
19220,4to3,4,3,0.106450885902464,-6.09816309102886,225,225,0,2
19237,3to2,3,2,0.014331227561306,-7.10476162826365,953,953,0,3
19252,2to1,2,1,0.087525846594516,-5.61024319004192,983,983,0,3
19268,1to0,1,0,0.199520693657097,-5.50836717287657,1014,1014,0,3
19284,0to5,0,5,0.916730783549558,-2.68050265590531,481,481,0,2
19300,5to10,5,10,0.491916182156536,-4.84655790884839,480,480,0,3
19317,10to11,10,11,0.723806282199167,-6.60434936407414,545,545,0,3
19341,11to16,11,16,0.017211552917447,-6.94847823671805,586,8,578,4
19360,16to17,16,17,0.213827003665814,-3.71649133281372,460,9,451,4
19376,17to12,17,12,0.473366721716741,-5.20631123779532,236,76,160,4
19393,12to13,12,13,0.641820044923246,-4.67657090946632,269,179,90,4
19409,13to14,13,14,0.520158250173282,-5.09673355258954,300,212,88,4
19425,14to9,14,9,0.273074996034087,-4.58076416031773,235,235,0,3
19440,9to4,9,4,0.706944615508971,-4.69671520786117,235,235,0,3
19455,4to3,4,3,0.094903828105985,-6.22582266549694,235,205,30,2
19470,3to8,3,8,0.090133969565323,-5.28515709582274,297,239,58,3
19486,8to3,8,3,0.334311561413772,-2.85523637336358,31,31,0,4
19504,3to4,3,4,0.895256229771294,-2.98934424253652,64,64,0,3
19519,4to9,4,9,0.905096171894015,-3.97064550327295,94,94,0,2
19535,9to14,9,14,0.111673662792163,-6.54208664029649,126,126,0,3
19552,14to13,14,13,0.720734683847491,-3.61023954252976,159,159,0,3
19567,13to12,13,12,0.192969544961502,-6.08833426679666,191,191,0,4
19583,12to7,12,7,0.084106281946768,-6.73777249235347,427,299,128,4
19598,7to6,7,6,0.051299090094471,-4.15005488862342,811,811,0,4
19614,6to5,6,5,0.296892762740767,-4.19868628213724,330,330,0,4
19629,5to6,5,6,0.365071734029066,-5.1447723834979,31,31,0,3
19644,6to1,6,1,0.229524836922959,-4.45604604199465,392,392,0,4
19661,1to2,1,2,0.466622484338247,-4.6924041695261,424,394,30,3
19678,2to3,2,3,0.852190159524534,-3.33436763558226,192,192,0,3
19693,3to4,3,4,0.895256229771294,-2.98934424253652,189,189,0,3
19710,4to9,4,9,0.905096171894015,-3.97064550327295,191,191,0,2
19728,9to8,9,8,0.181381721698866,-6.05706376316664,258,258,0,3
19742,8to13,8,13,0.313370364847355,-2.91992398484387,190,190,0,4
19758,13to12,13,12,0.192969544961502,-6.08833426679666,191,191,0,4
19775,12to11,12,11,0.130562020058175,-6.29800538934392,458,458,0,4
19791,11to10,11,10,0.062959734854889,-5.65156368353364,491,491,0,4
19806,10to11,10,11,0.723806282199167,-6.60434936407414,31,31,0,3
19822,11to12,11,12,0.781151590779268,-3.13328984699353,64,64,0,4
19838,12to7,12,7,0.084106281946768,-6.73777249235347,255,255,0,4
19854,7to8,7,8,0.296344107594283,-2.39620659892225,126,126,0,4
19870,8to3,8,3,0.334311561413772,-2.85523637336358,192,192,0,4
19887,3to4,3,4,0.895256229771294,-2.98934424253652,194,194,0,3
19904,4to9,4,9,0.905096171894015,-3.97064550327295,194,194,0,2
19920,9to14,9,14,0.111673662792163,-6.54208664029649,385,385,0,3
19935,14to13,14,13,0.720734683847491,-3.61023954252976,193,193,0,3
19951,13to8,13,8,0.278097541299112,-5.7228947249899,97,97,0,4
19967,8to3,8,3,0.334311561413772,-2.85523637336358,97,97,0,4
19984,3to4,3,4,0.895256229771294,-2.98934424253652,97,97,0,3
20000,4to9,4,9,0.905096171894015,-3.97064550327295,96,96,0,2
20015,9to4,9,4,0.706944615508971,-4.69671520786117,31,31,0,3
20032,4to9,4,9,0.905096171894015,-3.97064550327295,32,32,0,2
20048,9to8,9,8,0.181381721698866,-6.05706376316664,97,97,0,3
20063,8to13,8,13,0.313370364847355,-2.91992398484387,128,128,0,4
20079,13to14,13,14,0.520158250173282,-5.09673355258954,159,159,0,4
20095,14to9,14,9,0.273074996034087,-4.58076416031773,63,63,0,3
20110,9to4,9,4,0.706944615508971,-4.69671520786117,95,95,0,3
20126,4to9,4,9,0.905096171894015,-3.97064550327295,31,31,0,2
20141,9to8,9,8,0.181381721698866,-6.05706376316664,93,93,0,3
20157,8to3,8,3,0.334311561413772,-2.85523637336358,190,190,0,4
20173,3to4,3,4,0.895256229771294,-2.98934424253652,63,63,0,3
20189,4to9,4,9,0.905096171894015,-3.97064550327295,63,63,0,2
20205,9to14,9,14,0.111673662792163,-6.54208664029649,126,126,0,3
20221,14to13,14,13,0.720734683847491,-3.61023954252976,158,158,0,3
20237,13to12,13,12,0.097651119229682,-6.88110535113401,415,86,329,4
20253,12to17,12,17,0.054532947150405,-7.24809588371519,893,86,807,4
20268,17to22,17,22,0.012539932932009,-8.85661480097035,1384,84,1300,4
20285,22to21,22,21,0.060278708048468,-5.7041788945676,1416,315,1101,3
20302,21to16,21,16,0.580773796615051,-4.34934824910423,961,315,646,3
20319,16to11,16,11,0.567014403904434,-2.74127391970728,513,513,0,4
20337,11to6,11,6,0.081377331187988,-5.45936833961451,708,285,423,4
20354,6to5,6,5,0.192723660249514,-4.76895655240751,740,318,422,4
20369,5to10,5,10,0.39447696408157,-5.24275168047468,578,349,229,3
20385,10to15,10,15,0.027201055441996,-9.91572930692111,1548,382,1166,3
20400,15to20,15,20,0.010975236257141,-7.94623629196921,1547,85,1462,3
20416,20to15,20,15,0.881679356998433,-3.72411913230489,31,24,7,2
20432,15to10,15,10,0.800068493683384,-3.65718043643807,63,63,0,3
20448,10to11,10,11,0.679495897446061,-6.92993075942298,129,87,42,3
20465,11to12,11,12,0.833117959521852,-3.13328984699353,228,228,0,4
20480,12to13,12,13,0.713605314102285,-4.67657090946632,259,259,0,4
20496,13to14,13,14,0.581594178927135,-5.09673355258954,291,291,0,4
20511,14to9,14,9,0.273074996034087,-4.58076416031773,322,322,0,3
20527,9to4,9,4,0.706944615508971,-4.69671520786117,354,354,0,3
20543,4to3,4,3,0.094903828105985,-6.22582266549694,386,386,0,2
20558,3to8,3,8,0.090133969565323,-5.28515709582274,417,417,0,3
20574,8to13,8,13,0.313370364847355,-2.91992398484387,94,94,0,4
20591,13to14,13,14,0.581594178927135,-5.09673355258954,95,95,0,4
20606,14to9,14,9,0.273074996034087,-4.58076416031773,95,95,0,3
20622,9to4,9,4,0.706944615508971,-4.69671520786117,95,95,0,3
20639,4to9,4,9,0.905096171894015,-3.97064550327295,33,33,0,2
20655,9to8,9,8,0.181381721698866,-6.05706376316664,97,97,0,3
20670,8to3,8,3,0.334311561413772,-2.85523637336358,127,127,0,4
20688,3to4,3,4,0.895256229771294,-2.98934424253652,66,66,0,3
20705,4to9,4,9,0.905096171894015,-3.97064550327295,66,66,0,2
20721,9to14,9,14,0.111673662792163,-6.54208664029649,130,130,0,3
20738,14to13,14,13,0.720734683847491,-3.61023954252976,164,164,0,3
20755,13to12,13,12,0.097651119229682,-6.88110535113401,290,290,0,4
20771,12to7,12,7,0.067821444530042,-7.0550286552688,933,637,296,4
20786,7to2,7,2,0.023973288064634,-4.92272997679187,1125,668,457,4
20804,2to1,2,1,0.060806258327066,-6.00334663831778,1160,704,456,3
20820,1to0,1,0,0.133210863201494,-6.03414036875286,1552,736,816,3
20836,0to5,0,5,0.916730783549558,-2.68050265590531,482,482,0,2
20852,5to6,5,6,0.43508440330881,-5.1447723834979,515,515,0,3
20869,6to11,6,11,0.301177394036391,-4.32251446300207,421,421,0,4
20886,11to12,11,12,0.833117959521852,-3.13328984699353,131,131,0,4
20902,12to13,12,13,0.73167482106524,-4.67657090946632,164,164,0,4
20918,13to12,13,12,0.097651119229682,-6.88110535113401,32,32,0,4
20932,12to17,12,17,0.025304360209382,-8.07283815175643,679,119,560,4
20949,17to16,17,16,0.082645819732976,-7.07014985419722,647,119,528,4
20966,16to15,16,15,0.172883780903454,-3.92903904476113,550,550,0,4
20983,15to10,15,10,0.800068493683384,-3.65718043643807,551,551,0,3
21001,10to11,10,11,0.679495897446061,-6.92993075942298,132,132,0,3
21017,11to12,11,12,0.833117959521852,-3.13328984699353,99,99,0,4
21033,12to13,12,13,0.755397396282799,-4.67657090946632,131,131,0,4
21050,13to14,13,14,0.581594178927135,-5.09673355258954,329,329,0,4
21066,14to9,14,9,0.273074996034087,-4.58076416031773,361,361,0,3
21083,9to4,9,4,0.706944615508971,-4.69671520786117,395,395,0,3
21099,4to3,4,3,0.094903828105985,-6.22582266549694,429,429,0,2
21115,3to8,3,8,0.090133969565323,-5.28515709582274,460,460,0,3
21131,8to13,8,13,0.313370364847355,-2.91992398484387,98,98,0,4
21147,13to14,13,14,0.581594178927135,-5.09673355258954,97,97,0,4
21164,14to9,14,9,0.273074996034087,-4.58076416031773,98,98,0,3
21179,9to4,9,4,0.706944615508971,-4.69671520786117,96,96,0,3
21196,4to9,4,9,0.905096171894015,-3.97064550327295,32,32,0,2
21211,9to8,9,8,0.181381721698866,-6.05706376316664,96,96,0,3
21227,8to3,8,3,0.334311561413772,-2.85523637336358,128,128,0,4
21243,3to4,3,4,0.895256229771294,-2.98934424253652,64,64,0,3
21258,4to9,4,9,0.905096171894015,-3.97064550327295,62,62,0,2
21275,9to14,9,14,0.111673662792163,-6.54208664029649,128,128,0,3
21292,14to13,14,13,0.720734683847491,-3.61023954252976,161,161,0,3
21308,13to12,13,12,0.097651119229682,-6.88110535113401,291,291,0,4
21323,12to11,12,11,0.064274194722392,-7.23589358810168,322,20,302,4
21339,11to6,11,6,0.081377331187988,-5.45936833961451,487,487,0,4
21355,6to1,6,1,0.263530170668231,-4.45604604199465,551,551,0,4
21372,1to2,1,2,0.509622119829289,-4.6924041695261,586,586,0,3
21389,2to3,2,3,0.877144477521473,-3.33436763558226,162,162,0,3
21406,3to4,3,4,0.895256229771294,-2.98934424253652,163,163,0,3
21420,4to3,4,3,0.062573876792574,-6.67743556872275,31,17,14,2
21435,3to8,3,8,0.037667162442012,-6.21372852439417,224,16,208,3
21451,8to9,8,9,0.321439846646541,-2.89449932615566,193,193,0,4
21467,9to4,9,4,0.706944615508971,-4.69671520786117,61,61,0,3
21482,4to9,4,9,0.937426123207426,-3.97064550327295,31,31,0,2
21499,9to14,9,14,0.053737896449964,-7.33672949743935,224,46,178,3
21514,14to13,14,13,0.574310541533209,-4.25888819117841,222,78,144,3
21532,13to8,13,8,0.310943662125192,-5.7228947249899,97,97,0,4
21549,8to3,8,3,0.334311561413772,-2.85523637336358,129,129,0,4
21565,3to4,3,4,0.946880572654952,-2.98934424253652,98,98,0,3
21581,4to9,4,9,0.937426123207426,-3.97064550327295,99,99,0,2
21596,9to4,9,4,0.753050845106689,-4.69671520786117,31,31,0,3
21611,4to9,4,9,0.937426123207426,-3.97064550327295,30,30,0,2
21626,9to8,9,8,0.193211258443348,-6.05706376316664,94,94,0,3
21641,8to13,8,13,0.313370364847355,-2.91992398484387,127,127,0,4
21656,13to14,13,14,0.581594178927135,-5.09673355258954,157,157,0,4
21671,14to19,14,19,0.003681970425026,-9.31440246287926,2579,137,2442,3
21686,19to18,19,18,0.320063257000256,-4.49990370018398,2644,168,2476,3
21701,18to13,18,13,0.942483942169855,-3.27389333616027,60,60,0,4
21717,13to12,13,12,0.097651119229682,-6.88110535113401,409,409,0,4
21733,12to7,12,7,0.042892877581653,-7.67665027689042,962,364,598,4
21749,7to8,7,8,0.29990435017528,-2.39620659892225,123,123,0,4
21764,8to3,8,3,0.334311561413772,-2.85523637336358,215,215,0,4
21781,3to4,3,4,0.946880572654952,-2.98934424253652,185,185,0,3
21796,4to3,4,3,0.062573876792574,-6.67743556872275,32,32,0,2
21813,3to4,3,4,0.946880572654952,-2.98934424253652,32,32,0,3
21830,4to9,4,9,0.937426123207426,-3.97064550327295,219,219,0,2
21846,9to8,9,8,0.193211258443348,-6.05706376316664,97,97,0,3
21862,8to13,8,13,0.313370364847355,-2.91992398484387,161,161,0,4
21879,13to14,13,14,0.581594178927135,-5.09673355258954,223,223,0,4
21895,14to9,14,9,0.418671395394238,-4.58076416031773,65,65,0,3
21913,9to4,9,4,0.753050845106689,-4.69671520786117,100,100,0,3
21930,4to9,4,9,0.937426123207426,-3.97064550327295,35,35,0,2
21946,9to8,9,8,0.193211258443348,-6.05706376316664,100,100,0,3
21961,8to3,8,3,0.334311561413772,-2.85523637336358,165,165,0,4
21977,3to4,3,4,0.946880572654952,-2.98934424253652,64,64,0,3
21992,4to9,4,9,0.937426123207426,-3.97064550327295,62,62,0,2
22006,9to4,9,4,0.753050845106689,-4.69671520786117,29,29,0,3
22020,4to9,4,9,0.937426123207426,-3.97064550327295,28,28,0,2
22037,9to8,9,8,0.193211258443348,-6.05706376316664,91,91,0,3
22051,8to13,8,13,0.313370364847355,-2.91992398484387,189,189,0,4
22067,13to14,13,14,0.581594178927135,-5.09673355258954,188,188,0,4
22083,14to9,14,9,0.418671395394238,-4.58076416031773,63,63,0,3
22100,9to4,9,4,0.753050845106689,-4.69671520786117,94,94,0,3
22114,4to9,4,9,0.937426123207426,-3.97064550327295,31,31,0,2
22129,9to8,9,8,0.193211258443348,-6.05706376316664,92,92,0,3
22146,8to3,8,3,0.334311561413772,-2.85523637336358,185,185,0,4
22163,3to4,3,4,0.946880572654952,-2.98934424253652,63,63,0,3
22179,4to9,4,9,0.937426123207426,-3.97064550327295,65,65,0,2
22196,9to4,9,4,0.753050845106689,-4.69671520786117,33,33,0,3
22212,4to9,4,9,0.937426123207426,-3.97064550327295,33,33,0,2
22228,9to8,9,8,0.193211258443348,-6.05706376316664,99,99,0,3
22243,8to13,8,13,0.313370364847355,-2.91992398484387,192,192,0,4
22260,13to14,13,14,0.581594178927135,-5.09673355258954,193,193,0,4
22276,14to9,14,9,0.418671395394238,-4.58076416031773,64,64,0,3
22292,9to4,9,4,0.753050845106689,-4.69671520786117,96,96,0,3
22308,4to3,4,3,0.062573876792574,-6.67743556872275,162,162,0,2
22324,3to4,3,4,0.946880572654952,-2.98934424253652,32,32,0,3
22340,4to9,4,9,0.937426123207426,-3.97064550327295,64,64,0,2
22357,9to8,9,8,0.193211258443348,-6.05706376316664,129,129,0,3
22374,8to13,8,13,0.313370364847355,-2.91992398484387,131,131,0,4
22391,13to14,13,14,0.581594178927135,-5.09673355258954,131,131,0,4
22407,14to9,14,9,0.418671395394238,-4.58076416031773,67,67,0,3
22423,9to4,9,4,0.753050845106689,-4.69671520786117,99,99,0,3
22440,4to9,4,9,0.937426123207426,-3.97064550327295,33,33,0,2
22456,9to8,9,8,0.193211258443348,-6.05706376316664,99,99,0,3
22472,8to3,8,3,0.334311561413772,-2.85523637336358,164,164,0,4
22488,3to4,3,4,0.946880572654952,-2.98934424253652,65,65,0,3
22504,4to9,4,9,0.937426123207426,-3.97064550327295,64,64,0,2
22520,9to4,9,4,0.753050845106689,-4.69671520786117,32,32,0,3
22537,4to9,4,9,0.937426123207426,-3.97064550327295,33,33,0,2
22553,9to8,9,8,0.193211258443348,-6.05706376316664,97,97,0,3
22569,8to13,8,13,0.313370364847355,-2.91992398484387,195,195,0,4
22586,13to14,13,14,0.581594178927135,-5.09673355258954,195,195,0,4
22601,14to9,14,9,0.418671395394238,-4.58076416031773,64,64,0,3
22617,9to4,9,4,0.753050845106689,-4.69671520786117,97,97,0,3
22633,4to9,4,9,0.937426123207426,-3.97064550327295,32,32,0,2
22648,9to8,9,8,0.193211258443348,-6.05706376316664,95,95,0,3
22664,8to3,8,3,0.334311561413772,-2.85523637336358,192,192,0,4
22680,3to4,3,4,0.946880572654952,-2.98934424253652,63,63,0,3
22697,4to9,4,9,0.937426123207426,-3.97064550327295,64,64,0,2
22712,9to4,9,4,0.753050845106689,-4.69671520786117,32,32,0,3
22728,4to9,4,9,0.937426123207426,-3.97064550327295,31,31,0,2
22744,9to8,9,8,0.090769306330258,-6.93206376316664,96,12,84,3
22761,8to13,8,13,0.175834819379642,-3.68034065151054,192,46,146,4
22777,13to12,13,12,0.049115275037752,-7.62072799264345,1060,276,784,4
22793,12to11,12,11,0.030060807507892,-8.07058746565271,1470,243,1227,4
22810,11to10,11,10,0.056505474273957,-5.83547172951065,1827,1491,336,4
22826,10to5,10,5,0.237720704862492,-8.04588185833893,1990,1490,500,3
22843,5to6,5,6,0.258262428736613,-5.93865536222131,1504,310,1194,3
22859,6to1,6,1,0.263530170668231,-4.45604604199465,1504,1504,0,4
22875,1to2,1,2,0.507294114431126,-4.70171887345158,1503,1489,14,3
22891,2to3,2,3,0.831405135119715,-3.70441168844569,227,143,84,3
22907,3to4,3,4,0.931754863244183,-3.25601090920318,195,143,52,3
22923,4to9,4,9,0.91945723094662,-4.24244037506782,195,142,53,2
22940,9to14,9,14,0.034301176705918,-7.93277469517946,354,143,211,3
22956,14to13,14,13,0.577646634180736,-4.25888819117841,195,195,0,3
22973,13to14,13,14,0.612877161654662,-5.09673355258954,33,33,0,4
22988,14to9,14,9,0.418671395394238,-4.58076416031773,65,65,0,3
23005,9to4,9,4,0.87239224690158,-4.69671520786117,98,98,0,3
23020,4to9,4,9,0.91945723094662,-4.24244037506782,32,32,0,2
23036,9to8,9,8,0.093306576392503,-6.93206376316664,292,292,0,3
23052,8to3,8,3,0.401275934346765,-2.85523637336358,161,161,0,4
23069,3to4,3,4,0.931754863244183,-3.25601090920318,64,64,0,3
23085,4to3,4,3,0.08054276905338,-6.67743556872275,33,33,0,2
23099,3to4,3,4,0.931754863244183,-3.25601090920318,30,30,0,3
23114,4to9,4,9,0.91945723094662,-4.24244037506782,94,94,0,2
23130,9to4,9,4,0.87239224690158,-4.69671520786117,31,31,0,3
23146,4to9,4,9,0.91945723094662,-4.24244037506782,32,32,0,2
23161,9to4,9,4,0.87239224690158,-4.69671520786117,31,31,0,3
23176,4to9,4,9,0.91945723094662,-4.24244037506782,30,30,0,2
23192,9to4,9,4,0.87239224690158,-4.69671520786117,31,31,0,3
23209,4to9,4,9,0.91945723094662,-4.24244037506782,33,33,0,2
23224,9to8,9,8,0.093306576392503,-6.93206376316664,188,188,0,3
23241,8to3,8,3,0.401275934346765,-2.85523637336358,156,156,0,4
23258,3to4,3,4,0.931754863244183,-3.25601090920318,66,66,0,3
23275,4to9,4,9,0.91945723094662,-4.24244037506782,66,66,0,2
23289,9to4,9,4,0.87239224690158,-4.69671520786117,31,31,0,3
23305,4to9,4,9,0.91945723094662,-4.24244037506782,30,30,0,2
23320,9to4,9,4,0.87239224690158,-4.69671520786117,31,31,0,3
23335,4to9,4,9,0.91945723094662,-4.24244037506782,30,30,0,2
23351,9to4,9,4,0.87239224690158,-4.69671520786117,31,31,0,3
23367,4to9,4,9,0.91945723094662,-4.24244037506782,32,32,0,2
23381,9to4,9,4,0.87239224690158,-4.69671520786117,30,30,0,3
23397,4to9,4,9,0.91945723094662,-4.24244037506782,30,30,0,2
23413,9to4,9,4,0.87239224690158,-4.69671520786117,32,32,0,3
23430,4to9,4,9,0.91945723094662,-4.24244037506782,33,33,0,2
23446,9to8,9,8,0.093306576392503,-6.93206376316664,222,222,0,3
23461,8to13,8,13,0.175834819379642,-3.68034065151054,505,505,0,4
23476,13to14,13,14,0.612877161654662,-5.09673355258954,503,503,0,4
23492,14to9,14,9,0.418671395394238,-4.58076416031773,62,62,0,3
23508,9to4,9,4,0.87239224690158,-4.69671520786117,95,95,0,3
23523,4to3,4,3,0.08054276905338,-6.67743556872275,282,282,0,2
23539,3to4,3,4,0.931754863244183,-3.25601090920318,31,31,0,3
23553,4to9,4,9,0.91945723094662,-4.24244037506782,61,61,0,2
23568,9to4,9,4,0.87239224690158,-4.69671520786117,29,29,0,3
23584,4to9,4,9,0.868368303977925,-4.79082747184201,31,14,17,2
23599,9to4,9,4,0.87239224690158,-4.69671520786117,31,31,0,3
23615,4to9,4,9,0.868368303977925,-4.79082747184201,31,31,0,2
23631,9to8,9,8,0.045822435473441,-7.6942259253288,185,44,141,3
23647,8to7,8,7,0.014281977109729,-6.21426993369706,1914,44,1870,4
23663,7to6,7,6,0.020837356534274,-5.09517683984293,820,45,775,4
23679,6to11,6,11,0.301177394036391,-4.32251446300207,886,886,0,4
23695,11to12,11,12,0.842622797892552,-3.13328984699353,918,918,0,4
23712,12to13,12,13,0.895371578258555,-4.67657090946632,251,251,0,4
23729,13to14,13,14,0.537708780919149,-5.40503394784646,253,175,78,4
23745,14to9,14,9,0.418671395394238,-4.58076416031773,130,130,0,3
23760,9to4,9,4,0.918080012258642,-4.69671520786117,161,161,0,3
23776,4to3,4,3,0.131631696022075,-6.67743556872275,253,253,0,2
23792,3to2,3,2,0.019852283509098,-7.10476162826365,917,917,0,3
23808,2to3,2,3,0.831405135119715,-3.70441168844569,32,32,0,3
23824,3to4,3,4,0.931754863244183,-3.25601090920318,64,64,0,3
23841,4to9,4,9,0.868368303977925,-4.79082747184201,96,96,0,2
23857,9to4,9,4,0.918080012258642,-4.69671520786117,33,33,0,3
23873,4to9,4,9,0.868368303977925,-4.79082747184201,32,32,0,2
23888,9to4,9,4,0.918080012258642,-4.69671520786117,31,31,0,3
23904,4to9,4,9,0.868368303977925,-4.79082747184201,31,31,0,2
23920,9to8,9,8,0.045822435473441,-7.6942259253288,289,289,0,3
23936,8to3,8,3,0.41076938942097,-2.85523637336358,128,128,0,4
23953,3to4,3,4,0.931754863244183,-3.25601090920318,65,65,0,3
23968,4to9,4,9,0.868368303977925,-4.79082747184201,64,64,0,2
23982,9to4,9,4,0.918080012258642,-4.69671520786117,29,29,0,3
23998,4to9,4,9,0.868368303977925,-4.79082747184201,30,30,0,2
24014,9to4,9,4,0.918080012258642,-4.69671520786117,32,32,0,3
24029,4to9,4,9,0.868368303977925,-4.79082747184201,31,31,0,2
24045,9to4,9,4,0.918080012258642,-4.69671520786117,31,31,0,3
24061,4to3,4,3,0.131631696022075,-6.67743556872275,125,125,0,2
24075,3to4,3,4,0.931754863244183,-3.25601090920318,30,30,0,3
24092,4to9,4,9,0.868368303977925,-4.79082747184201,63,63,0,2
24109,9to4,9,4,0.918080012258642,-4.69671520786117,34,34,0,3
24124,4to9,4,9,0.868368303977925,-4.79082747184201,32,32,0,2
24139,9to14,9,14,0.036097552267916,-7.93277469517946,410,410,0,3
24157,14to13,14,13,0.577646634180736,-4.25888819117841,445,445,0,3
24174,13to8,13,8,0.391292881472455,-5.7228947249899,254,254,0,4
24189,8to3,8,3,0.41076938942097,-2.85523637336358,128,128,0,4
24206,3to4,3,4,0.931754863244183,-3.25601090920318,97,97,0,3
24221,4to9,4,9,0.868368303977925,-4.79082747184201,97,97,0,2
24236,9to4,9,4,0.918080012258642,-4.69671520786117,30,30,0,3
24251,4to9,4,9,0.868368303977925,-4.79082747184201,30,30,0,2
24267,9to4,9,4,0.918080012258642,-4.69671520786117,31,31,0,3
24283,4to9,4,9,0.868368303977925,-4.79082747184201,32,32,0,2
24298,9to4,9,4,0.918080012258642,-4.69671520786117,31,31,0,3
24315,4to3,4,3,0.131631696022075,-6.67743556872275,126,126,0,2
24331,3to2,3,2,0.019852283509098,-7.10476162826365,539,539,0,3
24346,2to1,2,1,0.051321927376808,-6.52385773448456,1487,713,774,3
24361,1to0,1,0,0.064972873112352,-6.83334963167294,3541,711,2830,3
24378,0to5,0,5,0.86500502975695,-3.22173976930737,1552,712,840,2
24394,5to10,5,10,0.377656998180132,-5.81409006431307,1584,679,905,3
24411,10to11,10,11,0.710987525350857,-7.00233513100768,732,679,53,3
24427,11to16,11,16,0.008383826559751,-7.75382613781063,3478,677,2801,4
24442,16to17,16,17,0.105520455768195,-4.55181896814135,3510,578,2932,4
24458,17to18,17,18,0.18132354219811,-6.54730536344704,2772,62,2710,4
24474,18to13,18,13,0.942483942169855,-3.27389333616027,317,317,0,4
24490,13to14,13,14,0.537708780919149,-5.40503394784646,351,351,0,4
24505,14to9,14,9,0.418671395394238,-4.58076416031773,222,222,0,3
24522,9to4,9,4,0.918080012258642,-4.69671520786117,224,224,0,3
24537,4to3,4,3,0.131631696022075,-6.67743556872275,222,222,0,2
24554,3to8,3,8,0.048392853246719,-6.21372852439417,380,380,0,3
24570,8to9,8,9,0.3949538836892,-2.89449932615566,65,65,0,4
24586,9to4,9,4,0.918080012258642,-4.69671520786117,64,64,0,3
24602,4to9,4,9,0.868368303977925,-4.79082747184201,32,32,0,2
24617,9to4,9,4,0.918080012258642,-4.69671520786117,31,31,0,3
24632,4to9,4,9,0.868368303977925,-4.79082747184201,30,30,0,2
24648,9to4,9,4,0.918080012258642,-4.69671520786117,31,31,0,3
24665,4to9,4,9,0.868368303977925,-4.79082747184201,33,33,0,2
24680,9to4,9,4,0.918080012258642,-4.69671520786117,32,32,0,3
24695,4to3,4,3,0.131631696022075,-6.67743556872275,158,158,0,2
24710,3to4,3,4,0.931754863244183,-3.25601090920318,30,30,0,3
24727,4to9,4,9,0.868368303977925,-4.79082747184201,62,62,0,2
24743,9to4,9,4,0.918080012258642,-4.69671520786117,33,33,0,3
24758,4to9,4,9,0.868368303977925,-4.79082747184201,31,31,0,2
24774,9to4,9,4,0.918080012258642,-4.69671520786117,31,31,0,3
24790,4to9,4,9,0.868368303977925,-4.79082747184201,32,32,0,2
24805,9to4,9,4,0.918080012258642,-4.69671520786117,31,31,0,3
24820,4to3,4,3,0.131631696022075,-6.67743556872275,125,125,0,2
24834,3to4,3,4,0.931754863244183,-3.25601090920318,29,29,0,3
24851,4to9,4,9,0.868368303977925,-4.79082747184201,61,61,0,2
24867,9to4,9,4,0.918080012258642,-4.69671520786117,33,33,0,3
24883,4to9,4,9,0.868368303977925,-4.79082747184201,32,32,0,2
24899,9to8,9,8,0.045822435473441,-7.6942259253288,345,345,0,3
24915,8to13,8,13,0.179994749780101,-3.68034065151054,441,441,0,4
24932,13to14,13,14,0.537708780919149,-5.40503394784646,442,442,0,4
24950,14to9,14,9,0.418671395394238,-4.58076416031773,67,67,0,3
24966,9to4,9,4,0.918080012258642,-4.69671520786117,99,99,0,3
24981,4to3,4,3,0.131631696022075,-6.67743556872275,161,161,0,2
24996,3to4,3,4,0.931754863244183,-3.25601090920318,30,30,0,3
25011,4to9,4,9,0.868368303977925,-4.79082747184201,61,61,0,2
25027,9to4,9,4,0.918080012258642,-4.69671520786117,31,31,0,3
25043,4to9,4,9,0.868368303977925,-4.79082747184201,32,32,0,2
25057,9to4,9,4,0.918080012258642,-4.69671520786117,30,30,0,3
25072,4to9,4,9,0.868368303977925,-4.79082747184201,29,29,0,2
25087,9to4,9,4,0.918080012258642,-4.69671520786117,30,30,0,3
25103,4to3,4,3,0.131631696022075,-6.67743556872275,122,122,0,2
25120,3to2,3,2,0.019852283509098,-7.10476162826365,789,789,0,3
25134,2to7,2,7,0.08813459434432,-5.98311070238446,1487,1487,0,3
25151,7to12,7,12,0.644668357323791,-1.66318819304745,1456,1456,0,4
25167,12to13,12,13,0.895371578258555,-4.67657090946632,252,252,0,4
25183,13to14,13,14,0.537708780919149,-5.40503394784646,251,251,0,4
25199,14to9,14,9,0.418671395394238,-4.58076416031773,127,127,0,3
25214,9to4,9,4,0.918080012258642,-4.69671520786117,127,127,0,3
25229,4to3,4,3,0.131631696022075,-6.67743556872275,126,126,0,2
25246,3to2,3,2,0.019852283509098,-7.10476162826365,126,126,0,3
25263,2to1,2,1,0.051321927376808,-6.52385773448456,917,917,0,3
25278,1to6,1,6,0.387396728296756,-5.04787017207365,1615,1615,0,3
25295,6to11,6,11,0.301177394036391,-4.32251446300207,884,884,0,4
25311,11to12,11,12,0.851364818950588,-3.13328984699353,160,160,0,4
25327,12to13,12,13,0.895371578258555,-4.67657090946632,160,160,0,4
25343,13to8,13,8,0.391292881472455,-5.7228947249899,444,444,0,4
25360,8to9,8,9,0.3949538836892,-2.89449932615566,161,161,0,4
25377,9to4,9,4,0.918080012258642,-4.69671520786117,163,163,0,3
25394,4to9,4,9,0.868368303977925,-4.79082747184201,34,34,0,2
25411,9to4,9,4,0.918080012258642,-4.69671520786117,34,34,0,3
25425,4to3,4,3,0.131631696022075,-6.67743556872275,196,196,0,2
25442,3to4,3,4,0.931754863244183,-3.25601090920318,31,31,0,3
25457,4to9,4,9,0.868368303977925,-4.79082747184201,63,63,0,2
25472,9to4,9,4,0.918080012258642,-4.69671520786117,30,30,0,3
25488,4to9,4,9,0.868368303977925,-4.79082747184201,31,31,0,2
25502,9to4,9,4,0.918080012258642,-4.69671520786117,30,30,0,3
25518,4to9,4,9,0.868368303977925,-4.79082747184201,30,30,0,2
25533,9to4,9,4,0.918080012258642,-4.69671520786117,31,31,0,3
25548,4to3,4,3,0.131631696022075,-6.67743556872275,123,123,0,2
25563,3to4,3,4,0.931754863244183,-3.25601090920318,30,30,0,3
25578,4to9,4,9,0.868368303977925,-4.79082747184201,60,60,0,2
25593,9to14,9,14,0.036097552267916,-7.93277469517946,410,410,0,3
25609,14to13,14,13,0.479886604047428,-4.652505212455,282,171,111,3
25624,13to8,13,8,0.391292881472455,-5.7228947249899,281,281,0,4
25641,8to3,8,3,0.41076938942097,-2.85523637336358,93,93,0,4
25658,3to4,3,4,0.931754863244183,-3.25601090920318,95,95,0,3
25674,4to3,4,3,0.131631696022075,-6.67743556872275,33,33,0,2
25689,3to4,3,4,0.931754863244183,-3.25601090920318,31,31,0,3
25704,4to9,4,9,0.868368303977925,-4.79082747184201,126,126,0,2
25718,9to4,9,4,0.918080012258642,-4.69671520786117,29,29,0,3
25733,4to9,4,9,0.868368303977925,-4.79082747184201,29,29,0,2
25750,9to4,9,4,0.918080012258642,-4.69671520786117,32,32,0,3
25766,4to9,4,9,0.868368303977925,-4.79082747184201,33,33,0,2
25782,9to4,9,4,0.918080012258642,-4.69671520786117,32,32,0,3
25796,4to3,4,3,0.131631696022075,-6.67743556872275,122,122,0,2
25812,3to4,3,4,0.931754863244183,-3.25601090920318,30,30,0,3
25829,4to9,4,9,0.868368303977925,-4.79082747184201,63,63,0,2
25845,9to4,9,4,0.918080012258642,-4.69671520786117,33,33,0,3
25861,4to9,4,9,0.868368303977925,-4.79082747184201,32,32,0,2
25876,9to4,9,4,0.918080012258642,-4.69671520786117,31,31,0,3
25890,4to9,4,9,0.868368303977925,-4.79082747184201,29,29,0,2
25905,9to4,9,4,0.918080012258642,-4.69671520786117,29,29,0,3
25920,4to3,4,3,0.131631696022075,-6.67743556872275,124,124,0,2
25936,3to8,3,8,0.048392853246719,-6.21372852439417,312,312,0,3
25953,8to13,8,13,0.179994749780101,-3.68034065151054,344,344,0,4
25968,13to14,13,14,0.537708780919149,-5.40503394784646,375,375,0,4
25984,14to9,14,9,0.515579178170639,-4.58076416031773,94,94,0,3
26000,9to4,9,4,0.918080012258642,-4.69671520786117,95,95,0,3
26017,4to9,4,9,0.868368303977925,-4.79082747184201,33,33,0,2
26033,9to4,9,4,0.918080012258642,-4.69671520786117,33,33,0,3
26049,4to3,4,3,0.131631696022075,-6.67743556872275,129,129,0,2
26065,3to2,3,2,0.019852283509098,-7.10476162826365,819,819,0,3
26082,2to7,2,7,0.08813459434432,-5.98311070238446,948,948,0,3
26097,7to12,7,12,0.601986862759919,-1.84512203528664,786,643,143,4
26114,12to13,12,13,0.895371578258555,-4.67657090946632,161,161,0,4
26129,13to14,13,14,0.537708780919149,-5.40503394784646,161,161,0,4
26144,14to9,14,9,0.515579178170639,-4.58076416031773,127,127,0,3
26160,9to4,9,4,0.918080012258642,-4.69671520786117,127,127,0,3
26175,4to3,4,3,0.131631696022075,-6.67743556872275,126,126,0,2
26190,3to4,3,4,0.931754863244183,-3.25601090920318,30,30,0,3
26207,4to9,4,9,0.868368303977925,-4.79082747184201,63,63,0,2
26223,9to14,9,14,0.036097552267916,-7.93277469517946,94,94,0,3
26239,14to13,14,13,0.479886604047428,-4.652505212455,125,125,0,3
26255,13to8,13,8,0.391292881472455,-5.7228947249899,319,319,0,4
26271,8to3,8,3,0.41076938942097,-2.85523637336358,96,96,0,4
26287,3to4,3,4,0.931754863244183,-3.25601090920318,97,97,0,3
26303,4to9,4,9,0.868368303977925,-4.79082747184201,96,96,0,2
26318,9to4,9,4,0.918080012258642,-4.69671520786117,31,31,0,3
26334,4to9,4,9,0.868368303977925,-4.79082747184201,31,31,0,2
26349,9to4,9,4,0.918080012258642,-4.69671520786117,31,31,0,3
26365,4to9,4,9,0.868368303977925,-4.79082747184201,31,31,0,2
26380,9to4,9,4,0.918080012258642,-4.69671520786117,31,31,0,3
26395,4to3,4,3,0.131631696022075,-6.67743556872275,124,124,0,2
26411,3to8,3,8,0.048392853246719,-6.21372852439417,156,156,0,3
26427,8to13,8,13,0.179994749780101,-3.68034065151054,188,188,0,4
26442,13to12,13,12,0.058652081777823,-7.62072799264345,345,345,0,4
26458,12to17,12,17,0.013259866128102,-8.90617148508976,2016,336,1680,4
26473,17to18,17,18,0.078943741585749,-7.4966850160525,2015,102,1913,4
26488,18to23,18,23,0.002580650835386,-9.17873329851928,7429,66,7363,4
26504,23to22,23,22,0.087093151843151,-5.01628631260735,6236,66,6170,3
26520,22to21,22,21,0.023286040881662,-6.69391425944331,6235,64,6171,3
26538,21to20,21,20,0.094960349577644,-6.30905762809717,6138,65,6073,3
26554,20to15,20,15,0.734984727755138,-4.7124870635862,5588,65,5523,2
26569,15to10,15,10,0.599142848646926,-4.64200802264497,2175,33,2142,3
26584,10to11,10,11,0.48726778542239,-7.95346003403328,1289,63,1226,3
26600,11to12,11,12,0.851364818950588,-3.13328984699353,158,158,0,4
26616,12to13,12,13,0.910817423971668,-4.67657090946632,189,189,0,4
26633,13to14,13,14,0.537708780919149,-5.40503394784646,410,410,0,4
26648,14to9,14,9,0.515579178170639,-4.58076416031773,283,283,0,3
26665,9to4,9,4,0.918080012258642,-4.69671520786117,285,285,0,3
26682,4to3,4,3,0.057729099558626,-7.58335891367048,287,27,260,2
26698,3to4,3,4,0.931754863244183,-3.25601090920318,33,33,0,3
26714,4to9,4,9,0.899027991534856,-5.39688807790262,66,26,40,2
26729,9to4,9,4,0.899414427526527,-4.92252165947407,31,24,7,3
26745,4to9,4,9,0.899027991534856,-5.39688807790262,31,31,0,2
26762,9to8,9,8,0.027637679110291,-8.43496666606954,351,91,260,3
26777,8to3,8,3,0.316195364604169,-3.26576268915305,95,56,39,4
26793,3to4,3,4,0.931754863244183,-3.25601090920318,64,64,0,3
26809,4to9,4,9,0.899027991534856,-5.39688807790262,64,64,0,2
26824,9to4,9,4,0.926695500755814,-4.92252165947407,31,31,0,3
26839,4to9,4,9,0.899027991534856,-5.39688807790262,30,30,0,2
26854,9to4,9,4,0.926695500755814,-4.92252165947407,30,30,0,3
26868,4to9,4,9,0.899027991534856,-5.39688807790262,29,29,0,2
26884,9to4,9,4,0.926695500755814,-4.92252165947407,30,30,0,3
26899,4to9,4,9,0.899027991534856,-5.39688807790262,31,31,0,2
26915,9to4,9,4,0.926695500755814,-4.92252165947407,31,31,0,3
26931,4to9,4,9,0.899027991534856,-5.39688807790262,32,32,0,2
26945,9to4,9,4,0.926695500755814,-4.92252165947407,30,30,0,3
26961,4to3,4,3,0.100972008465144,-7.58335891367048,184,184,0,2
26978,3to2,3,2,0.009598395316459,-7.84189196780363,913,240,673,3
26995,2to1,2,1,0.024541541229536,-7.28944664903421,1732,406,1326,3
27010,1to6,1,6,0.227055655924912,-5.81461382103439,1732,404,1328,3
27027,6to5,6,5,0.095017825068706,-5.59039860601265,2649,473,2176,4
27043,5to0,5,0,0.151223800233096,-6.90632190794072,2682,471,2211,3
27057,0to5,0,5,0.86500502975695,-3.22173976930737,30,30,0,2
27074,5to10,5,10,0.45078599015118,-5.81409006431307,505,505,0,3
27090,10to11,10,11,0.48726778542239,-7.95346003403328,506,506,0,3
27107,11to12,11,12,0.804083180534895,-3.46662318032687,507,338,169,4
27123,12to13,12,13,0.910817423971668,-4.67657090946632,507,507,0,4
27138,13to14,13,14,0.303840492734112,-6.38523196764844,505,10,495,4
27155,14to9,14,9,0.515579178170639,-4.58076416031773,224,224,0,3
27171,9to4,9,4,0.926695500755814,-4.92252165947407,226,226,0,3
27186,4to3,4,3,0.100972008465144,-7.58335891367048,225,225,0,2
27200,3to8,3,8,0.048899118678108,-6.21372852439417,438,438,0,3
27215,8to9,8,9,0.45834566566198,-2.89449932615566,60,60,0,4
27230,9to4,9,4,0.926695500755814,-4.92252165947407,59,59,0,3
27246,4to9,4,9,0.899027991534856,-5.39688807790262,31,31,0,2
27262,9to4,9,4,0.926695500755814,-4.92252165947407,32,32,0,3
27278,4to9,4,9,0.899027991534856,-5.39688807790262,32,32,0,2
27293,9to4,9,4,0.926695500755814,-4.92252165947407,31,31,0,3
27310,4to9,4,9,0.899027991534856,-5.39688807790262,32,32,0,2
27325,9to4,9,4,0.926695500755814,-4.92252165947407,32,32,0,3
27340,4to3,4,3,0.100972008465144,-7.58335891367048,154,154,0,2
27356,3to4,3,4,0.941502486005433,-3.25601090920318,31,31,0,3
27372,4to9,4,9,0.899027991534856,-5.39688807790262,62,62,0,2
27387,9to4,9,4,0.926695500755814,-4.92252165947407,31,31,0,3
27402,4to9,4,9,0.899027991534856,-5.39688807790262,30,30,0,2
27419,9to4,9,4,0.926695500755814,-4.92252165947407,32,32,0,3
27435,4to9,4,9,0.899027991534856,-5.39688807790262,33,33,0,2
27450,9to4,9,4,0.926695500755814,-4.92252165947407,31,31,0,3
27465,4to9,4,9,0.899027991534856,-5.39688807790262,30,30,0,2
27481,9to14,9,14,0.045666820133896,-7.93277469517946,343,343,0,3
27497,14to13,14,13,0.479886604047428,-4.652505212455,374,374,0,3
27512,13to8,13,8,0.589243853915539,-5.7228947249899,312,312,0,4
27530,8to3,8,3,0.316195364604169,-3.26576268915305,190,190,0,4
27545,3to4,3,4,0.941502486005433,-3.25601090920318,95,95,0,3
27561,4to9,4,9,0.899027991534856,-5.39688807790262,96,96,0,2
27577,9to4,9,4,0.926695500755814,-4.92252165947407,32,32,0,3
27593,4to9,4,9,0.899027991534856,-5.39688807790262,32,32,0,2
27608,9to4,9,4,0.926695500755814,-4.92252165947407,31,31,0,3
27624,4to9,4,9,0.899027991534856,-5.39688807790262,31,31,0,2
27639,9to4,9,4,0.926695500755814,-4.92252165947407,31,31,0,3
27655,4to9,4,9,0.899027991534856,-5.39688807790262,31,31,0,2
27670,9to4,9,4,0.926695500755814,-4.92252165947407,31,31,0,3
27685,4to3,4,3,0.100972008465144,-7.58335891367048,155,155,0,2
27702,3to4,3,4,0.941502486005433,-3.25601090920318,32,32,0,3
27718,4to9,4,9,0.899027991534856,-5.39688807790262,63,63,0,2
27733,9to4,9,4,0.926695500755814,-4.92252165947407,31,31,0,3
27750,4to3,4,3,0.100972008465144,-7.58335891367048,65,65,0,2
27766,3to4,3,4,0.941502486005433,-3.25601090920318,33,33,0,3
27782,4to9,4,9,0.899027991534856,-5.39688807790262,64,64,0,2
27798,9to8,9,8,0.027637679110291,-8.43496666606954,286,286,0,3
27814,8to13,8,13,0.208884674415667,-3.68034065151054,317,317,0,4
27830,13to14,13,14,0.303840492734112,-6.38523196764844,349,349,0,4
27846,14to19,14,19,0.001674734386442,-10.3132688596404,6175,7,6168,3
27863,19to18,19,18,0.151266233013277,-5.47112672176672,1390,40,1350,3
27879,18to17,18,17,0.01793075962648,-7.26618630289326,1421,139,1282,4
27894,17to12,17,12,0.77985596721206,-5.20631123779532,787,787,0,4
27911,12to7,12,7,0.031862146549955,-8.04351741740437,1829,1158,671,4
27928,7to8,7,8,0.346939723989873,-2.39620659892225,130,130,0,4
27944,8to9,8,9,0.45834566566198,-2.89449932615566,162,162,0,4
27960,9to14,9,14,0.045666820133896,-7.93277469517946,130,130,0,3
27976,14to13,14,13,0.481265082143315,-4.652505212455,162,162,0,3
27991,13to8,13,8,0.589243853915539,-5.7228947249899,63,63,0,4
28006,8to3,8,3,0.316195364604169,-3.26576268915305,256,256,0,4
28022,3to4,3,4,0.941502486005433,-3.25601090920318,256,256,0,3
28037,4to9,4,9,0.899027991534856,-5.39688807790262,93,93,0,2
28053,9to4,9,4,0.926695500755814,-4.92252165947407,31,31,0,3
28069,4to9,4,9,0.899027991534856,-5.39688807790262,32,32,0,2
28084,9to4,9,4,0.926695500755814,-4.92252165947407,31,31,0,3
28099,4to9,4,9,0.899027991534856,-5.39688807790262,30,30,0,2
28114,9to4,9,4,0.926695500755814,-4.92252165947407,30,30,0,3
28129,4to9,4,9,0.899027991534856,-5.39688807790262,30,30,0,2
28144,9to4,9,4,0.926695500755814,-4.92252165947407,30,30,0,3
28159,4to3,4,3,0.100972008465144,-7.58335891367048,153,153,0,2
28176,3to4,3,4,0.941502486005433,-3.25601090920318,32,32,0,3
28193,4to9,4,9,0.899027991534856,-5.39688807790262,64,64,0,2
28209,9to4,9,4,0.926695500755814,-4.92252165947407,33,33,0,3
28226,4to9,4,9,0.899027991534856,-5.39688807790262,33,33,0,2
28243,9to4,9,4,0.926695500755814,-4.92252165947407,34,34,0,3
28258,4to9,4,9,0.899027991534856,-5.39688807790262,32,32,0,2
28273,9to4,9,4,0.926695500755814,-4.92252165947407,30,30,0,3
28288,4to9,4,9,0.899027991534856,-5.39688807790262,30,30,0,2
28304,9to14,9,14,0.045666820133896,-7.93277469517946,344,344,0,3
28321,14to13,14,13,0.481265082143315,-4.652505212455,345,345,0,3
28338,13to14,13,14,0.303840492734112,-6.38523196764844,34,34,0,4
28353,14to9,14,9,0.517060183470243,-4.58076416031773,65,65,0,3
28371,9to4,9,4,0.926695500755814,-4.92252165947407,98,98,0,3
28386,4to3,4,3,0.100972008465144,-7.58335891367048,227,227,0,2
28403,3to8,3,8,0.048899118678108,-6.21372852439417,412,412,0,3
28420,8to9,8,9,0.45834566566198,-2.89449932615566,67,67,0,4
28436,9to4,9,4,0.926695500755814,-4.92252165947407,65,65,0,3
28452,4to9,4,9,0.899027991534856,-5.39688807790262,32,32,0,2
28467,9to4,9,4,0.926695500755814,-4.92252165947407,31,31,0,3
28483,4to9,4,9,0.899027991534856,-5.39688807790262,31,31,0,2
28499,9to4,9,4,0.926695500755814,-4.92252165947407,32,32,0,3
28513,4to9,4,9,0.899027991534856,-5.39688807790262,30,30,0,2
28528,9to4,9,4,0.926695500755814,-4.92252165947407,29,29,0,3
28543,4to3,4,3,0.100972008465144,-7.58335891367048,157,157,0,2
28561,3to2,3,2,0.009598395316459,-7.84189196780363,1583,1583,0,3
28576,2to7,2,7,0.090622560006842,-5.98311070238446,665,665,0,3
28593,7to12,7,12,0.601986862759919,-1.84512203528664,699,699,0,4
28609,12to7,12,7,0.031862146549955,-8.04351741740437,33,33,0,4
28626,7to8,7,8,0.346939723989873,-2.39620659892225,223,223,0,4
28642,8to13,8,13,0.208884674415667,-3.68034065151054,321,321,0,4
28658,13to14,13,14,0.303840492734112,-6.38523196764844,320,320,0,4
28673,14to9,14,9,0.517060183470243,-4.58076416031773,160,160,0,3
28688,9to8,9,8,0.027637679110291,-8.43496666606954,62,62,0,3
28705,8to3,8,3,0.316195364604169,-3.26576268915305,162,162,0,4
28723,3to4,3,4,0.941502486005433,-3.25601090920318,195,195,0,3
28739,4to9,4,9,0.899027991534856,-5.39688807790262,66,66,0,2
28754,9to4,9,4,0.926695500755814,-4.92252165947407,31,31,0,3
28770,4to9,4,9,0.899027991534856,-5.39688807790262,31,31,0,2
28785,9to4,9,4,0.926695500755814,-4.92252165947407,31,31,0,3
28801,4to9,4,9,0.899027991534856,-5.39688807790262,31,31,0,2
28818,9to4,9,4,0.926695500755814,-4.92252165947407,33,33,0,3
28833,4to9,4,9,0.899027991534856,-5.39688807790262,32,32,0,2
28848,9to4,9,4,0.926695500755814,-4.92252165947407,30,30,0,3
28863,4to3,4,3,0.100972008465144,-7.58335891367048,158,158,0,2
28879,3to4,3,4,0.941502486005433,-3.25601090920318,31,31,0,3
28894,4to9,4,9,0.899027991534856,-5.39688807790262,61,61,0,2
28910,9to4,9,4,0.926695500755814,-4.92252165947407,31,31,0,3
28925,4to9,4,9,0.899027991534856,-5.39688807790262,31,31,0,2
28941,9to4,9,4,0.926695500755814,-4.92252165947407,31,31,0,3
28957,4to9,4,9,0.899027991534856,-5.39688807790262,32,32,0,2
28972,9to4,9,4,0.926695500755814,-4.92252165947407,31,31,0,3
28989,4to9,4,9,0.899027991534856,-5.39688807790262,32,32,0,2
29004,9to4,9,4,0.926695500755814,-4.92252165947407,32,32,0,3
29018,4to3,4,3,0.100972008465144,-7.58335891367048,155,155,0,2
29034,3to8,3,8,0.022062634690386,-7.03742794635949,346,61,285,3
29049,8to13,8,13,0.100951361281827,-4.5353775065474,407,59,348,4
29066,13to18,13,18,0.009545803107369,-9.85480869036682,1203,390,813,4
29083,18to17,18,17,0.007010505495082,-8.21635241585007,1204,60,1144,4
29099,17to16,17,16,0.051089865866756,-8.00829197748489,4672,289,4383,4
29116,16to11,16,11,0.435447381808763,-3.59862831259968,2026,289,1737,4
29132,11to12,11,12,0.65605859032108,-4.23285694656063,539,126,413,4
29147,12to13,12,13,0.92367953195953,-4.67657090946632,98,98,0,4
29163,13to14,13,14,0.306641194165374,-6.38523196764844,505,505,0,4
29178,14to9,14,9,0.517060183470243,-4.58076416031773,189,189,0,3
29193,9to4,9,4,0.926695500755814,-4.92252165947407,189,189,0,3
29208,4to3,4,3,0.100972008465144,-7.58335891367048,190,190,0,2
29225,3to4,3,4,0.96806813943535,-3.25601090920318,32,32,0,3
29241,4to9,4,9,0.899027991534856,-5.39688807790262,63,63,0,2
29258,9to4,9,4,0.926695500755814,-4.92252165947407,33,33,0,3
29275,4to9,4,9,0.899027991534856,-5.39688807790262,34,34,0,2
29290,9to4,9,4,0.926695500755814,-4.92252165947407,32,32,0,3
29305,4to9,4,9,0.899027991534856,-5.39688807790262,30,30,0,2
29321,9to4,9,4,0.926695500755814,-4.92252165947407,31,31,0,3
29338,4to9,4,9,0.899027991534856,-5.39688807790262,33,33,0,2
29354,9to4,9,4,0.926695500755814,-4.92252165947407,33,33,0,3
29368,4to9,4,9,0.899027991534856,-5.39688807790262,30,30,0,2
29385,9to4,9,4,0.926695500755814,-4.92252165947407,31,31,0,3
29400,4to3,4,3,0.100972008465144,-7.58335891367048,192,192,0,2
29416,3to4,3,4,0.96806813943535,-3.25601090920318,31,31,0,3
29432,4to3,4,3,0.100972008465144,-7.58335891367048,32,32,0,2
29448,3to4,3,4,0.96806813943535,-3.25601090920318,32,32,0,3
29463,4to3,4,3,0.100972008465144,-7.58335891367048,31,31,0,2
29478,3to4,3,4,0.96806813943535,-3.25601090920318,30,30,0,3
29493,4to3,4,3,0.100972008465144,-7.58335891367048,30,30,0,2
29509,3to4,3,4,0.96806813943535,-3.25601090920318,31,31,0,3
29526,4to9,4,9,0.899027991534856,-5.39688807790262,158,158,0,2
29543,9to14,9,14,0.045666820133896,-7.93277469517946,380,380,0,3
29559,14to13,14,13,0.481265082143315,-4.652505212455,412,412,0,3
29575,13to8,13,8,0.594675309381442,-5.7228947249899,541,541,0,4
29590,8to3,8,3,0.35933447744348,-3.26576268915305,97,97,0,4
29605,3to4,3,4,0.96806813943535,-3.25601090920318,96,96,0,3
29621,4to9,4,9,0.899027991534856,-5.39688807790262,95,95,0,2
29635,9to4,9,4,0.926695500755814,-4.92252165947407,30,30,0,3
29650,4to9,4,9,0.899027991534856,-5.39688807790262,29,29,0,2
29667,9to4,9,4,0.926695500755814,-4.92252165947407,32,32,0,3
29682,4to9,4,9,0.899027991534856,-5.39688807790262,32,32,0,2
29697,9to4,9,4,0.926695500755814,-4.92252165947407,30,30,0,3
29712,4to9,4,9,0.899027991534856,-5.39688807790262,30,30,0,2
29727,9to4,9,4,0.926695500755814,-4.92252165947407,30,30,0,3
29742,4to3,4,3,0.100972008465144,-7.58335891367048,152,152,0,2
29756,3to4,3,4,0.96806813943535,-3.25601090920318,29,29,0,3
29772,4to9,4,9,0.899027991534856,-5.39688807790262,60,60,0,2
29786,9to4,9,4,0.926695500755814,-4.92252165947407,30,30,0,3
29802,4to9,4,9,0.899027991534856,-5.39688807790262,30,30,0,2
29817,9to4,9,4,0.926695500755814,-4.92252165947407,31,31,0,3
29832,4to9,4,9,0.899027991534856,-5.39688807790262,30,30,0,2
29849,9to4,9,4,0.926695500755814,-4.92252165947407,32,32,0,3
29864,4to9,4,9,0.899027991534856,-5.39688807790262,32,32,0,2
29881,9to14,9,14,0.045666820133896,-7.93277469517946,338,338,0,3
29899,14to13,14,13,0.481265082143315,-4.652505212455,340,340,0,3
29916,13to8,13,8,0.594675309381442,-5.7228947249899,341,341,0,4
29932,8to3,8,3,0.35933447744348,-3.26576268915305,190,190,0,4
29947,3to4,3,4,0.96806813943535,-3.25601090920318,98,98,0,3
29963,4to9,4,9,0.899027991534856,-5.39688807790262,99,99,0,2
29979,9to4,9,4,0.926695500755814,-4.92252165947407,32,32,0,3
29996,4to9,4,9,0.899027991534856,-5.39688807790262,33,33,0,2
30013,9to4,9,4,0.926695500755814,-4.92252165947407,34,34,0,3
30030,4to9,4,9,0.899027991534856,-5.39688807790262,34,34,0,2
30046,9to4,9,4,0.926695500755814,-4.92252165947407,33,33,0,3
30063,4to9,4,9,0.899027991534856,-5.39688807790262,33,33,0,2
30079,9to4,9,4,0.926695500755814,-4.92252165947407,33,33,0,3
30094,4to3,4,3,0.100972008465144,-7.58335891367048,162,162,0,2
30110,3to2,3,2,0.007743794024712,-8.08656595101861,1549,1170,379,3
30126,2to7,2,7,0.07345443237277,-6.21185163844247,1517,1170,347,3
30141,7to12,7,12,0.601986862759919,-1.84512203528664,1009,1009,0,4
30157,12to13,12,13,0.92367953195953,-4.67657090946632,258,258,0,4
30174,13to8,13,8,0.594675309381442,-5.7228947249899,258,258,0,4
30189,8to9,8,9,0.520878604483375,-2.89449932615566,126,126,0,4
30203,9to4,9,4,0.926695500755814,-4.92252165947407,124,124,0,3
30220,4to9,4,9,0.899027991534856,-5.39688807790262,31,31,0,2
30234,9to4,9,4,0.926695500755814,-4.92252165947407,31,31,0,3
30249,4to3,4,3,0.100972008465144,-7.58335891367048,155,155,0,2
30264,3to4,3,4,0.97014621125158,-3.25601090920318,30,30,0,3
30281,4to9,4,9,0.899027991534856,-5.39688807790262,61,61,0,2
30296,9to14,9,14,0.045666820133896,-7.93277469517946,415,415,0,3
30312,14to13,14,13,0.481265082143315,-4.652505212455,155,155,0,3
30329,13to12,13,12,0.089137693345816,-7.62072799264345,188,188,0,4
30346,12to11,12,11,0.011739799020917,-9.06164437622181,1230,11,1219,4
30363,11to6,11,6,0.080838470775974,-6.45608769541528,3353,11,3342,4
30381,6to1,6,1,0.191719528064913,-5.025744801593,3386,1457,1929,4
30397,1to0,1,0,0.031926078192145,-7.82947366268069,3354,13,3341,3
30412,0to5,0,5,0.704873142063152,-4.20862501520901,3355,44,3311,2
30429,5to0,5,0,0.151223800233096,-6.90632190794072,32,32,0,3
30444,0to1,0,1,0.233603778071467,-5.39669788814512,63,43,20,2
30461,1to2,1,2,0.527530589271256,-5.57921175094446,351,43,308,3
30478,2to7,2,7,0.032078745087383,-7.08401072935156,352,45,307,3
30493,7to8,7,8,0.346939723989873,-2.39620659892225,319,319,0,4
30509,8to9,8,9,0.520878604483375,-2.89449932615566,228,228,0,4
30525,9to4,9,4,0.926695500755814,-4.92252165947407,261,261,0,3
30541,4to3,4,3,0.100972008465144,-7.58335891367048,292,292,0,2
30555,3to4,3,4,0.97014621125158,-3.25601090920318,30,30,0,3
30572,4to9,4,9,0.899027991534856,-5.39688807790262,63,63,0,2
30586,9to4,9,4,0.926695500755814,-4.92252165947407,31,31,0,3
30603,4to9,4,9,0.899027991534856,-5.39688807790262,31,31,0,2
30620,9to4,9,4,0.926695500755814,-4.92252165947407,34,34,0,3
30635,4to9,4,9,0.899027991534856,-5.39688807790262,32,32,0,2
30653,9to14,9,14,0.027785908903114,-8.44818085764445,357,173,184,3
30669,14to13,14,13,0.377365588072957,-5.07827552057825,357,205,152,3
30685,13to8,13,8,0.594675309381442,-5.7228947249899,192,192,0,4
30701,8to3,8,3,0.35933447744348,-3.26576268915305,160,160,0,4
30718,3to4,3,4,0.97014621125158,-3.25601090920318,98,98,0,3
30735,4to9,4,9,0.899027991534856,-5.39688807790262,100,100,0,2
30750,9to4,9,4,0.94405857723326,-4.92252165947407,32,32,0,3
30766,4to3,4,3,0.100972008465144,-7.58335891367048,65,65,0,2
30783,3to4,3,4,0.97014621125158,-3.25601090920318,33,33,0,3
30800,4to9,4,9,0.899027991534856,-5.39688807790262,65,65,0,2
30815,9to4,9,4,0.94405857723326,-4.92252165947407,32,32,0,3
30831,4to9,4,9,0.899027991534856,-5.39688807790262,31,31,0,2
30845,9to4,9,4,0.94405857723326,-4.92252165947407,30,30,0,3
30860,4to9,4,9,0.899027991534856,-5.39688807790262,29,29,0,2
30875,9to4,9,4,0.94405857723326,-4.92252165947407,30,30,0,3
30889,4to9,4,9,0.899027991534856,-5.39688807790262,29,29,0,2
30904,9to4,9,4,0.94405857723326,-4.92252165947407,29,29,0,3
30920,4to3,4,3,0.100972008465144,-7.58335891367048,154,154,0,2
30935,3to4,3,4,0.97014621125158,-3.25601090920318,31,31,0,3
30950,4to9,4,9,0.899027991534856,-5.39688807790262,61,61,0,2
30964,9to4,9,4,0.94405857723326,-4.92252165947407,29,29,0,3
30980,4to9,4,9,0.899027991534856,-5.39688807790262,30,30,0,2
30997,9to14,9,14,0.027785908903114,-8.44818085764445,344,344,0,3
31013,14to13,14,13,0.377365588072957,-5.07827552057825,344,344,0,3
31029,13to8,13,8,0.594675309381442,-5.7228947249899,344,344,0,4
31047,8to3,8,3,0.35933447744348,-3.26576268915305,127,127,0,4
31065,3to4,3,4,0.97014621125158,-3.25601090920318,101,101,0,3
31082,4to9,4,9,0.899027991534856,-5.39688807790262,102,102,0,2
31097,9to4,9,4,0.94405857723326,-4.92252165947407,32,32,0,3
31113,4to9,4,9,0.899027991534856,-5.39688807790262,31,31,0,2
31129,9to4,9,4,0.94405857723326,-4.92252165947407,32,32,0,3
31145,4to9,4,9,0.899027991534856,-5.39688807790262,32,32,0,2
31161,9to4,9,4,0.94405857723326,-4.92252165947407,32,32,0,3
31177,4to9,4,9,0.899027991534856,-5.39688807790262,32,32,0,2
31192,9to4,9,4,0.94405857723326,-4.92252165947407,31,31,0,3
31207,4to3,4,3,0.100972008465144,-7.58335891367048,160,160,0,2
31223,3to4,3,4,0.97014621125158,-3.25601090920318,31,31,0,3
31239,4to9,4,9,0.899027991534856,-5.39688807790262,62,62,0,2
31254,9to4,9,4,0.94405857723326,-4.92252165947407,31,31,0,3
31268,4to9,4,9,0.899027991534856,-5.39688807790262,29,29,0,2
31283,9to4,9,4,0.94405857723326,-4.92252165947407,29,29,0,3
31299,4to9,4,9,0.899027991534856,-5.39688807790262,31,31,0,2
31313,9to4,9,4,0.94405857723326,-4.92252165947407,30,30,0,3
31328,4to9,4,9,0.899027991534856,-5.39688807790262,29,29,0,2
31343,9to4,9,4,0.94405857723326,-4.92252165947407,30,30,0,3
31358,4to3,4,3,0.100972008465144,-7.58335891367048,151,151,0,2
31374,3to4,3,4,0.97014621125158,-3.25601090920318,31,31,0,3
31389,4to9,4,9,0.899027991534856,-5.39688807790262,61,61,0,2
31406,9to4,9,4,0.94405857723326,-4.92252165947407,32,32,0,3
31422,4to9,4,9,0.899027991534856,-5.39688807790262,33,33,0,2
31439,9to4,9,4,0.94405857723326,-4.92252165947407,33,33,0,3
31454,4to9,4,9,0.899027991534856,-5.39688807790262,32,32,0,2
31471,9to4,9,4,0.94405857723326,-4.92252165947407,32,32,0,3
31487,4to9,4,9,0.899027991534856,-5.39688807790262,33,33,0,2
31503,9to4,9,4,0.94405857723326,-4.92252165947407,32,32,0,3
31519,4to3,4,3,0.100972008465144,-7.58335891367048,161,161,0,2
31535,3to4,3,4,0.97014621125158,-3.25601090920318,32,32,0,3
31552,4to9,4,9,0.899027991534856,-5.39688807790262,65,65,0,2
31567,9to4,9,4,0.94405857723326,-4.92252165947407,32,32,0,3
31584,4to9,4,9,0.899027991534856,-5.39688807790262,32,32,0,2
31599,9to14,9,14,0.027785908903114,-8.44818085764445,602,602,0,3
31615,14to13,14,13,0.377365588072957,-5.07827552057825,602,602,0,3
31632,13to8,13,8,0.594675309381442,-5.7228947249899,603,603,0,4
31649,8to3,8,3,0.35933447744348,-3.26576268915305,130,130,0,4
31666,3to4,3,4,0.97014621125158,-3.25601090920318,99,99,0,3
31682,4to9,4,9,0.899027991534856,-5.39688807790262,98,98,0,2
31698,9to14,9,14,0.027785908903114,-8.44818085764445,99,99,0,3
31712,14to9,14,9,0.620624238283547,-4.58076416031773,30,30,0,3
31729,9to4,9,4,0.94405857723326,-4.92252165947407,63,63,0,3
31746,4to9,4,9,0.899027991534856,-5.39688807790262,34,34,0,2
31762,9to4,9,4,0.94405857723326,-4.92252165947407,33,33,0,3
31776,4to3,4,3,0.100972008465144,-7.58335891367048,127,127,0,2
31792,3to4,3,4,0.97014621125158,-3.25601090920318,30,30,0,3
31808,4to9,4,9,0.899027991534856,-5.39688807790262,62,62,0,2
31824,9to14,9,14,0.027785908903114,-8.44818085764445,126,126,0,3
31840,14to13,14,13,0.377365588072957,-5.07827552057825,225,225,0,3
31855,13to12,13,12,0.083005766575959,-7.69870964401959,1526,1407,119,4
31870,12to7,12,7,0.032495826116336,-8.04351741740437,1392,1392,0,4
31888,7to8,7,8,0.346939723989873,-2.39620659892225,256,256,0,4
31904,8to9,8,9,0.520878604483375,-2.89449932615566,96,96,0,4
31920,9to4,9,4,0.94405857723326,-4.92252165947407,128,128,0,3
31936,4to3,4,3,0.100972008465144,-7.58335891367048,160,160,0,2
31951,3to4,3,4,0.97014621125158,-3.25601090920318,31,31,0,3
31967,4to9,4,9,0.899027991534856,-5.39688807790262,63,63,0,2
31984,9to4,9,4,0.94405857723326,-4.92252165947407,33,33,0,3
32000,4to9,4,9,0.899027991534856,-5.39688807790262,33,33,0,2
32014,9to4,9,4,0.94405857723326,-4.92252165947407,30,30,0,3
32029,4to9,4,9,0.899027991534856,-5.39688807790262,29,29,0,2
32045,9to4,9,4,0.94405857723326,-4.92252165947407,31,31,0,3
32061,4to9,4,9,0.899027991534856,-5.39688807790262,32,32,0,2
32078,9to4,9,4,0.94405857723326,-4.92252165947407,33,33,0,3
32094,4to9,4,9,0.899027991534856,-5.39688807790262,33,33,0,2
32110,9to4,9,4,0.94405857723326,-4.92252165947407,32,32,0,3
32125,4to3,4,3,0.100972008465144,-7.58335891367048,189,189,0,2
32142,3to4,3,4,0.97014621125158,-3.25601090920318,32,32,0,3
32159,4to9,4,9,0.899027991534856,-5.39688807790262,65,65,0,2
32175,9to4,9,4,0.94405857723326,-4.92252165947407,33,33,0,3
32190,4to9,4,9,0.899027991534856,-5.39688807790262,31,31,0,2
32204,9to4,9,4,0.94405857723326,-4.92252165947407,29,29,0,3
32219,4to9,4,9,0.899027991534856,-5.39688807790262,29,29,0,2
32234,9to4,9,4,0.94405857723326,-4.92252165947407,30,30,0,3
32249,4to9,4,9,0.899027991534856,-5.39688807790262,30,30,0,2
32265,9to4,9,4,0.94405857723326,-4.92252165947407,31,31,0,3
32282,4to9,4,9,0.899027991534856,-5.39688807790262,33,33,0,2
32297,9to4,9,4,0.94405857723326,-4.92252165947407,32,32,0,3
32313,4to3,4,3,0.100972008465144,-7.58335891367048,188,188,0,2
32327,3to4,3,4,0.97014621125158,-3.25601090920318,30,30,0,3
32345,4to9,4,9,0.899027991534856,-5.39688807790262,63,63,0,2
32360,9to4,9,4,0.94405857723326,-4.92252165947407,33,33,0,3
32375,4to9,4,9,0.899027991534856,-5.39688807790262,30,30,0,2
32391,9to14,9,14,0.027785908903114,-8.44818085764445,567,567,0,3
32407,14to13,14,13,0.377365588072957,-5.07827552057825,567,567,0,3
32423,13to8,13,8,0.598678664688089,-5.7228947249899,535,535,0,4
32439,8to3,8,3,0.35933447744348,-3.26576268915305,126,126,0,4
32455,3to4,3,4,0.97014621125158,-3.25601090920318,95,95,0,3
32472,4to9,4,9,0.899027991534856,-5.39688807790262,97,97,0,2
32487,9to4,9,4,0.94405857723326,-4.92252165947407,32,32,0,3
32503,4to9,4,9,0.899027991534856,-5.39688807790262,31,31,0,2
32518,9to4,9,4,0.94405857723326,-4.92252165947407,31,31,0,3
32535,4to9,4,9,0.899027991534856,-5.39688807790262,32,32,0,2
32552,9to4,9,4,0.94405857723326,-4.92252165947407,34,34,0,3
32568,4to9,4,9,0.899027991534856,-5.39688807790262,33,33,0,2
32583,9to8,9,8,0.028155513863626,-8.43496666606954,160,160,0,3
32599,8to3,8,3,0.35933447744348,-3.26576268915305,160,160,0,4
32616,3to4,3,4,0.97014621125158,-3.25601090920318,64,64,0,3
32632,4to9,4,9,0.899027991534856,-5.39688807790262,64,64,0,2
32647,9to8,9,8,0.028155513863626,-8.43496666606954,64,64,0,3
32662,8to13,8,13,0.100951361281827,-4.5353775065474,255,255,0,4
32677,13to8,13,8,0.598678664688089,-5.7228947249899,30,30,0,4
32692,8to3,8,3,0.35933447744348,-3.26576268915305,93,93,0,4
32708,3to4,3,4,0.97014621125158,-3.25601090920318,92,92,0,3
32724,4to9,4,9,0.899027991534856,-5.39688807790262,92,92,0,2
32742,9to8,9,8,0.028155513863626,-8.43496666606954,65,65,0,3
32757,8to3,8,3,0.35933447744348,-3.26576268915305,65,65,0,4
32773,3to4,3,4,0.97014621125158,-3.25601090920318,65,65,0,3
32789,4to3,4,3,0.100972008465144,-7.58335891367048,32,32,0,2
32806,3to8,3,8,0.022109994723708,-7.03742794635949,64,64,0,3
32823,8to7,8,7,0.018835556791318,-6.21426993369706,953,953,0,4
32839,7to12,7,12,0.601986862759919,-1.84512203528664,984,984,0,4
32854,12to13,12,13,0.942049821116576,-4.67657090946632,192,192,0,4
32870,13to14,13,14,0.199624701564793,-6.96769543320168,479,200,279,4
32886,14to9,14,9,0.620624238283547,-4.58076416031773,162,162,0,3
32902,9to4,9,4,0.94405857723326,-4.92252165947407,129,129,0,3
32916,4to9,4,9,0.899027991534856,-5.39688807790262,30,30,0,2
32932,9to4,9,4,0.94405857723326,-4.92252165947407,30,30,0,3
32948,4to3,4,3,0.100972008465144,-7.58335891367048,159,159,0,2
32964,3to2,3,2,0.007743794024712,-8.08656595101861,2503,2503,0,3
32980,2to1,2,1,0.026121474252276,-7.28944664903421,2536,2536,0,3
32995,1to2,1,2,0.527530589271256,-5.57921175094446,31,31,0,3
33012,2to3,2,3,0.94179978066034,-3.70441168844569,64,64,0,3
33028,3to4,3,4,0.97014621125158,-3.25601090920318,96,96,0,3
33044,4to9,4,9,0.899027991534856,-5.39688807790262,128,128,0,2
33061,9to4,9,4,0.94405857723326,-4.92252165947407,33,33,0,3
33076,4to9,4,9,0.899027991534856,-5.39688807790262,32,32,0,2
33092,9to4,9,4,0.94405857723326,-4.92252165947407,31,31,0,3
33106,4to9,4,9,0.899027991534856,-5.39688807790262,30,30,0,2
33120,9to4,9,4,0.94405857723326,-4.92252165947407,28,28,0,3
33135,4to9,4,9,0.899027991534856,-5.39688807790262,29,29,0,2
33152,9to4,9,4,0.94405857723326,-4.92252165947407,32,32,0,3
33169,4to9,4,9,0.899027991534856,-5.39688807790262,34,34,0,2
33184,9to4,9,4,0.94405857723326,-4.92252165947407,32,32,0,3
33199,4to3,4,3,0.100972008465144,-7.58335891367048,187,187,0,2
33215,3to4,3,4,0.97014621125158,-3.25601090920318,31,31,0,3
33232,4to9,4,9,0.899027991534856,-5.39688807790262,63,63,0,2
33247,9to4,9,4,0.94405857723326,-4.92252165947407,32,32,0,3
33262,4to9,4,9,0.899027991534856,-5.39688807790262,30,30,0,2
33277,9to4,9,4,0.94405857723326,-4.92252165947407,30,30,0,3
33292,4to9,4,9,0.899027991534856,-5.39688807790262,30,30,0,2
33307,9to4,9,4,0.94405857723326,-4.92252165947407,30,30,0,3
33323,4to9,4,9,0.899027991534856,-5.39688807790262,31,31,0,2
33339,9to4,9,4,0.94405857723326,-4.92252165947407,32,32,0,3
33355,4to9,4,9,0.899027991534856,-5.39688807790262,32,32,0,2
33371,9to8,9,8,0.028155513863626,-8.43496666606954,565,565,0,3
33388,8to3,8,3,0.35933447744348,-3.26576268915305,189,189,0,4
33405,3to4,3,4,0.97014621125158,-3.25601090920318,66,66,0,3
33421,4to9,4,9,0.899027991534856,-5.39688807790262,66,66,0,2
33438,9to14,9,14,0.027785908903114,-8.44818085764445,568,568,0,3
33454,14to13,14,13,0.377365588072957,-5.07827552057825,600,600,0,3
33470,13to12,13,12,0.096103419756356,-7.69870964401959,631,631,0,4
33488,12to17,12,17,0.00558814475327,-9.81218737612268,4405,414,3991,4
33504,17to22,17,22,0.008297089305233,-9.83975765811321,7000,118,6882,4
33522,22to23,22,23,0.018156512015887,-6.97331760217983,7034,21,7013,3
33539,23to18,23,18,0.749364598376843,-3.67425020423656,4473,87,4386,3
33555,18to23,18,23,0.002677889344853,-9.17873329851928,33,33,0,4
33570,23to24,23,24,0.021010047299709,-7.28361752446612,14494,85,14409,3
33585,24to19,24,19,0.381104831163205,-4.89549669273523,5739,116,5623,2
33600,19to14,19,14,0.825700749470295,-3.77393571952463,162,162,0,3
33617,14to9,14,9,0.620624238283547,-4.58076416031773,196,196,0,3
33633,9to4,9,4,0.94405857723326,-4.92252165947407,228,228,0,3
33648,4to3,4,3,0.100972008465144,-7.58335891367048,260,260,0,2
33665,3to4,3,4,0.97014621125158,-3.25601090920318,32,32,0,3
33680,4to9,4,9,0.899027991534856,-5.39688807790262,63,63,0,2
33694,9to4,9,4,0.94405857723326,-4.92252165947407,29,29,0,3
33711,4to3,4,3,0.100972008465144,-7.58335891367048,63,63,0,2
33727,3to4,3,4,0.97014621125158,-3.25601090920318,33,33,0,3
33742,4to9,4,9,0.899027991534856,-5.39688807790262,62,62,0,2
33759,9to4,9,4,0.94405857723326,-4.92252165947407,32,32,0,3
33775,4to9,4,9,0.899027991534856,-5.39688807790262,33,33,0,2
33790,9to4,9,4,0.889333153533907,-5.66445714334504,31,8,23,3
33806,4to9,4,9,0.809155994312219,-6.13882356177359,31,8,23,2
33822,9to8,9,8,0.024876997496427,-9.27310413835336,451,73,378,3
33840,8to3,8,3,0.269559522086973,-3.68436734031584,129,75,54,4
33856,3to4,3,4,0.97014621125158,-3.25601090920318,66,66,0,3
33871,4to9,4,9,0.809155994312219,-6.13882356177359,65,65,0,2
33887,9to14,9,14,0.027757575488236,-9.19382545694759,287,73,214,3
33903,14to13,14,13,0.377365588072957,-5.07827552057825,449,449,0,3
33918,13to8,13,8,0.693145420915346,-5.7228947249899,96,96,0,4
33934,8to9,8,9,0.593868100276837,-2.89449932615566,63,63,0,4
33948,9to4,9,4,0.946600463488392,-5.66445714334504,92,92,0,3
33962,4to3,4,3,0.190844005687781,-7.58335891367048,122,122,0,2
33978,3to4,3,4,0.97014621125158,-3.25601090920318,30,30,0,3
33993,4to9,4,9,0.809155994312219,-6.13882356177359,59,59,0,2
34007,9to4,9,4,0.946600463488392,-5.66445714334504,29,29,0,3
34024,4to9,4,9,0.809155994312219,-6.13882356177359,31,31,0,2
34039,9to4,9,4,0.946600463488392,-5.66445714334504,32,32,0,3
34054,4to3,4,3,0.190844005687781,-7.58335891367048,92,92,0,2
34069,3to4,3,4,0.97014621125158,-3.25601090920318,30,30,0,3
34085,4to9,4,9,0.809155994312219,-6.13882356177359,61,61,0,2
34101,9to4,9,4,0.946600463488392,-5.66445714334504,32,32,0,3
34117,4to9,4,9,0.809155994312219,-6.13882356177359,32,32,0,2
34132,9to4,9,4,0.946600463488392,-5.66445714334504,31,31,0,3
34148,4to3,4,3,0.190844005687781,-7.58335891367048,94,94,0,2
34163,3to4,3,4,0.97014621125158,-3.25601090920318,31,31,0,3
34180,4to9,4,9,0.809155994312219,-6.13882356177359,63,63,0,2
34197,9to4,9,4,0.946600463488392,-5.66445714334504,34,34,0,3
34213,4to3,4,3,0.190844005687781,-7.58335891367048,65,65,0,2
34229,3to2,3,2,0.007743794024712,-8.08656595101861,1234,1234,0,3
34244,2to7,2,7,0.017168672477538,-7.72440481802151,1421,511,910,3
34260,7to12,7,12,0.601986862759919,-1.84512203528664,790,790,0,4
34274,12to13,12,13,0.949811754710102,-4.67657090946632,371,371,0,4
34290,13to8,13,8,0.693145420915346,-5.7228947249899,372,372,0,4
34307,8to9,8,9,0.593868100276837,-2.89449932615566,127,127,0,4
34325,9to4,9,4,0.946600463488392,-5.66445714334504,128,128,0,3
34342,4to3,4,3,0.190844005687781,-7.58335891367048,129,129,0,2
34358,3to2,3,2,0.007743794024712,-8.08656595101861,129,129,0,3
34375,2to1,2,1,0.016366468542711,-7.78263661319192,1395,707,688,3
34391,1to6,1,6,0.237215472027311,-6.64703685976329,4028,675,3353,3
34407,6to11,6,11,0.220999471181871,-5.12379493579202,4061,807,3254,4
34423,11to10,11,10,0.067731939739328,-6.72579694382552,7349,806,6543,4
34440,10to5,10,5,0.261109688484519,-8.86216785635284,4028,740,3288,3
34457,5to0,5,0,0.07358509043692,-7.71416699234986,4028,774,3254,3
34474,0to1,0,1,0.233603778071467,-5.39669788814512,99,99,0,2
34490,1to2,1,2,0.69007066237453,-5.57921175094446,132,132,0,3
34506,2to3,2,3,0.966285718642534,-3.70441168844569,164,164,0,3
34522,3to4,3,4,0.97014621125158,-3.25601090920318,197,197,0,3
34538,4to9,4,9,0.809155994312219,-6.13882356177359,231,231,0,2
34554,9to14,9,14,0.027757575488236,-9.19382545694759,667,667,0,3
34569,14to13,14,13,0.377365588072957,-5.07827552057825,295,295,0,3
34585,13to8,13,8,0.693145420915346,-5.7228947249899,295,295,0,4
34602,8to9,8,9,0.593868100276837,-2.89449932615566,64,64,0,4
34617,9to4,9,4,0.946600463488392,-5.66445714334504,95,95,0,3
34633,4to3,4,3,0.190844005687781,-7.58335891367048,127,127,0,2
34649,3to4,3,4,0.97014621125158,-3.25601090920318,32,32,0,3
34665,4to9,4,9,0.809155994312219,-6.13882356177359,63,63,0,2
34681,9to14,9,14,0.027757575488236,-9.19382545694759,127,127,0,3
34698,14to13,14,13,0.377365588072957,-5.07827552057825,129,129,0,3
34715,13to8,13,8,0.693145420915346,-5.7228947249899,130,130,0,4
34731,8to9,8,9,0.593868100276837,-2.89449932615566,66,66,0,4
34746,9to4,9,4,0.946600463488392,-5.66445714334504,97,97,0,3
34763,4to3,4,3,0.190844005687781,-7.58335891367048,130,130,0,2
34778,3to4,3,4,0.97014621125158,-3.25601090920318,32,32,0,3
34796,4to9,4,9,0.809155994312219,-6.13882356177359,65,65,0,2
34811,9to4,9,4,0.946600463488392,-5.66445714334504,33,33,0,3
34826,4to3,4,3,0.190844005687781,-7.58335891367048,63,63,0,2
34843,3to4,3,4,0.97014621125158,-3.25601090920318,32,32,0,3
34858,4to9,4,9,0.809155994312219,-6.13882356177359,62,62,0,2
34874,9to4,9,4,0.946600463488392,-5.66445714334504,31,31,0,3
34890,4to3,4,3,0.190844005687781,-7.58335891367048,64,64,0,2
34907,3to4,3,4,0.97014621125158,-3.25601090920318,33,33,0,3
34922,4to9,4,9,0.809155994312219,-6.13882356177359,64,64,0,2
34939,9to4,9,4,0.946600463488392,-5.66445714334504,32,32,0,3
34955,4to3,4,3,0.190844005687781,-7.58335891367048,65,65,0,2
34971,3to4,3,4,0.97014621125158,-3.25601090920318,32,32,0,3
34987,4to9,4,9,0.809155994312219,-6.13882356177359,65,65,0,2
35003,9to4,9,4,0.946600463488392,-5.66445714334504,32,32,0,3
35019,4to9,4,9,0.809155994312219,-6.13882356177359,32,32,0,2
35035,9to4,9,4,0.946600463488392,-5.66445714334504,32,32,0,3
35051,4to3,4,3,0.190844005687781,-7.58335891367048,96,96,0,2
35067,3to4,3,4,0.97014621125158,-3.25601090920318,32,32,0,3
35083,4to9,4,9,0.809155994312219,-6.13882356177359,64,64,0,2
35099,9to4,9,4,0.946600463488392,-5.66445714334504,32,32,0,3
35114,4to9,4,9,0.809155994312219,-6.13882356177359,31,31,0,2
35129,9to4,9,4,0.946600463488392,-5.66445714334504,30,30,0,3
35145,4to3,4,3,0.190844005687781,-7.58335891367048,94,94,0,2
35162,3to4,3,4,0.97014621125158,-3.25601090920318,33,33,0,3
35178,4to9,4,9,0.809155994312219,-6.13882356177359,64,64,0,2
35194,9to4,9,4,0.946600463488392,-5.66445714334504,32,32,0,3
35210,4to9,4,9,0.809155994312219,-6.13882356177359,32,32,0,2
35227,9to4,9,4,0.946600463488392,-5.66445714334504,33,33,0,3
35243,4to3,4,3,0.190844005687781,-7.58335891367048,98,98,0,2
35259,3to4,3,4,0.97014621125158,-3.25601090920318,32,32,0,3
35276,4to9,4,9,0.809155994312219,-6.13882356177359,66,66,0,2
35291,9to8,9,8,0.025641961023372,-9.27310413835336,576,576,0,3
35307,8to13,8,13,0.115097438498672,-4.5353775065474,609,609,0,4
35323,13to14,13,14,0.199624701564793,-6.96769543320168,642,642,0,4
35338,14to9,14,9,0.620624238283547,-4.58076416031773,62,62,0,3
35356,9to4,9,4,0.946600463488392,-5.66445714334504,97,97,0,3
35373,4to3,4,3,0.190844005687781,-7.58335891367048,130,130,0,2
35388,3to4,3,4,0.97014621125158,-3.25601090920318,32,32,0,3
35403,4to3,4,3,0.190844005687781,-7.58335891367048,30,30,0,2
35418,3to4,3,4,0.97014621125158,-3.25601090920318,30,30,0,3
35434,4to9,4,9,0.809155994312219,-6.13882356177359,96,96,0,2
35448,9to4,9,4,0.946600463488392,-5.66445714334504,30,30,0,3
35465,4to9,4,9,0.809155994312219,-6.13882356177359,31,31,0,2
35480,9to4,9,4,0.946600463488392,-5.66445714334504,32,32,0,3
35495,4to3,4,3,0.190844005687781,-7.58335891367048,92,92,0,2
35511,3to4,3,4,0.97014621125158,-3.25601090920318,31,31,0,3
35525,4to9,4,9,0.809155994312219,-6.13882356177359,60,60,0,2
35542,9to4,9,4,0.946600463488392,-5.66445714334504,31,31,0,3
35558,4to9,4,9,0.809155994312219,-6.13882356177359,33,33,0,2
35575,9to4,9,4,0.946600463488392,-5.66445714334504,33,33,0,3
35589,4to3,4,3,0.190844005687781,-7.58335891367048,94,94,0,2
35605,3to4,3,4,0.97014621125158,-3.25601090920318,30,30,0,3
35621,4to9,4,9,0.809155994312219,-6.13882356177359,63,63,0,2
35637,9to4,9,4,0.946600463488392,-5.66445714334504,32,32,0,3
35653,4to9,4,9,0.809155994312219,-6.13882356177359,32,32,0,2
35669,9to4,9,4,0.946600463488392,-5.66445714334504,32,32,0,3
35686,4to3,4,3,0.190844005687781,-7.58335891367048,97,97,0,2
35703,3to2,3,2,0.007743794024712,-8.08656595101861,1213,1213,0,3
35719,2to7,2,7,0.017347812814755,-7.72440481802151,1475,1475,0,3
35736,7to12,7,12,0.601986862759919,-1.84512203528664,1476,1476,0,4
35752,12to13,12,13,0.949811754710102,-4.67657090946632,445,445,0,4
35768,13to8,13,8,0.693145420915346,-5.7228947249899,477,477,0,4
35784,8to9,8,9,0.593868100276837,-2.89449932615566,131,131,0,4
35800,9to4,9,4,0.946600463488392,-5.66445714334504,131,131,0,3
35816,4to3,4,3,0.190844005687781,-7.58335891367048,130,130,0,2
35833,3to4,3,4,0.97014621125158,-3.25601090920318,33,33,0,3
35849,4to9,4,9,0.809155994312219,-6.13882356177359,65,65,0,2
35865,9to4,9,4,0.946600463488392,-5.66445714334504,32,32,0,3
35881,4to9,4,9,0.809155994312219,-6.13882356177359,32,32,0,2
35897,9to14,9,14,0.011097297935668,-10.1276233663553,574,38,536,3
35913,14to13,14,13,0.219097850719849,-5.84846185598198,161,37,124,3
35930,13to8,13,8,0.693145420915346,-5.7228947249899,162,162,0,4
35946,8to13,8,13,0.115097438498672,-4.5353775065474,33,33,0,4
35962,13to18,13,18,0.00435734906007,-10.7990926358889,2423,135,2288,4
35977,18to19,18,19,0.003141904865235,-9.02385758316135,2392,133,2259,4
35995,19to14,19,14,0.825700749470295,-3.77393571952463,98,98,0,3
36011,14to9,14,9,0.778381008641982,-4.58076416031773,130,130,0,3
36028,9to4,9,4,0.962821342207016,-5.66445714334504,163,163,0,3
36043,4to3,4,3,0.190844005687781,-7.58335891367048,227,227,0,2
36060,3to4,3,4,0.97014621125158,-3.25601090920318,32,32,0,3
36076,4to9,4,9,0.809155994312219,-6.13882356177359,65,65,0,2
36090,9to4,9,4,0.962821342207016,-5.66445714334504,30,30,0,3
36106,4to9,4,9,0.809155994312219,-6.13882356177359,30,30,0,2
36121,9to4,9,4,0.962821342207016,-5.66445714334504,31,31,0,3
36136,4to3,4,3,0.190844005687781,-7.58335891367048,93,93,0,2
36151,3to4,3,4,0.97014621125158,-3.25601090920318,30,30,0,3
36166,4to9,4,9,0.809155994312219,-6.13882356177359,60,60,0,2
36181,9to4,9,4,0.962821342207016,-5.66445714334504,30,30,0,3
36197,4to9,4,9,0.809155994312219,-6.13882356177359,31,31,0,2
36212,9to4,9,4,0.962821342207016,-5.66445714334504,31,31,0,3
36229,4to3,4,3,0.190844005687781,-7.58335891367048,93,93,0,2
36243,3to4,3,4,0.97014621125158,-3.25601090920318,31,31,0,3
36260,4to9,4,9,0.809155994312219,-6.13882356177359,63,63,0,2
36275,9to4,9,4,0.962821342207016,-5.66445714334504,32,32,0,3
36292,4to3,4,3,0.190844005687781,-7.58335891367048,63,63,0,2
36307,3to4,3,4,0.97014621125158,-3.25601090920318,32,32,0,3
36323,4to9,4,9,0.809155994312219,-6.13882356177359,63,63,0,2
36339,9to4,9,4,0.962821342207016,-5.66445714334504,32,32,0,3
36354,4to9,4,9,0.809155994312219,-6.13882356177359,31,31,0,2
36369,9to4,9,4,0.962821342207016,-5.66445714334504,30,30,0,3
36385,4to3,4,3,0.190844005687781,-7.58335891367048,93,93,0,2
36400,3to4,3,4,0.97014621125158,-3.25601090920318,31,31,0,3
36417,4to9,4,9,0.809155994312219,-6.13882356177359,63,63,0,2
36433,9to4,9,4,0.962821342207016,-5.66445714334504,33,33,0,3
36448,4to9,4,9,0.809155994312219,-6.13882356177359,31,31,0,2
36464,9to4,9,4,0.962821342207016,-5.66445714334504,31,31,0,3
36479,4to3,4,3,0.190844005687781,-7.58335891367048,94,94,0,2
36493,3to4,3,4,0.97014621125158,-3.25601090920318,29,29,0,3
36508,4to9,4,9,0.809155994312219,-6.13882356177359,60,60,0,2
36525,9to8,9,8,0.026081359857316,-9.27310413835336,595,595,0,3
36541,8to13,8,13,0.115097438498672,-4.5353775065474,595,595,0,4
36556,13to14,13,14,0.200991187012191,-6.96769543320168,561,561,0,4
36572,14to9,14,9,0.778381008641982,-4.58076416031773,64,64,0,3
36589,9to4,9,4,0.962821342207016,-5.66445714334504,96,96,0,3
36605,4to3,4,3,0.190844005687781,-7.58335891367048,126,126,0,2
36620,3to4,3,4,0.97014621125158,-3.25601090920318,31,31,0,3
36636,4to9,4,9,0.809155994312219,-6.13882356177359,64,64,0,2
36652,9to4,9,4,0.962821342207016,-5.66445714334504,32,32,0,3
36668,4to9,4,9,0.809155994312219,-6.13882356177359,32,32,0,2
36684,9to4,9,4,0.962821342207016,-5.66445714334504,32,32,0,3
36701,4to3,4,3,0.190844005687781,-7.58335891367048,96,96,0,2
36717,3to4,3,4,0.97014621125158,-3.25601090920318,33,33,0,3
36732,4to9,4,9,0.809155994312219,-6.13882356177359,64,64,0,2
36747,9to4,9,4,0.962821342207016,-5.66445714334504,30,30,0,3
36761,4to9,4,9,0.809155994312219,-6.13882356177359,29,29,0,2
36776,9to4,9,4,0.962821342207016,-5.66445714334504,29,29,0,3
36793,4to3,4,3,0.190844005687781,-7.58335891367048,92,92,0,2
36809,3to4,3,4,0.97014621125158,-3.25601090920318,33,33,0,3
36826,4to9,4,9,0.620268776346531,-7.09266971561974,65,3,62,2
36847,9to4,9,4,0.923506713917634,-6.42761503808188,38,9,29,3
36863,4to3,4,3,0.203896324834719,-8.45478748509905,70,9,61,2
36879,3to4,3,4,0.97014621125158,-3.25601090920318,32,32,0,3
36895,4to9,4,9,0.796103675165281,-7.09266971561974,69,69,0,2
36910,9to8,9,8,0.026602641324001,-10.0029742682235,385,104,281,3
36926,8to13,8,13,0.063932824827008,-5.17953335070324,385,137,248,4
36941,13to12,13,12,0.059206616388176,-8.23065985148847,1205,564,641,4
36957,12to7,12,7,0.013004235952507,-8.98778236086155,1238,69,1169,4
36973,7to6,7,6,0.008952348553185,-6.06806607299553,2582,70,2512,4
36988,6to1,6,1,0.107376833108658,-6.01142499252378,2514,36,2478,4
37006,1to2,1,2,0.457125108476538,-6.55158320144331,1303,36,1267,3
37021,2to3,2,3,0.966285718642534,-3.70441168844569,158,158,0,3
37037,3to4,3,4,0.97014621125158,-3.25601090920318,158,158,0,3
37054,4to9,4,9,0.796103675165281,-7.09266971561974,159,159,0,2
37068,9to4,9,4,0.949912370626526,-6.42761503808188,31,31,0,3
37084,4to9,4,9,0.796103675165281,-7.09266971561974,30,30,0,2
37099,9to4,9,4,0.949912370626526,-6.42761503808188,31,31,0,3
37113,4to3,4,3,0.203896324834719,-8.45478748509905,92,92,0,2
37130,3to4,3,4,0.97014621125158,-3.25601090920318,31,31,0,3
37145,4to9,4,9,0.796103675165281,-7.09266971561974,61,61,0,2
37160,9to4,9,4,0.949912370626526,-6.42761503808188,30,30,0,3
37176,4to9,4,9,0.796103675165281,-7.09266971561974,31,31,0,2
37192,9to4,9,4,0.949912370626526,-6.42761503808188,32,32,0,3
37209,4to3,4,3,0.203896324834719,-8.45478748509905,96,96,0,2
37225,3to4,3,4,0.97014621125158,-3.25601090920318,33,33,0,3
37240,4to9,4,9,0.796103675165281,-7.09266971561974,64,64,0,2
37255,9to14,9,14,0.023484988049473,-10.1276233663553,699,699,0,3
37272,14to13,14,13,0.219097850719849,-5.84846185598198,346,346,0,3
37288,13to8,13,8,0.726906912100731,-5.7228947249899,378,378,0,4
37305,8to9,8,9,0.628205250201048,-2.89449932615566,65,65,0,4
37321,9to4,9,4,0.949912370626526,-6.42761503808188,96,96,0,3
37336,4to3,4,3,0.203896324834719,-8.45478748509905,127,127,0,2
37352,3to4,3,4,0.97014621125158,-3.25601090920318,31,31,0,3
37369,4to9,4,9,0.796103675165281,-7.09266971561974,64,64,0,2
37384,9to4,9,4,0.949912370626526,-6.42761503808188,32,32,0,3
37400,4to3,4,3,0.203896324834719,-8.45478748509905,64,64,0,2
37415,3to4,3,4,0.97014621125158,-3.25601090920318,31,31,0,3
37432,4to9,4,9,0.796103675165281,-7.09266971561974,63,63,0,2
37449,9to4,9,4,0.949912370626526,-6.42761503808188,34,34,0,3
37464,4to9,4,9,0.796103675165281,-7.09266971561974,32,32,0,2
37480,9to4,9,4,0.949912370626526,-6.42761503808188,31,31,0,3
37494,4to3,4,3,0.203896324834719,-8.45478748509905,94,94,0,2
37509,3to4,3,4,0.97014621125158,-3.25601090920318,29,29,0,3
37525,4to3,4,3,0.203896324834719,-8.45478748509905,31,31,0,2
37541,3to4,3,4,0.97014621125158,-3.25601090920318,32,32,0,3
37556,4to9,4,9,0.796103675165281,-7.09266971561974,92,92,0,2
37572,9to4,9,4,0.949912370626526,-6.42761503808188,31,31,0,3
37588,4to9,4,9,0.796103675165281,-7.09266971561974,32,32,0,2
37605,9to4,9,4,0.949912370626526,-6.42761503808188,33,33,0,3
37620,4to3,4,3,0.203896324834719,-8.45478748509905,95,95,0,2
37634,3to4,3,4,0.97014621125158,-3.25601090920318,29,29,0,3
37649,4to9,4,9,0.796103675165281,-7.09266971561974,61,61,0,2
37663,9to4,9,4,0.949912370626526,-6.42761503808188,29,29,0,3
37679,4to9,4,9,0.796103675165281,-7.09266971561974,30,30,0,2
37694,9to4,9,4,0.949912370626526,-6.42761503808188,31,31,0,3
37709,4to3,4,3,0.203896324834719,-8.45478748509905,89,89,0,2
37725,3to4,3,4,0.97014621125158,-3.25601090920318,31,31,0,3
37740,4to9,4,9,0.796103675165281,-7.09266971561974,61,61,0,2
37756,9to4,9,4,0.949912370626526,-6.42761503808188,31,31,0,3
37771,4to9,4,9,0.796103675165281,-7.09266971561974,31,31,0,2
37787,9to4,9,4,0.949912370626526,-6.42761503808188,31,31,0,3
37803,4to3,4,3,0.203896324834719,-8.45478748509905,94,94,0,2
37818,3to4,3,4,0.97014621125158,-3.25601090920318,31,31,0,3
37835,4to3,4,3,0.203896324834719,-8.45478748509905,32,32,0,2
37849,3to4,3,4,0.97014621125158,-3.25601090920318,31,31,0,3
37865,4to9,4,9,0.796103675165281,-7.09266971561974,94,94,0,2
37881,9to8,9,8,0.026602641324001,-10.0029742682235,593,593,0,3
37896,8to13,8,13,0.063932824827008,-5.17953335070324,624,624,0,4
37911,13to14,13,14,0.209347953567764,-6.96769543320168,656,656,0,4
37928,14to9,14,9,0.778381008641982,-4.58076416031773,63,63,0,3
37943,9to8,9,8,0.026602641324001,-10.0029742682235,62,62,0,3
37960,8to3,8,3,0.285145315833234,-3.68436734031584,125,125,0,4
37976,3to4,3,4,0.97014621125158,-3.25601090920318,127,127,0,3
37992,4to9,4,9,0.796103675165281,-7.09266971561974,64,64,0,2
38008,9to4,9,4,0.949912370626526,-6.42761503808188,32,32,0,3
38023,4to9,4,9,0.796103675165281,-7.09266971561974,31,31,0,2
38040,9to4,9,4,0.949912370626526,-6.42761503808188,32,32,0,3
38056,4to3,4,3,0.203896324834719,-8.45478748509905,96,96,0,2
38072,3to2,3,2,0.007743794024712,-8.08656595101861,1066,1066,0,3
38088,2to7,2,7,0.016930790344662,-7.74916167036457,1131,1103,28,3
38104,7to12,7,12,0.610855200737785,-1.84512203528664,1163,1163,0,4
38120,12to13,12,13,0.969215128690204,-4.67657090946632,224,224,0,4
38137,13to12,13,12,0.059206616388176,-8.23065985148847,33,33,0,4
38152,12to11,12,11,0.006051455960631,-9.75884063790405,3745,1134,2611,4
38167,11to10,11,10,0.039944973667445,-7.28322215750074,3744,1657,2087,4
38183,10to15,10,15,0.036392538712177,-10.8911356187278,11629,286,11343,3
38200,15to20,15,20,0.008435132600156,-8.91888249330688,11662,319,11343,3
38217,20to21,20,21,0.120278224707584,-6.70228515828035,11697,354,11343,2
38232,21to16,21,16,0.440523802007294,-5.31452946009733,9133,318,8815,3
38248,16to17,16,17,0.073480152193591,-5.4854324135195,4760,316,4444,4
38264,17to18,17,18,0.034811998297802,-8.46062941222973,2302,83,2219,4
38280,18to13,18,13,0.987121870965031,-3.27389333616027,160,160,0,4
38297,13to8,13,8,0.726906912100731,-5.7228947249899,354,354,0,4
38314,8to9,8,9,0.628205250201048,-2.89449932615566,291,291,0,4
38330,9to4,9,4,0.949912370626526,-6.42761503808188,290,290,0,3
38346,4to3,4,3,0.203896324834719,-8.45478748509905,290,290,0,2
38362,3to4,3,4,0.97014621125158,-3.25601090920318,32,32,0,3
38379,4to9,4,9,0.796103675165281,-7.09266971561974,65,65,0,2
38395,9to4,9,4,0.949912370626526,-6.42761503808188,33,33,0,3
38411,4to9,4,9,0.796103675165281,-7.09266971561974,32,32,0,2
38427,9to4,9,4,0.949912370626526,-6.42761503808188,32,32,0,3
38442,4to3,4,3,0.203896324834719,-8.45478748509905,96,96,0,2
38459,3to4,3,4,0.97014621125158,-3.25601090920318,32,32,0,3
38475,4to9,4,9,0.796103675165281,-7.09266971561974,64,64,0,2
38490,9to4,9,4,0.949912370626526,-6.42761503808188,31,31,0,3
38506,4to9,4,9,0.796103675165281,-7.09266971561974,31,31,0,2
38521,9to4,9,4,0.949912370626526,-6.42761503808188,31,31,0,3
38537,4to3,4,3,0.203896324834719,-8.45478748509905,95,95,0,2
38552,3to4,3,4,0.97014621125158,-3.25601090920318,31,31,0,3
38567,4to9,4,9,0.796103675165281,-7.09266971561974,61,61,0,2
38583,9to14,9,14,0.023484988049473,-10.1276233663553,672,672,0,3
38601,14to13,14,13,0.219097850719849,-5.84846185598198,321,321,0,3
38616,13to8,13,8,0.726906912100731,-5.7228947249899,319,319,0,4
38633,8to9,8,9,0.628205250201048,-2.89449932615566,66,66,0,4
38648,9to4,9,4,0.949912370626526,-6.42761503808188,96,96,0,3
38664,4to3,4,3,0.203896324834719,-8.45478748509905,127,127,0,2
38681,3to4,3,4,0.97014621125158,-3.25601090920318,33,33,0,3
38696,4to9,4,9,0.796103675165281,-7.09266971561974,63,63,0,2
38712,9to4,9,4,0.949912370626526,-6.42761503808188,31,31,0,3
38727,4to9,4,9,0.796103675165281,-7.09266971561974,31,31,0,2
38743,9to4,9,4,0.949912370626526,-6.42761503808188,31,31,0,3
38758,4to9,4,9,0.796103675165281,-7.09266971561974,31,31,0,2
38773,9to4,9,4,0.949912370626526,-6.42761503808188,30,30,0,3
38789,4to3,4,3,0.203896324834719,-8.45478748509905,125,125,0,2
38805,3to4,3,4,0.97014621125158,-3.25601090920318,32,32,0,3
38821,4to9,4,9,0.796103675165281,-7.09266971561974,63,63,0,2
38837,9to4,9,4,0.949912370626526,-6.42761503808188,32,32,0,3
38852,4to9,4,9,0.796103675165281,-7.09266971561974,31,31,0,2
38868,9to4,9,4,0.949912370626526,-6.42761503808188,31,31,0,3
38883,4to3,4,3,0.203896324834719,-8.45478748509905,94,94,0,2
38899,3to4,3,4,0.97014621125158,-3.25601090920318,31,31,0,3
38914,4to9,4,9,0.796103675165281,-7.09266971561974,62,62,0,2
38931,9to14,9,14,0.023484988049473,-10.1276233663553,348,348,0,3
38946,14to13,14,13,0.219097850719849,-5.84846185598198,345,345,0,3
38962,13to8,13,8,0.726906912100731,-5.7228947249899,346,346,0,4
38979,8to9,8,9,0.628205250201048,-2.89449932615566,65,65,0,4
38996,9to4,9,4,0.949912370626526,-6.42761503808188,97,97,0,3
39011,4to3,4,3,0.203896324834719,-8.45478748509905,128,128,0,2
39026,3to4,3,4,0.97014621125158,-3.25601090920318,30,30,0,3
39042,4to3,4,3,0.203896324834719,-8.45478748509905,31,31,0,2
39056,3to4,3,4,0.97014621125158,-3.25601090920318,30,30,0,3
39071,4to9,4,9,0.796103675165281,-7.09266971561974,92,92,0,2
39087,9to4,9,4,0.949912370626526,-6.42761503808188,31,31,0,3
39102,4to9,4,9,0.796103675165281,-7.09266971561974,31,31,0,2
39118,9to4,9,4,0.949912370626526,-6.42761503808188,31,31,0,3
39134,4to3,4,3,0.203896324834719,-8.45478748509905,92,92,0,2
39149,3to4,3,4,0.97014621125158,-3.25601090920318,31,31,0,3
39164,4to9,4,9,0.796103675165281,-7.09266971561974,62,62,0,2
39180,9to4,9,4,0.949912370626526,-6.42761503808188,31,31,0,3
39197,4to9,4,9,0.796103675165281,-7.09266971561974,33,33,0,2
39212,9to14,9,14,0.023484988049473,-10.1276233663553,281,281,0,3
39228,14to13,14,13,0.219097850719849,-5.84846185598198,282,282,0,3
39244,13to14,13,14,0.209347953567764,-6.96769543320168,32,32,0,4
39259,14to9,14,9,0.778381008641982,-4.58076416031773,62,62,0,3
39277,9to4,9,4,0.949912370626526,-6.42761503808188,97,97,0,3
39293,4to3,4,3,0.203896324834719,-8.45478748509905,159,159,0,2
39308,3to4,3,4,0.97014621125158,-3.25601090920318,31,31,0,3
39325,4to9,4,9,0.796103675165281,-7.09266971561974,66,66,0,2
39341,9to4,9,4,0.949912370626526,-6.42761503808188,33,33,0,3
39356,4to9,4,9,0.796103675165281,-7.09266971561974,31,31,0,2
39373,9to4,9,4,0.949912370626526,-6.42761503808188,32,32,0,3
39389,4to3,4,3,0.203896324834719,-8.45478748509905,96,96,0,2
39405,3to4,3,4,0.97014621125158,-3.25601090920318,32,32,0,3
39420,4to9,4,9,0.796103675165281,-7.09266971561974,64,64,0,2
39435,9to8,9,8,0.026602641324001,-10.0029742682235,473,473,0,3
39451,8to7,8,7,0.02271660913871,-6.21426993369706,1363,1363,0,4
39467,7to12,7,12,0.610855200737785,-1.84512203528664,1330,1330,0,4
39483,12to13,12,13,0.975127884686323,-4.67657090946632,255,255,0,4
39500,13to14,13,14,0.209347953567764,-6.96769543320168,256,256,0,4
39516,14to9,14,9,0.778381008641982,-4.58076416031773,96,96,0,3
39532,9to4,9,4,0.949912370626526,-6.42761503808188,127,127,0,3
39548,4to3,4,3,0.203896324834719,-8.45478748509905,159,159,0,2
39564,3to4,3,4,0.97014621125158,-3.25601090920318,32,32,0,3
39580,4to9,4,9,0.796103675165281,-7.09266971561974,64,64,0,2
39596,9to4,9,4,0.949912370626526,-6.42761503808188,32,32,0,3
39611,4to9,4,9,0.796103675165281,-7.09266971561974,31,31,0,2
39626,9to4,9,4,0.949912370626526,-6.42761503808188,30,30,0,3
39642,4to3,4,3,0.203896324834719,-8.45478748509905,94,94,0,2
39658,3to4,3,4,0.97014621125158,-3.25601090920318,32,32,0,3
39674,4to9,4,9,0.796103675165281,-7.09266971561974,63,63,0,2
39688,9to4,9,4,0.949912370626526,-6.42761503808188,30,30,0,3
39703,4to9,4,9,0.796103675165281,-7.09266971561974,29,29,0,2
39719,9to4,9,4,0.949912370626526,-6.42761503808188,31,31,0,3
39735,4to3,4,3,0.203896324834719,-8.45478748509905,93,93,0,2
39751,3to4,3,4,0.97014621125158,-3.25601090920318,32,32,0,3
39766,4to9,4,9,0.796103675165281,-7.09266971561974,63,63,0,2
39781,9to4,9,4,0.949912370626526,-6.42761503808188,30,30,0,3
39798,4to9,4,9,0.796103675165281,-7.09266971561974,32,32,0,2
39812,9to4,9,4,0.949912370626526,-6.42761503808188,31,31,0,3
39828,4to3,4,3,0.203896324834719,-8.45478748509905,93,93,0,2
39844,3to4,3,4,0.97014621125158,-3.25601090920318,32,32,0,3
39860,4to9,4,9,0.796103675165281,-7.09266971561974,62,62,0,2
39876,9to4,9,4,0.949912370626526,-6.42761503808188,32,32,0,3
39892,4to9,4,9,0.796103675165281,-7.09266971561974,32,32,0,2
39908,9to4,9,4,0.949912370626526,-6.42761503808188,32,32,0,3
39925,4to3,4,3,0.203896324834719,-8.45478748509905,97,97,0,2
39940,3to4,3,4,0.97014621125158,-3.25601090920318,32,32,0,3
39955,4to9,4,9,0.796103675165281,-7.09266971561974,63,63,0,2
39970,9to4,9,4,0.949912370626526,-6.42761503808188,30,30,0,3
39986,4to9,4,9,0.796103675165281,-7.09266971561974,31,31,0,2
40001,9to4,9,4,0.949912370626526,-6.42761503808188,31,31,0,3
40017,4to3,4,3,0.203896324834719,-8.45478748509905,92,92,0,2
40033,3to4,3,4,0.97014621125158,-3.25601090920318,32,32,0,3
40048,4to9,4,9,0.796103675165281,-7.09266971561974,62,62,0,2
40064,9to8,9,8,0.026602641324001,-10.0029742682235,629,629,0,3
40079,8to13,8,13,0.063932824827008,-5.17953335070324,596,596,0,4
40096,13to14,13,14,0.209347953567764,-6.96769543320168,596,596,0,4
40112,14to9,14,9,0.778381008641982,-4.58076416031773,64,64,0,3
40128,9to4,9,4,0.949912370626526,-6.42761503808188,95,95,0,3
40143,4to3,4,3,0.203896324834719,-8.45478748509905,126,126,0,2
40159,3to2,3,2,0.007743794024712,-8.08656595101861,2087,2087,0,3
40174,2to1,2,1,0.016373414220162,-7.78263661319192,3186,3186,0,3
40191,1to6,1,6,0.413321720803645,-6.65604866834005,3218,3189,29,3
40209,6to5,6,5,0.112917172776231,-6.01993578749991,5769,3291,2478,4
40224,5to10,5,10,0.492019995863335,-5.81409006431307,2057,2057,0,3
40240,10to11,10,11,0.686797409991317,-7.95346003403328,2088,2088,0,3
40256,11to12,11,12,0.84375997104658,-4.23285694656063,789,789,0,4
40272,12to13,12,13,0.975127884686323,-4.67657090946632,193,193,0,4
40286,13to8,13,8,0.726906912100731,-5.7228947249899,222,222,0,4
40303,8to9,8,9,0.628205250201048,-2.89449932615566,191,191,0,4
40319,9to4,9,4,0.949912370626526,-6.42761503808188,191,191,0,3
40336,4to3,4,3,0.203896324834719,-8.45478748509905,193,193,0,2
40351,3to4,3,4,0.97014621125158,-3.25601090920318,32,32,0,3
40368,4to9,4,9,0.796103675165281,-7.09266971561974,65,65,0,2
40383,9to4,9,4,0.949912370626526,-6.42761503808188,32,32,0,3
40400,4to9,4,9,0.796103675165281,-7.09266971561974,32,32,0,2
40416,9to4,9,4,0.949912370626526,-6.42761503808188,33,33,0,3
40432,4to3,4,3,0.203896324834719,-8.45478748509905,96,96,0,2
40448,3to4,3,4,0.97014621125158,-3.25601090920318,32,32,0,3
40466,4to9,4,9,0.796103675165281,-7.09266971561974,66,66,0,2
40481,9to4,9,4,0.949912370626526,-6.42761503808188,33,33,0,3
40495,4to9,4,9,0.796103675165281,-7.09266971561974,29,29,0,2
40511,9to4,9,4,0.949912370626526,-6.42761503808188,30,30,0,3
40527,4to3,4,3,0.203896324834719,-8.45478748509905,95,95,0,2
40543,3to4,3,4,0.97014621125158,-3.25601090920318,32,32,0,3
40559,4to9,4,9,0.796103675165281,-7.09266971561974,64,64,0,2
40575,9to4,9,4,0.949912370626526,-6.42761503808188,32,32,0,3
40591,4to9,4,9,0.796103675165281,-7.09266971561974,32,32,0,2
40607,9to4,9,4,0.949912370626526,-6.42761503808188,32,32,0,3
40624,4to3,4,3,0.203896324834719,-8.45478748509905,97,97,0,2
40639,3to4,3,4,0.97014621125158,-3.25601090920318,32,32,0,3
40656,4to9,4,9,0.796103675165281,-7.09266971561974,65,65,0,2
40671,9to4,9,4,0.949912370626526,-6.42761503808188,32,32,0,3
40687,4to9,4,9,0.796103675165281,-7.09266971561974,31,31,0,2
40703,9to4,9,4,0.949912370626526,-6.42761503808188,32,32,0,3
40720,4to3,4,3,0.203896324834719,-8.45478748509905,96,96,0,2
40736,3to4,3,4,0.97014621125158,-3.25601090920318,33,33,0,3
40752,4to9,4,9,0.796103675165281,-7.09266971561974,65,65,0,2
40767,9to14,9,14,0.023484988049473,-10.1276233663553,671,671,0,3
40783,14to13,14,13,0.219097850719849,-5.84846185598198,511,511,0,3
40800,13to8,13,8,0.726906912100731,-5.7228947249899,514,514,0,4
40817,8to7,8,7,0.02271660913871,-6.21426993369706,1366,1366,0,4
40833,7to12,7,12,0.610855200737785,-1.84512203528664,577,577,0,4
40848,12to13,12,13,0.975127884686323,-4.67657090946632,65,65,0,4
40862,13to8,13,8,0.726906912100731,-5.7228947249899,62,62,0,4
40877,8to9,8,9,0.628205250201048,-2.89449932615566,125,125,0,4
40893,9to4,9,4,0.949912370626526,-6.42761503808188,157,157,0,3
40909,4to3,4,3,0.203896324834719,-8.45478748509905,189,189,0,2
40924,3to4,3,4,0.97014621125158,-3.25601090920318,31,31,0,3
40940,4to9,4,9,0.796103675165281,-7.09266971561974,63,63,0,2
40955,9to4,9,4,0.949912370626526,-6.42761503808188,31,31,0,3
40970,4to3,4,3,0.105967510600882,-9.22527928837774,61,14,47,2
40984,3to4,3,4,0.97014621125158,-3.25601090920318,29,29,0,3
41001,4to9,4,9,0.894032489399118,-7.09266971561974,61,61,0,2
41016,9to4,9,4,0.949912370626526,-6.42761503808188,32,32,0,3
41031,4to9,4,9,0.894032489399118,-7.09266971561974,30,30,0,2
41047,9to4,9,4,0.949912370626526,-6.42761503808188,31,31,0,3
41062,4to9,4,9,0.894032489399118,-7.09266971561974,31,31,0,2
41078,9to4,9,4,0.949912370626526,-6.42761503808188,31,31,0,3
41092,4to3,4,3,0.105967510600882,-9.22527928837774,122,122,0,2
41108,3to4,3,4,0.97014621125158,-3.25601090920318,30,30,0,3
41122,4to3,4,3,0.105967510600882,-9.22527928837774,30,30,0,2
41139,3to4,3,4,0.97014621125158,-3.25601090920318,31,31,0,3
41155,4to9,4,9,0.894032489399118,-7.09266971561974,93,93,0,2
41171,9to4,9,4,0.949912370626526,-6.42761503808188,32,32,0,3
41186,4to9,4,9,0.894032489399118,-7.09266971561974,31,31,0,2
41202,9to4,9,4,0.949912370626526,-6.42761503808188,31,31,0,3
41217,4to9,4,9,0.894032489399118,-7.09266971561974,31,31,0,2
41233,9to4,9,4,0.949912370626526,-6.42761503808188,31,31,0,3
41249,4to9,4,9,0.894032489399118,-7.09266971561974,32,32,0,2
41266,9to4,9,4,0.949912370626526,-6.42761503808188,33,33,0,3
41282,4to3,4,3,0.105967510600882,-9.22527928837774,160,160,0,2
41297,3to4,3,4,0.97014621125158,-3.25601090920318,31,31,0,3
41313,4to9,4,9,0.894032489399118,-7.09266971561974,64,64,0,2
41328,9to8,9,8,0.021127345148399,-10.2390257703694,466,356,110,3
41343,8to13,8,13,0.048953941561651,-5.46236163353152,495,355,140,4
41358,13to14,13,14,0.150603506448497,-7.36871066162807,591,354,237,4
41375,14to9,14,9,0.778381008641982,-4.58076416031773,62,62,0,3
41394,9to4,9,4,0.955255565287669,-6.42761503808188,97,97,0,3
41411,4to9,4,9,0.894032489399118,-7.09266971561974,36,36,0,2
41428,9to4,9,4,0.955255565287669,-6.42761503808188,34,34,0,3
41444,4to3,4,3,0.105967510600882,-9.22527928837774,162,162,0,2
41459,3to4,3,4,0.97014621125158,-3.25601090920318,31,31,0,3
41474,4to9,4,9,0.894032489399118,-7.09266971561974,63,63,0,2
41490,9to4,9,4,0.955255565287669,-6.42761503808188,31,31,0,3
41507,4to9,4,9,0.894032489399118,-7.09266971561974,33,33,0,2
41523,9to4,9,4,0.955255565287669,-6.42761503808188,33,33,0,3
41538,4to9,4,9,0.894032489399118,-7.09266971561974,31,31,0,2
41553,9to4,9,4,0.955255565287669,-6.42761503808188,30,30,0,3
41570,4to9,4,9,0.894032489399118,-7.09266971561974,32,32,0,2
41586,9to4,9,4,0.955255565287669,-6.42761503808188,33,33,0,3
41601,4to3,4,3,0.105967510600882,-9.22527928837774,157,157,0,2
41616,3to4,3,4,0.97014621125158,-3.25601090920318,30,30,0,3
41633,4to9,4,9,0.894032489399118,-7.09266971561974,63,63,0,2
41650,9to4,9,4,0.955255565287669,-6.42761503808188,34,34,0,3
41666,4to3,4,3,0.105967510600882,-9.22527928837774,65,65,0,2
41682,3to8,3,8,0.022109994723708,-7.03742794635949,354,354,0,3
41698,8to9,8,9,0.638257747883927,-2.89449932615566,65,65,0,4
41714,9to4,9,4,0.955255565287669,-6.42761503808188,64,64,0,3
41731,4to9,4,9,0.894032489399118,-7.09266971561974,33,33,0,2
41747,9to4,9,4,0.955255565287669,-6.42761503808188,33,33,0,3
41763,4to9,4,9,0.894032489399118,-7.09266971561974,32,32,0,2
41778,9to4,9,4,0.955255565287669,-6.42761503808188,31,31,0,3
41794,4to9,4,9,0.894032489399118,-7.09266971561974,31,31,0,2
41811,9to4,9,4,0.955255565287669,-6.42761503808188,33,33,0,3
41826,4to3,4,3,0.105967510600882,-9.22527928837774,160,160,0,2
41842,3to4,3,4,0.97014621125158,-3.25601090920318,31,31,0,3
41859,4to9,4,9,0.894032489399118,-7.09266971561974,65,65,0,2
41875,9to4,9,4,0.955255565287669,-6.42761503808188,33,33,0,3
41891,4to9,4,9,0.894032489399118,-7.09266971561974,32,32,0,2
41905,9to4,9,4,0.955255565287669,-6.42761503808188,30,30,0,3
41921,4to9,4,9,0.894032489399118,-7.09266971561974,30,30,0,2
41936,9to4,9,4,0.955255565287669,-6.42761503808188,31,31,0,3
41951,4to3,4,3,0.105967510600882,-9.22527928837774,125,125,0,2
41967,3to4,3,4,0.97014621125158,-3.25601090920318,31,31,0,3
41984,4to9,4,9,0.894032489399118,-7.09266971561974,63,63,0,2
42001,9to4,9,4,0.955255565287669,-6.42761503808188,34,34,0,3
42017,4to9,4,9,0.894032489399118,-7.09266971561974,33,33,0,2
42032,9to14,9,14,0.023617089563932,-10.1276233663553,674,674,0,3
42048,14to13,14,13,0.219097850719849,-5.84846185598198,705,705,0,3
42064,13to8,13,8,0.780915176357074,-5.7228947249899,382,382,0,4
42079,8to3,8,3,0.289708191781469,-3.68436734031584,128,128,0,4
42094,3to4,3,4,0.97014621125158,-3.25601090920318,93,93,0,3
42110,4to9,4,9,0.894032489399118,-7.09266971561974,93,93,0,2
42125,9to4,9,4,0.955255565287669,-6.42761503808188,31,31,0,3
42139,4to9,4,9,0.894032489399118,-7.09266971561974,29,29,0,2
42155,9to14,9,14,0.023617089563932,-10.1276233663553,123,123,0,3
42172,14to13,14,13,0.219097850719849,-5.84846185598198,124,124,0,3
42189,13to12,13,12,0.063124144404826,-8.23877194588375,1356,1345,11,4
42205,12to17,12,17,0.002810715955153,-10.5286392335905,3957,1122,2835,4
42221,17to16,17,16,0.029434668904609,-8.65481992935253,3989,1410,2579,4
42237,16to15,16,15,0.219207034641963,-4.57334096878678,4054,1442,2612,4
42253,15to10,15,10,0.607456098505106,-4.64200802264497,2029,2029,0,3
42268,10to11,10,11,0.621458021966399,-8.24290776578871,2028,1441,587,3
42283,11to6,11,6,0.067591508859459,-6.78304754245161,2092,1408,684,4
42299,6to7,6,7,0.48928672369266,-4.56794346931066,1482,1439,43,4
42315,7to8,7,8,0.352050763649748,-2.39620659892225,251,251,0,4
42331,8to9,8,9,0.638257747883927,-2.89449932615566,192,192,0,4
42346,9to4,9,4,0.955255565287669,-6.42761503808188,221,221,0,3
42362,4to3,4,3,0.105967510600882,-9.22527928837774,283,283,0,2
42379,3to2,3,2,0.005459674918496,-8.43836775282041,2220,1439,781,3
42394,2to7,2,7,0.016930790344662,-7.74916167036457,95,95,0,3
42409,7to12,7,12,0.610855200737785,-1.84512203528664,220,220,0,4
42425,12to13,12,13,0.977997939642311,-4.67657090946632,253,253,0,4
42441,13to8,13,8,0.781316685161452,-5.7228947249899,126,126,0,4
42457,8to9,8,9,0.638257747883927,-2.89449932615566,126,126,0,4
42472,9to4,9,4,0.955255565287669,-6.42761503808188,126,126,0,3
42488,4to9,4,9,0.894032489399118,-7.09266971561974,31,31,0,2
42503,9to4,9,4,0.955255565287669,-6.42761503808188,31,31,0,3
42519,4to3,4,3,0.105967510600882,-9.22527928837774,157,157,0,2
42535,3to4,3,4,0.972379434368351,-3.25601090920318,32,32,0,3
42550,4to9,4,9,0.894032489399118,-7.09266971561974,62,62,0,2
42565,9to4,9,4,0.955255565287669,-6.42761503808188,30,30,0,3
42580,4to9,4,9,0.894032489399118,-7.09266971561974,30,30,0,2
42594,9to4,9,4,0.955255565287669,-6.42761503808188,29,29,0,3
42609,4to9,4,9,0.894032489399118,-7.09266971561974,29,29,0,2
42625,9to4,9,4,0.955255565287669,-6.42761503808188,31,31,0,3
42640,4to9,4,9,0.894032489399118,-7.09266971561974,31,31,0,2
42656,9to4,9,4,0.955255565287669,-6.42761503808188,31,31,0,3
42672,4to9,4,9,0.894032489399118,-7.09266971561974,32,32,0,2
42686,9to4,9,4,0.955255565287669,-6.42761503808188,30,30,0,3
42701,4to3,4,3,0.105967510600882,-9.22527928837774,182,182,0,2
42717,3to4,3,4,0.972379434368351,-3.25601090920318,31,31,0,3
42733,4to9,4,9,0.894032489399118,-7.09266971561974,61,61,0,2
42749,9to4,9,4,0.955255565287669,-6.42761503808188,32,32,0,3
42766,4to9,4,9,0.894032489399118,-7.09266971561974,33,33,0,2
42781,9to4,9,4,0.955255565287669,-6.42761503808188,32,32,0,3
42798,4to9,4,9,0.894032489399118,-7.09266971561974,32,32,0,2
42814,9to4,9,4,0.955255565287669,-6.42761503808188,33,33,0,3
42829,4to9,4,9,0.894032489399118,-7.09266971561974,31,31,0,2
42846,9to14,9,14,0.023617089563932,-10.1276233663553,691,691,0,3
42863,14to13,14,13,0.219097850719849,-5.84846185598198,438,438,0,3
42878,13to8,13,8,0.781316685161452,-5.7228947249899,437,437,0,4
42894,8to3,8,3,0.289708191781469,-3.68436734031584,193,193,0,4
42911,3to4,3,4,0.972379434368351,-3.25601090920318,97,97,0,3
42928,4to9,4,9,0.894032489399118,-7.09266971561974,99,99,0,2
42943,9to4,9,4,0.955255565287669,-6.42761503808188,32,32,0,3
42959,4to9,4,9,0.894032489399118,-7.09266971561974,31,31,0,2
42975,9to4,9,4,0.955255565287669,-6.42761503808188,32,32,0,3
42991,4to9,4,9,0.894032489399118,-7.09266971561974,32,32,0,2
43007,9to4,9,4,0.955255565287669,-6.42761503808188,32,32,0,3
43024,4to9,4,9,0.894032489399118,-7.09266971561974,33,33,0,2
43039,9to4,9,4,0.955255565287669,-6.42761503808188,32,32,0,3
43056,4to3,4,3,0.105967510600882,-9.22527928837774,162,162,0,2
43072,3to4,3,4,0.972379434368351,-3.25601090920318,33,33,0,3
43088,4to9,4,9,0.894032489399118,-7.09266971561974,64,64,0,2
43103,9to4,9,4,0.955255565287669,-6.42761503808188,31,31,0,3
43118,4to9,4,9,0.894032489399118,-7.09266971561974,30,30,0,2
43133,9to4,9,4,0.955255565287669,-6.42761503808188,30,30,0,3
43150,4to9,4,9,0.894032489399118,-7.09266971561974,32,32,0,2
43166,9to4,9,4,0.955255565287669,-6.42761503808188,33,33,0,3
43182,4to9,4,9,0.894032489399118,-7.09266971561974,32,32,0,2
43198,9to4,9,4,0.955255565287669,-6.42761503808188,32,32,0,3
43213,4to3,4,3,0.056564936786409,-9.90680795079812,157,50,107,2
43230,3to4,3,4,0.972379434368351,-3.25601090920318,32,32,0,3
43246,4to9,4,9,0.931567018178174,-7.29579471561974,64,51,13,2
43263,9to4,9,4,0.955255565287669,-6.42761503808188,33,33,0,3
43279,4to9,4,9,0.931567018178174,-7.29579471561974,33,33,0,2
43294,9to4,9,4,0.955255565287669,-6.42761503808188,31,31,0,3
43309,4to9,4,9,0.931567018178174,-7.29579471561974,30,30,0,2
43324,9to14,9,14,0.011122783216851,-10.8933137429243,478,112,366,3
43341,14to13,14,13,0.219097850719849,-5.84846185598198,478,478,0,3
43357,13to8,13,8,0.655403239353043,-6.35337489200452,479,177,302,4
43374,8to3,8,3,0.289708191781469,-3.68436734031584,161,161,0,4
43389,3to4,3,4,0.972379434368351,-3.25601090920318,95,95,0,3
43405,4to9,4,9,0.931567018178174,-7.29579471561974,96,96,0,2
43420,9to4,9,4,0.967479515077129,-6.42761503808188,31,31,0,3
43436,4to9,4,9,0.931567018178174,-7.29579471561974,31,31,0,2
43452,9to4,9,4,0.967479515077129,-6.42761503808188,32,32,0,3
43468,4to3,4,3,0.068432981821826,-9.90680795079812,94,94,0,2
43484,3to4,3,4,0.972379434368351,-3.25601090920318,32,32,0,3
43500,4to9,4,9,0.931567018178174,-7.29579471561974,64,64,0,2
43516,9to4,9,4,0.967479515077129,-6.42761503808188,32,32,0,3
43532,4to9,4,9,0.931567018178174,-7.29579471561974,32,32,0,2
43548,9to14,9,14,0.011122783216851,-10.8933137429243,224,224,0,3
43563,14to19,14,19,0.000953875236037,-11.2867726824719,7586,201,7385,3
43579,19to18,19,18,0.062659869068402,-6.45174760605647,5315,103,5212,3
43594,18to13,18,13,0.97954593170326,-3.74424906738557,253,134,119,4
43610,13to8,13,8,0.655403239353043,-6.35337489200452,253,253,0,4
43626,8to9,8,9,0.638257747883927,-2.89449932615566,94,94,0,4
43643,9to14,9,14,0.011122783216851,-10.8933137429243,95,95,0,3
43658,14to9,14,9,0.77960402165431,-4.58076416031773,32,32,0,3
43676,9to4,9,4,0.967479515077129,-6.42761503808188,160,160,0,3
43691,4to9,4,9,0.931567018178174,-7.29579471561974,33,33,0,2
43707,9to4,9,4,0.967479515077129,-6.42761503808188,31,31,0,3
43723,4to3,4,3,0.068432981821826,-9.90680795079812,255,255,0,2
43738,3to4,3,4,0.972379434368351,-3.25601090920318,31,31,0,3
43755,4to3,4,3,0.068432981821826,-9.90680795079812,32,32,0,2
43770,3to4,3,4,0.972379434368351,-3.25601090920318,32,32,0,3
43784,4to9,4,9,0.931567018178174,-7.29579471561974,93,93,0,2
43801,9to4,9,4,0.967479515077129,-6.42761503808188,31,31,0,3
43819,4to9,4,9,0.931567018178174,-7.29579471561974,35,35,0,2
43834,9to4,9,4,0.967479515077129,-6.42761503808188,33,33,0,3
43850,4to9,4,9,0.931567018178174,-7.29579471561974,31,31,0,2
43865,9to4,9,4,0.967479515077129,-6.42761503808188,31,31,0,3
43881,4to9,4,9,0.931567018178174,-7.29579471561974,31,31,0,2
43897,9to4,9,4,0.967479515077129,-6.42761503808188,32,32,0,3
43912,4to9,4,9,0.931567018178174,-7.29579471561974,31,31,0,2
43929,9to4,9,4,0.967479515077129,-6.42761503808188,32,32,0,3
43947,4to9,4,9,0.931567018178174,-7.29579471561974,35,35,0,2
43963,9to4,9,4,0.967479515077129,-6.42761503808188,34,34,0,3
43980,4to9,4,9,0.931567018178174,-7.29579471561974,33,33,0,2
43995,9to4,9,4,0.967479515077129,-6.42761503808188,32,32,0,3
44010,4to3,4,3,0.068432981821826,-9.90680795079812,255,255,0,2
44027,3to4,3,4,0.972379434368351,-3.25601090920318,32,32,0,3
44041,4to9,4,9,0.931567018178174,-7.29579471561974,61,61,0,2
44056,9to4,9,4,0.967479515077129,-6.42761503808188,29,29,0,3
44071,4to9,4,9,0.931567018178174,-7.29579471561974,30,30,0,2
44086,9to4,9,4,0.967479515077129,-6.42761503808188,30,30,0,3
44101,4to9,4,9,0.931567018178174,-7.29579471561974,30,30,0,2
44117,9to14,9,14,0.011122783216851,-10.8933137429243,474,474,0,3
44132,14to13,14,13,0.219442103109653,-5.84846185598198,538,538,0,3
44147,13to8,13,8,0.655403239353043,-6.35337489200452,537,537,0,4
44162,8to7,8,7,0.01532458178468,-6.6316907481767,1768,1030,738,4
44178,7to12,7,12,0.466508255517779,-2.4301983495885,1769,734,1035,4
44193,12to13,12,13,0.977997939642311,-4.67657090946632,61,61,0,4
44209,13to8,13,8,0.655403239353043,-6.35337489200452,62,62,0,4
44224,8to9,8,9,0.643324725910363,-2.89449932615566,123,123,0,4
44239,9to4,9,4,0.967479515077129,-6.42761503808188,153,153,0,3
44255,4to3,4,3,0.068432981821826,-9.90680795079812,245,245,0,2
44270,3to4,3,4,0.972379434368351,-3.25601090920318,31,31,0,3
44287,4to9,4,9,0.931567018178174,-7.29579471561974,63,63,0,2
44303,9to4,9,4,0.967479515077129,-6.42761503808188,33,33,0,3
44318,4to9,4,9,0.931567018178174,-7.29579471561974,31,31,0,2
44333,9to4,9,4,0.967479515077129,-6.42761503808188,30,30,0,3
44350,4to9,4,9,0.931567018178174,-7.29579471561974,32,32,0,2
44367,9to4,9,4,0.967479515077129,-6.42761503808188,34,34,0,3
44383,4to9,4,9,0.931567018178174,-7.29579471561974,33,33,0,2
44398,9to4,9,4,0.967479515077129,-6.42761503808188,31,31,0,3
44413,4to9,4,9,0.931567018178174,-7.29579471561974,30,30,0,2
44430,9to4,9,4,0.967479515077129,-6.42761503808188,32,32,0,3
44447,4to9,4,9,0.931567018178174,-7.29579471561974,34,34,0,2
44462,9to4,9,4,0.967479515077129,-6.42761503808188,32,32,0,3
44478,4to3,4,3,0.068432981821826,-9.90680795079812,223,223,0,2
44494,3to4,3,4,0.972379434368351,-3.25601090920318,32,32,0,3
44512,4to9,4,9,0.931567018178174,-7.29579471561974,65,65,0,2
44527,9to4,9,4,0.967479515077129,-6.42761503808188,33,33,0,3
44543,4to9,4,9,0.931567018178174,-7.29579471561974,31,31,0,2
44560,9to4,9,4,0.967479515077129,-6.42761503808188,33,33,0,3
44576,4to9,4,9,0.931567018178174,-7.29579471561974,33,33,0,2
44593,9to4,9,4,0.967479515077129,-6.42761503808188,33,33,0,3
44608,4to9,4,9,0.931567018178174,-7.29579471561974,32,32,0,2
44623,9to4,9,4,0.967479515077129,-6.42761503808188,30,30,0,3
44639,4to9,4,9,0.931567018178174,-7.29579471561974,31,31,0,2
44655,9to8,9,8,0.021397701706019,-10.2390257703694,446,446,0,3
44672,8to3,8,3,0.292008116924097,-3.68436734031584,194,194,0,4
44689,3to4,3,4,0.972379434368351,-3.25601090920318,66,66,0,3
44704,4to9,4,9,0.931567018178174,-7.29579471561974,65,65,0,2
44721,9to4,9,4,0.967479515077129,-6.42761503808188,32,32,0,3
44736,4to9,4,9,0.931567018178174,-7.29579471561974,32,32,0,2
44753,9to4,9,4,0.967479515077129,-6.42761503808188,32,32,0,3
44770,4to9,4,9,0.931567018178174,-7.29579471561974,34,34,0,2
44786,9to4,9,4,0.967479515077129,-6.42761503808188,33,33,0,3
44802,4to9,4,9,0.931567018178174,-7.29579471561974,32,32,0,2
44818,9to4,9,4,0.967479515077129,-6.42761503808188,32,32,0,3
44835,4to9,4,9,0.931567018178174,-7.29579471561974,33,33,0,2
44851,9to4,9,4,0.967479515077129,-6.42761503808188,33,33,0,3
44866,4to9,4,9,0.931567018178174,-7.29579471561974,31,31,0,2
44881,9to4,9,4,0.967479515077129,-6.42761503808188,30,30,0,3
44896,4to3,4,3,0.068432981821826,-9.90680795079812,224,224,0,2
44911,3to4,3,4,0.972379434368351,-3.25601090920318,30,30,0,3
44928,4to9,4,9,0.931567018178174,-7.29579471561974,62,62,0,2
44943,9to4,9,4,0.967479515077129,-6.42761503808188,32,32,0,3
44957,4to9,4,9,0.931567018178174,-7.29579471561974,29,29,0,2
44974,9to4,9,4,0.967479515077129,-6.42761503808188,31,31,0,3
44991,4to9,4,9,0.931567018178174,-7.29579471561974,34,34,0,2
45008,9to4,9,4,0.967479515077129,-6.42761503808188,34,34,0,3
45024,4to9,4,9,0.931567018178174,-7.29579471561974,33,33,0,2
45039,9to4,9,4,0.967479515077129,-6.42761503808188,31,31,0,3
45054,4to9,4,9,0.931567018178174,-7.29579471561974,30,30,0,2
45069,9to4,9,4,0.967479515077129,-6.42761503808188,30,30,0,3
45084,4to9,4,9,0.931567018178174,-7.29579471561974,30,30,0,2
45098,9to4,9,4,0.967479515077129,-6.42761503808188,29,29,0,3
45113,4to3,4,3,0.068432981821826,-9.90680795079812,217,217,0,2
45129,3to4,3,4,0.972379434368351,-3.25601090920318,31,31,0,3
45145,4to9,4,9,0.931567018178174,-7.29579471561974,61,61,0,2
45160,9to4,9,4,0.967479515077129,-6.42761503808188,31,31,0,3
45175,4to9,4,9,0.931567018178174,-7.29579471561974,30,30,0,2
45191,9to4,9,4,0.967479515077129,-6.42761503808188,31,31,0,3
45205,4to9,4,9,0.931567018178174,-7.29579471561974,30,30,0,2
45220,9to4,9,4,0.967479515077129,-6.42761503808188,29,29,0,3
45234,4to9,4,9,0.931567018178174,-7.29579471561974,29,29,0,2
45249,9to4,9,4,0.967479515077129,-6.42761503808188,29,29,0,3
45265,4to9,4,9,0.931567018178174,-7.29579471561974,31,31,0,2
45280,9to4,9,4,0.967479515077129,-6.42761503808188,31,31,0,3
45298,4to9,4,9,0.931567018178174,-7.29579471561974,33,33,0,2
45313,9to4,9,4,0.967479515077129,-6.42761503808188,33,33,0,3
45330,4to9,4,9,0.931567018178174,-7.29579471561974,32,32,0,2
45346,9to4,9,4,0.967479515077129,-6.42761503808188,33,33,0,3
45363,4to3,4,3,0.068432981821826,-9.90680795079812,250,250,0,2
45378,3to4,3,4,0.972379434368351,-3.25601090920318,32,32,0,3
45395,4to9,4,9,0.931567018178174,-7.29579471561974,65,65,0,2
45410,9to4,9,4,0.967479515077129,-6.42761503808188,32,32,0,3
45425,4to9,4,9,0.931567018178174,-7.29579471561974,30,30,0,2
45441,9to8,9,8,0.021397701706019,-10.2390257703694,786,786,0,3
45457,8to13,8,13,0.049342575380861,-5.46236163353152,1264,1264,0,4
45473,13to14,13,14,0.237439987940123,-7.36871066162807,1356,1356,0,4
45489,14to9,14,9,0.77960402165431,-4.58076416031773,64,64,0,3
45506,9to4,9,4,0.967479515077129,-6.42761503808188,96,96,0,3
45522,4to9,4,9,0.931567018178174,-7.29579471561974,33,33,0,2
45538,9to4,9,4,0.967479515077129,-6.42761503808188,32,32,0,3
45555,4to9,4,9,0.931567018178174,-7.29579471561974,33,33,0,2
45570,9to4,9,4,0.967479515077129,-6.42761503808188,32,32,0,3
45586,4to3,4,3,0.068432981821826,-9.90680795079812,223,223,0,2
45602,3to2,3,2,0.004307080043742,-8.67665506278007,3223,2455,768,3
45618,2to1,2,1,0.006110932260807,-8.7785954669759,5444,22,5422,3
45635,1to0,1,0,0.051400562725206,-8.82464274480629,11178,54,11124,3
45651,0to5,0,5,0.550793157000284,-5.19282200161107,5442,86,5356,2
45668,5to10,5,10,0.271539149392115,-6.76899489593825,3415,154,3261,3
45683,10to11,10,11,0.387045348229037,-9.19839824895123,3415,152,3263,3
45700,11to12,11,12,0.711073026707477,-5.19672028427417,1522,55,1467,4
45716,12to13,12,13,0.977997939642311,-4.67657090946632,259,259,0,4
45733,13to8,13,8,0.655403239353043,-6.35337489200452,292,292,0,4
45750,8to9,8,9,0.643324725910363,-2.89449932615566,195,195,0,4
45765,9to4,9,4,0.967479515077129,-6.42761503808188,195,195,0,3
45780,4to9,4,9,0.931567018178174,-7.29579471561974,30,30,0,2
45797,9to4,9,4,0.967479515077129,-6.42761503808188,32,32,0,3
45814,4to9,4,9,0.931567018178174,-7.29579471561974,34,34,0,2
45829,9to4,9,4,0.967479515077129,-6.42761503808188,32,32,0,3
45846,4to3,4,3,0.068432981821826,-9.90680795079812,260,260,0,2
45862,3to4,3,4,0.973506346494591,-3.25601090920318,33,33,0,3
45878,4to9,4,9,0.931567018178174,-7.29579471561974,64,64,0,2
45893,9to4,9,4,0.967479515077129,-6.42761503808188,31,31,0,3
45908,4to9,4,9,0.931567018178174,-7.29579471561974,30,30,0,2
45924,9to4,9,4,0.967479515077129,-6.42761503808188,31,31,0,3
45938,4to9,4,9,0.931567018178174,-7.29579471561974,30,30,0,2
45954,9to4,9,4,0.967479515077129,-6.42761503808188,30,30,0,3
45969,4to9,4,9,0.931567018178174,-7.29579471561974,31,31,0,2
45985,9to4,9,4,0.967479515077129,-6.42761503808188,31,31,0,3
46001,4to9,4,9,0.931567018178174,-7.29579471561974,32,32,0,2
46017,9to4,9,4,0.967479515077129,-6.42761503808188,32,32,0,3
46032,4to9,4,9,0.931567018178174,-7.29579471561974,31,31,0,2
46046,9to4,9,4,0.967479515077129,-6.42761503808188,29,29,0,3
46061,4to3,4,3,0.068432981821826,-9.90680795079812,215,215,0,2
46077,3to2,3,2,0.004208898175659,-8.69981295751692,475,464,11,3
46094,2to7,2,7,0.008079576290426,-8.5084784405509,1932,465,1467,3
46111,7to12,7,12,0.466508255517779,-2.4301983495885,411,411,0,4
46126,12to13,12,13,0.977997939642311,-4.67657090946632,410,410,0,4
46143,13to8,13,8,0.655403239353043,-6.35337489200452,410,410,0,4
46161,8to9,8,9,0.643324725910363,-2.89449932615566,129,129,0,4
46177,9to14,9,14,0.011122783216851,-10.8933137429243,704,704,0,3
46194,14to9,14,9,0.77960402165431,-4.58076416031773,33,33,0,3
46209,9to4,9,4,0.967479515077129,-6.42761503808188,163,163,0,3
46224,4to9,4,9,0.931567018178174,-7.29579471561974,30,30,0,2
46239,9to4,9,4,0.967479515077129,-6.42761503808188,30,30,0,3
46254,4to9,4,9,0.931567018178174,-7.29579471561974,30,30,0,2
46271,9to14,9,14,0.011122783216851,-10.8933137429243,94,94,0,3
46287,14to13,14,13,0.219442103109653,-5.84846185598198,161,161,0,3
46303,13to8,13,8,0.655403239353043,-6.35337489200452,160,160,0,4
46319,8to3,8,3,0.292008116924097,-3.68436734031584,258,258,0,4
46335,3to4,3,4,0.973602340620664,-3.25601090920318,96,96,0,3
46351,4to9,4,9,0.931567018178174,-7.29579471561974,97,97,0,2
46366,9to4,9,4,0.967479515077129,-6.42761503808188,31,31,0,3
46381,4to9,4,9,0.931567018178174,-7.29579471561974,30,30,0,2
46397,9to4,9,4,0.967479515077129,-6.42761503808188,31,31,0,3
46412,4to9,4,9,0.931567018178174,-7.29579471561974,31,31,0,2
46428,9to4,9,4,0.967479515077129,-6.42761503808188,31,31,0,3
46443,4to9,4,9,0.931567018178174,-7.29579471561974,31,31,0,2
46459,9to4,9,4,0.967479515077129,-6.42761503808188,31,31,0,3
46474,4to9,4,9,0.931567018178174,-7.29579471561974,31,31,0,2
46489,9to4,9,4,0.967479515077129,-6.42761503808188,30,30,0,3
46504,4to9,4,9,0.931567018178174,-7.29579471561974,30,30,0,2
46519,9to4,9,4,0.967479515077129,-6.42761503808188,30,30,0,3
46535,4to9,4,9,0.931567018178174,-7.29579471561974,31,31,0,2
46550,9to4,9,4,0.967479515077129,-6.42761503808188,31,31,0,3
46565,4to3,4,3,0.068432981821826,-9.90680795079812,246,246,0,2
46582,3to8,3,8,0.022188761203676,-7.03742794635949,279,279,0,3
46599,8to9,8,9,0.643324725910363,-2.89449932615566,64,64,0,4
46614,9to4,9,4,0.967479515077129,-6.42761503808188,64,64,0,3
46629,4to9,4,9,0.931567018178174,-7.29579471561974,30,30,0,2
46644,9to4,9,4,0.967479515077129,-6.42761503808188,30,30,0,3
46660,4to9,4,9,0.931567018178174,-7.29579471561974,31,31,0,2
46676,9to4,9,4,0.967479515077129,-6.42761503808188,32,32,0,3
46691,4to9,4,9,0.931567018178174,-7.29579471561974,31,31,0,2
46706,9to4,9,4,0.967479515077129,-6.42761503808188,30,30,0,3
46723,4to9,4,9,0.931567018178174,-7.29579471561974,32,32,0,2
46739,9to4,9,4,0.967479515077129,-6.42761503808188,33,33,0,3
46754,4to9,4,9,0.931567018178174,-7.29579471561974,31,31,0,2
46770,9to4,9,4,0.967479515077129,-6.42761503808188,31,31,0,3
46787,4to9,4,9,0.931567018178174,-7.29579471561974,33,33,0,2
46802,9to4,9,4,0.967479515077129,-6.42761503808188,32,32,0,3
46819,4to3,4,3,0.068432981821826,-9.90680795079812,254,254,0,2
46836,3to4,3,4,0.973602340620664,-3.25601090920318,34,34,0,3
46852,4to3,4,3,0.068432981821826,-9.90680795079812,33,33,0,2
46868,3to4,3,4,0.973602340620664,-3.25601090920318,32,32,0,3
46886,4to9,4,9,0.931567018178174,-7.29579471561974,99,99,0,2
46902,9to4,9,4,0.967479515077129,-6.42761503808188,34,34,0,3
46918,4to9,4,9,0.931567018178174,-7.29579471561974,32,32,0,2
46935,9to4,9,4,0.967479515077129,-6.42761503808188,33,33,0,3
46952,4to9,4,9,0.931567018178174,-7.29579471561974,34,34,0,2
46968,9to4,9,4,0.967479515077129,-6.42761503808188,33,33,0,3
46985,4to9,4,9,0.931567018178174,-7.29579471561974,33,33,0,2
47001,9to4,9,4,0.967479515077129,-6.42761503808188,33,33,0,3
47017,4to9,4,9,0.931567018178174,-7.29579471561974,32,32,0,2
47031,9to4,9,4,0.967479515077129,-6.42761503808188,30,30,0,3
47046,4to9,4,9,0.931567018178174,-7.29579471561974,29,29,0,2
47063,9to4,9,4,0.967479515077129,-6.42761503808188,32,32,0,3
47079,4to9,4,9,0.931567018178174,-7.29579471561974,33,33,0,2
47096,9to4,9,4,0.967479515077129,-6.42761503808188,33,33,0,3
47112,4to3,4,3,0.068432981821826,-9.90680795079812,260,260,0,2
47128,3to4,3,4,0.973602340620664,-3.25601090920318,32,32,0,3
47144,4to9,4,9,0.931567018178174,-7.29579471561974,65,65,0,2
47160,9to4,9,4,0.967479515077129,-6.42761503808188,32,32,0,3
47176,4to3,4,3,0.068432981821826,-9.90680795079812,64,64,0,2
47191,3to4,3,4,0.973602340620664,-3.25601090920318,31,31,0,3
47208,4to9,4,9,0.931567018178174,-7.29579471561974,64,64,0,2
47222,9to4,9,4,0.967479515077129,-6.42761503808188,31,31,0,3
47237,4to9,4,9,0.931567018178174,-7.29579471561974,29,29,0,2
47252,9to4,9,4,0.967479515077129,-6.42761503808188,30,30,0,3
47268,4to9,4,9,0.931567018178174,-7.29579471561974,31,31,0,2
47284,9to4,9,4,0.967479515077129,-6.42761503808188,32,32,0,3
47300,4to9,4,9,0.931567018178174,-7.29579471561974,32,32,0,2
47316,9to8,9,8,0.021397701706019,-10.2390257703694,734,734,0,3
47332,8to13,8,13,0.049342575380861,-5.46236163353152,1045,1045,0,4
47349,13to14,13,14,0.237439987940123,-7.36871066162807,1078,1078,0,4
47364,14to13,14,13,0.219442103109653,-5.84846185598198,32,32,0,3
47380,13to12,13,12,0.099469754684181,-8.23877194588375,1269,1269,0,4
47397,12to7,12,7,0.013122077433275,-8.98778236086155,1303,1303,0,4
47412,7to6,7,6,0.006531442420275,-6.70464240366427,5129,1864,3265,4
47427,6to1,6,1,0.115522710859099,-6.01142499252378,1809,1809,0,4
47444,1to2,1,2,0.499051184043837,-6.55158320144331,1367,1367,0,3
47462,2to3,2,3,0.985753362597878,-3.70441168844569,286,286,0,3
47479,3to4,3,4,0.973602340620664,-3.25601090920318,195,195,0,3
47495,4to9,4,9,0.931567018178174,-7.29579471561974,195,195,0,2
47512,9to4,9,4,0.967479515077129,-6.42761503808188,33,33,0,3
47527,4to9,4,9,0.931567018178174,-7.29579471561974,32,32,0,2
47542,9to4,9,4,0.967479515077129,-6.42761503808188,30,30,0,3
47558,4to3,4,3,0.068432981821826,-9.90680795079812,96,96,0,2
47574,3to4,3,4,0.973602340620664,-3.25601090920318,32,32,0,3
47589,4to3,4,3,0.068432981821826,-9.90680795079812,31,31,0,2
47604,3to4,3,4,0.973602340620664,-3.25601090920318,30,30,0,3
47621,4to9,4,9,0.931567018178174,-7.29579471561974,94,94,0,2
47637,9to4,9,4,0.967479515077129,-6.42761503808188,33,33,0,3
47652,4to9,4,9,0.931567018178174,-7.29579471561974,31,31,0,2
47667,9to4,9,4,0.967479515077129,-6.42761503808188,30,30,0,3
47683,4to9,4,9,0.931567018178174,-7.29579471561974,31,31,0,2
47699,9to4,9,4,0.967479515077129,-6.42761503808188,32,32,0,3
47715,4to9,4,9,0.931567018178174,-7.29579471561974,32,32,0,2
47731,9to14,9,14,0.011122783216851,-10.8933137429243,382,382,0,3
47747,14to13,14,13,0.219442103109653,-5.84846185598198,383,383,0,3
47765,13to12,13,12,0.099469754684181,-8.23877194588375,385,385,0,4
47782,12to13,12,13,0.977997939642311,-4.67657090946632,35,35,0,4
47799,13to8,13,8,0.655403239353043,-6.35337489200452,483,483,0,4
47815,8to3,8,3,0.292008116924097,-3.68436734031584,226,226,0,4
47831,3to4,3,4,0.973602340620664,-3.25601090920318,132,132,0,3
47848,4to9,4,9,0.931567018178174,-7.29579471561974,133,133,0,2
47863,9to4,9,4,0.967479515077129,-6.42761503808188,32,32,0,3
47879,4to9,4,9,0.931567018178174,-7.29579471561974,31,31,0,2
47895,9to4,9,4,0.967479515077129,-6.42761503808188,32,32,0,3
47910,4to9,4,9,0.931567018178174,-7.29579471561974,31,31,0,2
47925,9to4,9,4,0.967479515077129,-6.42761503808188,30,30,0,3
47941,4to9,4,9,0.931567018178174,-7.29579471561974,31,31,0,2
47956,9to4,9,4,0.967479515077129,-6.42761503808188,31,31,0,3
47971,4to9,4,9,0.931567018178174,-7.29579471561974,30,30,0,2
47986,9to4,9,4,0.967479515077129,-6.42761503808188,30,30,0,3
48000,4to9,4,9,0.931567018178174,-7.29579471561974,29,29,0,2
48016,9to4,9,4,0.967479515077129,-6.42761503808188,30,30,0,3
48033,4to9,4,9,0.931567018178174,-7.29579471561974,33,33,0,2
48049,9to4,9,4,0.967479515077129,-6.42761503808188,33,33,0,3
48065,4to3,4,3,0.068432981821826,-9.90680795079812,250,250,0,2
48080,3to4,3,4,0.973602340620664,-3.25601090920318,31,31,0,3
48096,4to9,4,9,0.931567018178174,-7.29579471561974,63,63,0,2
48112,9to4,9,4,0.967479515077129,-6.42761503808188,32,32,0,3
48128,4to9,4,9,0.931567018178174,-7.29579471561974,32,32,0,2
48144,9to4,9,4,0.967479515077129,-6.42761503808188,32,32,0,3
48160,4to9,4,9,0.931567018178174,-7.29579471561974,32,32,0,2
48176,9to4,9,4,0.967479515077129,-6.42761503808188,32,32,0,3
48191,4to9,4,9,0.931567018178174,-7.29579471561974,31,31,0,2
48208,9to4,9,4,0.967479515077129,-6.42761503808188,32,32,0,3
48225,4to9,4,9,0.931567018178174,-7.29579471561974,34,34,0,2
48241,9to4,9,4,0.967479515077129,-6.42761503808188,33,33,0,3
48256,4to9,4,9,0.931567018178174,-7.29579471561974,31,31,0,2
48270,9to4,9,4,0.967479515077129,-6.42761503808188,29,29,0,3
48286,4to3,4,3,0.068432981821826,-9.90680795079812,221,221,0,2
48301,3to4,3,4,0.973602340620664,-3.25601090920318,31,31,0,3
48316,4to9,4,9,0.931567018178174,-7.29579471561974,60,60,0,2
48332,9to4,9,4,0.967479515077129,-6.42761503808188,31,31,0,3
48348,4to9,4,9,0.931567018178174,-7.29579471561974,32,32,0,2
48362,9to4,9,4,0.967479515077129,-6.42761503808188,30,30,0,3
48378,4to9,4,9,0.931567018178174,-7.29579471561974,30,30,0,2
48393,9to4,9,4,0.967479515077129,-6.42761503808188,31,31,0,3
48408,4to9,4,9,0.931567018178174,-7.29579471561974,30,30,0,2
48422,9to4,9,4,0.967479515077129,-6.42761503808188,29,29,0,3
48437,4to9,4,9,0.931567018178174,-7.29579471561974,29,29,0,2
48451,9to4,9,4,0.967479515077129,-6.42761503808188,29,29,0,3
48468,4to9,4,9,0.931567018178174,-7.29579471561974,31,31,0,2
48484,9to4,9,4,0.967479515077129,-6.42761503808188,33,33,0,3
48501,4to9,4,9,0.931567018178174,-7.29579471561974,33,33,0,2
48517,9to4,9,4,0.967479515077129,-6.42761503808188,33,33,0,3
48534,4to3,4,3,0.068432981821826,-9.90680795079812,248,248,0,2
48548,3to4,3,4,0.973602340620664,-3.25601090920318,31,31,0,3
48565,4to9,4,9,0.931567018178174,-7.29579471561974,64,64,0,2
48580,9to4,9,4,0.967479515077129,-6.42761503808188,32,32,0,3
48596,4to3,4,3,0.068432981821826,-9.90680795079812,62,62,0,2
48611,3to2,3,2,0.004208898175659,-8.69981295751692,1167,1167,0,3
48627,2to3,2,3,0.985753362597878,-3.70441168844569,31,31,0,3
48644,3to4,3,4,0.973602340620664,-3.25601090920318,64,64,0,3
48659,4to9,4,9,0.931567018178174,-7.29579471561974,94,94,0,2
48674,9to8,9,8,0.021397701706019,-10.2390257703694,875,875,0,3
48688,8to13,8,13,0.049342575380861,-5.46236163353152,906,906,0,4
48703,13to14,13,14,0.10526775732182,-8.34196169043466,972,26,946,4
48719,14to9,14,9,0.671143236820143,-5.13076416031772,60,27,33,3
48734,9to4,9,4,0.967479515077129,-6.42761503808188,90,90,0,3
48750,4to9,4,9,0.931567018178174,-7.29579471561974,31,31,0,2
48764,9to4,9,4,0.967479515077129,-6.42761503808188,30,30,0,3
48780,4to9,4,9,0.931567018178174,-7.29579471561974,30,30,0,2
48796,9to4,9,4,0.967479515077129,-6.42761503808188,32,32,0,3
48812,4to9,4,9,0.931567018178174,-7.29579471561974,32,32,0,2
48826,9to4,9,4,0.967479515077129,-6.42761503808188,30,30,0,3
48842,4to3,4,3,0.068432981821826,-9.90680795079812,215,215,0,2
48858,3to4,3,4,0.973602340620664,-3.25601090920318,32,32,0,3
48876,4to9,4,9,0.931567018178174,-7.29579471561974,64,64,0,2
48892,9to4,9,4,0.967479515077129,-6.42761503808188,34,34,0,3
48908,4to9,4,9,0.931567018178174,-7.29579471561974,32,32,0,2
48923,9to4,9,4,0.967479515077129,-6.42761503808188,31,31,0,3
48939,4to9,4,9,0.931567018178174,-7.29579471561974,31,31,0,2
48953,9to4,9,4,0.967479515077129,-6.42761503808188,30,30,0,3
48969,4to3,4,3,0.068432981821826,-9.90680795079812,127,127,0,2
48985,3to4,3,4,0.973602340620664,-3.25601090920318,32,32,0,3
49001,4to9,4,9,0.931567018178174,-7.29579471561974,62,62,0,2
49019,9to14,9,14,0.011122783216851,-10.8933137429243,316,316,0,3
49034,14to13,14,13,0.327433468957543,-5.84846185598198,346,346,0,3
49050,13to8,13,8,0.752550340502765,-6.44380042391941,376,342,34,4
49067,8to9,8,9,0.643324725910363,-2.89449932615566,66,66,0,4
49083,9to4,9,4,0.967479515077129,-6.42761503808188,98,98,0,3
49098,4to9,4,9,0.931567018178174,-7.29579471561974,31,31,0,2
49114,9to4,9,4,0.967479515077129,-6.42761503808188,31,31,0,3
49131,4to9,4,9,0.931567018178174,-7.29579471561974,33,33,0,2
49147,9to4,9,4,0.967479515077129,-6.42761503808188,33,33,0,3
49163,4to9,4,9,0.931567018178174,-7.29579471561974,32,32,0,2
49179,9to4,9,4,0.967479515077129,-6.42761503808188,32,32,0,3
49196,4to9,4,9,0.931567018178174,-7.29579471561974,33,33,0,2
49212,9to4,9,4,0.967479515077129,-6.42761503808188,33,33,0,3
49226,4to3,4,3,0.068432981821826,-9.90680795079812,257,257,0,2
49240,3to4,3,4,0.973602340620664,-3.25601090920318,28,28,0,3
49257,4to9,4,9,0.931567018178174,-7.29579471561974,61,61,0,2
49273,9to4,9,4,0.967479515077129,-6.42761503808188,33,33,0,3
49287,4to9,4,9,0.931567018178174,-7.29579471561974,30,30,0,2
49304,9to4,9,4,0.967479515077129,-6.42761503808188,31,31,0,3
49319,4to9,4,9,0.931567018178174,-7.29579471561974,32,32,0,2
49335,9to4,9,4,0.967479515077129,-6.42761503808188,31,31,0,3
49350,4to9,4,9,0.931567018178174,-7.29579471561974,31,31,0,2
49366,9to4,9,4,0.967479515077129,-6.42761503808188,31,31,0,3
49381,4to9,4,9,0.931567018178174,-7.29579471561974,31,31,0,2
49395,9to4,9,4,0.967479515077129,-6.42761503808188,29,29,0,3
49410,4to9,4,9,0.931567018178174,-7.29579471561974,29,29,0,2
49427,9to8,9,8,0.021397701706019,-10.2390257703694,377,377,0,3
49443,8to3,8,3,0.292008116924097,-3.68436734031584,217,217,0,4
49458,3to4,3,4,0.973602340620664,-3.25601090920318,63,63,0,3
49474,4to9,4,9,0.931567018178174,-7.29579471561974,64,64,0,2
49489,9to4,9,4,0.967479515077129,-6.42761503808188,31,31,0,3
49506,4to9,4,9,0.931567018178174,-7.29579471561974,32,32,0,2
49520,9to4,9,4,0.967479515077129,-6.42761503808188,31,31,0,3
49535,4to9,4,9,0.931567018178174,-7.29579471561974,29,29,0,2
49550,9to14,9,14,0.011122783216851,-10.8933137429243,531,531,0,3
49566,14to13,14,13,0.327433468957543,-5.84846185598198,532,532,0,3
49583,13to12,13,12,0.125022831184414,-8.23877194588375,1818,1818,0,4
49599,12to7,12,7,0.007219008513669,-9.59132459519398,2202,873,1329,4
49615,7to8,7,8,0.48544384411283,-2.39620659892225,188,188,0,4
49632,8to9,8,9,0.643324725910363,-2.89449932615566,97,97,0,4
49649,9to4,9,4,0.967479515077129,-6.42761503808188,129,129,0,3
49664,4to9,4,9,0.931567018178174,-7.29579471561974,32,32,0,2
49680,9to4,9,4,0.967479515077129,-6.42761503808188,31,31,0,3
49696,4to3,4,3,0.068432981821826,-9.90680795079812,253,253,0,2
49712,3to4,3,4,0.973602340620664,-3.25601090920318,32,32,0,3
49729,4to9,4,9,0.931567018178174,-7.29579471561974,65,65,0,2
49745,9to4,9,4,0.967479515077129,-6.42761503808188,33,33,0,3
49760,4to9,4,9,0.931567018178174,-7.29579471561974,31,31,0,2
49775,9to4,9,4,0.967479515077129,-6.42761503808188,30,30,0,3
49790,4to9,4,9,0.931567018178174,-7.29579471561974,30,30,0,2
49806,9to4,9,4,0.967479515077129,-6.42761503808188,31,31,0,3
49821,4to9,4,9,0.931567018178174,-7.29579471561974,31,31,0,2
49836,9to4,9,4,0.967479515077129,-6.42761503808188,30,30,0,3
49852,4to9,4,9,0.931567018178174,-7.29579471561974,31,31,0,2
49868,9to4,9,4,0.967479515077129,-6.42761503808188,32,32,0,3
49884,4to9,4,9,0.931567018178174,-7.29579471561974,32,32,0,2
49900,9to4,9,4,0.967479515077129,-6.42761503808188,32,32,0,3
49915,4to9,4,9,0.931567018178174,-7.29579471561974,31,31,0,2
49931,9to4,9,4,0.967479515077129,-6.42761503808188,31,31,0,3
49947,4to3,4,3,0.068432981821826,-9.90680795079812,251,251,0,2
49962,3to4,3,4,0.973602340620664,-3.25601090920318,31,31,0,3
49978,4to9,4,9,0.931567018178174,-7.29579471561974,63,63,0,2
49994,9to4,9,4,0.967479515077129,-6.42761503808188,32,32,0,3
50009,4to9,4,9,0.931567018178174,-7.29579471561974,31,31,0,2
50025,9to4,9,4,0.967479515077129,-6.42761503808188,31,31,0,3
50040,4to9,4,9,0.931567018178174,-7.29579471561974,31,31,0,2
50055,9to4,9,4,0.967479515077129,-6.42761503808188,30,30,0,3
50071,4to9,4,9,0.931567018178174,-7.29579471561974,31,31,0,2
50088,9to4,9,4,0.967479515077129,-6.42761503808188,33,33,0,3
50103,4to9,4,9,0.931567018178174,-7.29579471561974,32,32,0,2
50120,9to4,9,4,0.967479515077129,-6.42761503808188,32,32,0,3
50135,4to9,4,9,0.931567018178174,-7.29579471561974,32,32,0,2
50150,9to4,9,4,0.967479515077129,-6.42761503808188,30,30,0,3
50164,4to9,4,9,0.931567018178174,-7.29579471561974,29,29,0,2
50179,9to4,9,4,0.967479515077129,-6.42761503808188,29,29,0,3
50194,4to3,4,3,0.068432981821826,-9.90680795079812,247,247,0,2
50210,3to8,3,8,0.022188761203676,-7.03742794635949,595,595,0,3
50226,8to13,8,13,0.049342575380861,-5.46236163353152,660,660,0,4
50240,13to12,13,12,0.125022831184414,-8.23877194588375,657,657,0,4
50258,12to11,12,11,0.003080302143947,-10.4460537526582,4575,1431,3144,4
50274,11to16,11,16,0.021742890739847,-8.71893230942369,8053,281,7772,4
50289,16to15,16,15,0.096616710170901,-5.53844280683944,8052,281,7771,4
50307,15to10,15,10,0.607456098505106,-4.64200802264497,4639,4639,0,3
50323,10to5,10,5,0.37792880428454,-9.52783566457202,4672,1562,3110,3
50339,5to6,5,6,0.506017351204216,-6.41661914766716,2927,1528,1399,3
50355,6to1,6,1,0.075666122389475,-6.47863810727788,2928,1560,1368,4
50372,1to2,1,2,0.499051184043837,-6.55158320144331,1761,1761,0,3
50388,2to3,2,3,0.985753362597878,-3.70441168844569,194,194,0,3
50406,3to4,3,4,0.973602340620664,-3.25601090920318,227,227,0,3
50422,4to9,4,9,0.931567018178174,-7.29579471561974,258,258,0,2
50436,9to4,9,4,0.967479515077129,-6.42761503808188,30,30,0,3
50452,4to9,4,9,0.931567018178174,-7.29579471561974,30,30,0,2
50468,9to4,9,4,0.967479515077129,-6.42761503808188,32,32,0,3
50483,4to9,4,9,0.931567018178174,-7.29579471561974,31,31,0,2
50498,9to4,9,4,0.967479515077129,-6.42761503808188,30,30,0,3
50514,4to9,4,9,0.931567018178174,-7.29579471561974,31,31,0,2
50529,9to4,9,4,0.967479515077129,-6.42761503808188,31,31,0,3
50545,4to9,4,9,0.931567018178174,-7.29579471561974,31,31,0,2
50561,9to4,9,4,0.967479515077129,-6.42761503808188,32,32,0,3
50577,4to9,4,9,0.931567018178174,-7.29579471561974,32,32,0,2
50594,9to8,9,8,0.021397701706019,-10.2390257703694,384,384,0,3
50611,8to3,8,3,0.292008116924097,-3.68436734031584,223,223,0,4
50628,3to4,3,4,0.973602340620664,-3.25601090920318,67,67,0,3
50646,4to9,4,9,0.931567018178174,-7.29579471561974,69,69,0,2
50662,9to4,9,4,0.967479515077129,-6.42761503808188,34,34,0,3
50679,4to9,4,9,0.931567018178174,-7.29579471561974,33,33,0,2
50693,9to4,9,4,0.967479515077129,-6.42761503808188,31,31,0,3
50709,4to9,4,9,0.931567018178174,-7.29579471561974,30,30,0,2
50725,9to4,9,4,0.967479515077129,-6.42761503808188,32,32,0,3
50740,4to9,4,9,0.931567018178174,-7.29579471561974,31,31,0,2
50756,9to4,9,4,0.967479515077129,-6.42761503808188,31,31,0,3
50772,4to9,4,9,0.931567018178174,-7.29579471561974,32,32,0,2
50789,9to4,9,4,0.967479515077129,-6.42761503808188,33,33,0,3
50804,4to9,4,9,0.931567018178174,-7.29579471561974,32,32,0,2
50821,9to4,9,4,0.967479515077129,-6.42761503808188,32,32,0,3
50838,4to9,4,9,0.931567018178174,-7.29579471561974,34,34,0,2
50852,9to4,9,4,0.967479515077129,-6.42761503808188,31,31,0,3
50867,4to3,4,3,0.068432981821826,-9.90680795079812,256,256,0,2
50883,3to4,3,4,0.973602340620664,-3.25601090920318,31,31,0,3
50900,4to9,4,9,0.931567018178174,-7.29579471561974,62,62,0,2
50914,9to4,9,4,0.967479515077129,-6.42761503808188,31,31,0,3
50931,4to9,4,9,0.931567018178174,-7.29579471561974,31,31,0,2
50946,9to4,9,4,0.967479515077129,-6.42761503808188,32,32,0,3
50962,4to9,4,9,0.931567018178174,-7.29579471561974,31,31,0,2
50978,9to14,9,14,0.011122783216851,-10.8933137429243,1428,1428,0,3
50994,14to13,14,13,0.327433468957543,-5.84846185598198,768,768,0,3
51009,13to8,13,8,0.752550340502765,-6.44380042391941,415,415,0,4
51024,8to3,8,3,0.292008116924097,-3.68436734031584,157,157,0,4
51040,3to4,3,4,0.973602340620664,-3.25601090920318,94,94,0,3
51057,4to9,4,9,0.931567018178174,-7.29579471561974,95,95,0,2
51074,9to4,9,4,0.967479515077129,-6.42761503808188,34,34,0,3
51089,4to9,4,9,0.931567018178174,-7.29579471561974,32,32,0,2
51105,9to4,9,4,0.967479515077129,-6.42761503808188,31,31,0,3
51119,4to9,4,9,0.931567018178174,-7.29579471561974,30,30,0,2
51135,9to4,9,4,0.967479515077129,-6.42761503808188,30,30,0,3
51151,4to9,4,9,0.931567018178174,-7.29579471561974,32,32,0,2
51167,9to4,9,4,0.967479515077129,-6.42761503808188,32,32,0,3
51183,4to9,4,9,0.931567018178174,-7.29579471561974,32,32,0,2
51198,9to4,9,4,0.967479515077129,-6.42761503808188,31,31,0,3
51214,4to9,4,9,0.931567018178174,-7.29579471561974,31,31,0,2
51231,9to8,9,8,0.021397701706019,-10.2390257703694,222,222,0,3
51247,8to7,8,7,0.01532458178468,-6.6316907481767,1648,1648,0,4
51262,7to12,7,12,0.469220057558042,-2.4301983495885,1022,1022,0,4
51276,12to13,12,13,0.986842580741535,-4.67657090946632,282,282,0,4
51292,13to18,13,18,0.003662699601857,-11.7751071568276,7713,185,7528,4
51307,18to23,18,23,0.001578969941471,-10.1772686748149,17752,26,17726,4
51322,23to22,23,22,0.08569276655487,-6.01493936008742,17818,24,17794,3
51339,22to17,22,17,0.893375874932991,-4.00504444405007,9134,24,9110,3
51355,17to12,17,12,0.925821901928086,-5.20631123779532,93,93,0,4
51372,12to13,12,13,0.986842580741535,-4.67657090946632,96,96,0,4
51388,13to8,13,8,0.757108978848607,-6.44380042391941,157,157,0,4
51405,8to9,8,9,0.643324725910363,-2.89449932615566,191,191,0,4
51421,9to4,9,4,0.967479515077129,-6.42761503808188,223,223,0,3
51436,4to3,4,3,0.068432981821826,-9.90680795079812,412,412,0,2
51452,3to4,3,4,0.973602340620664,-3.25601090920318,31,31,0,3
51467,4to9,4,9,0.931567018178174,-7.29579471561974,62,62,0,2
51483,9to4,9,4,0.967479515077129,-6.42761503808188,31,31,0,3
51500,4to3,4,3,0.068432981821826,-9.90680795079812,64,64,0,2
51516,3to4,3,4,0.973602340620664,-3.25601090920318,33,33,0,3
51532,4to9,4,9,0.931567018178174,-7.29579471561974,65,65,0,2
51547,9to4,9,4,0.967479515077129,-6.42761503808188,31,31,0,3
51562,4to9,4,9,0.931567018178174,-7.29579471561974,30,30,0,2
51578,9to4,9,4,0.967479515077129,-6.42761503808188,31,31,0,3
51593,4to9,4,9,0.931567018178174,-7.29579471561974,31,31,0,2
51610,9to4,9,4,0.967479515077129,-6.42761503808188,32,32,0,3
51625,4to9,4,9,0.931567018178174,-7.29579471561974,32,32,0,2
51641,9to4,9,4,0.967479515077129,-6.42761503808188,31,31,0,3
51656,4to9,4,9,0.931567018178174,-7.29579471561974,31,31,0,2
51671,9to8,9,8,0.021397701706019,-10.2390257703694,283,283,0,3
51688,8to3,8,3,0.292008116924097,-3.68436734031584,188,188,0,4
51705,3to4,3,4,0.973602340620664,-3.25601090920318,64,64,0,3
51721,4to9,4,9,0.931567018178174,-7.29579471561974,65,65,0,2
51735,9to4,9,4,0.967479515077129,-6.42761503808188,30,30,0,3
51750,4to9,4,9,0.931567018178174,-7.29579471561974,29,29,0,2
51766,9to4,9,4,0.967479515077129,-6.42761503808188,31,31,0,3
51782,4to9,4,9,0.931567018178174,-7.29579471561974,32,32,0,2
51796,9to4,9,4,0.967479515077129,-6.42761503808188,30,30,0,3
51813,4to9,4,9,0.931567018178174,-7.29579471561974,31,31,0,2
51829,9to4,9,4,0.967479515077129,-6.42761503808188,33,33,0,3
51844,4to9,4,9,0.931567018178174,-7.29579471561974,31,31,0,2
51859,9to4,9,4,0.967479515077129,-6.42761503808188,30,30,0,3
51874,4to9,4,9,0.931567018178174,-7.29579471561974,30,30,0,2
51890,9to4,9,4,0.967479515077129,-6.42761503808188,31,31,0,3
51906,4to9,4,9,0.931567018178174,-7.29579471561974,32,32,0,2
51921,9to4,9,4,0.967479515077129,-6.42761503808188,31,31,0,3
51937,4to3,4,3,0.068432981821826,-9.90680795079812,249,249,0,2
51954,3to4,3,4,0.973602340620664,-3.25601090920318,33,33,0,3
51970,4to9,4,9,0.931567018178174,-7.29579471561974,64,64,0,2
51987,9to4,9,4,0.967479515077129,-6.42761503808188,33,33,0,3
52003,4to9,4,9,0.931567018178174,-7.29579471561974,33,33,0,2
52018,9to4,9,4,0.967479515077129,-6.42761503808188,31,31,0,3
52032,4to9,4,9,0.931567018178174,-7.29579471561974,29,29,0,2
52048,9to4,9,4,0.967479515077129,-6.42761503808188,30,30,0,3
52064,4to9,4,9,0.931567018178174,-7.29579471561974,32,32,0,2
52079,9to4,9,4,0.967479515077129,-6.42761503808188,31,31,0,3
52094,4to9,4,9,0.931567018178174,-7.29579471561974,30,30,0,2
52110,9to4,9,4,0.967479515077129,-6.42761503808188,31,31,0,3
52126,4to9,4,9,0.931567018178174,-7.29579471561974,32,32,0,2
52142,9to4,9,4,0.967479515077129,-6.42761503808188,32,32,0,3
52156,4to9,4,9,0.931567018178174,-7.29579471561974,30,30,0,2
52171,9to4,9,4,0.967479515077129,-6.42761503808188,29,29,0,3
52187,4to3,4,3,0.068432981821826,-9.90680795079812,250,250,0,2
52203,3to4,3,4,0.973602340620664,-3.25601090920318,32,32,0,3
52219,4to9,4,9,0.931567018178174,-7.29579471561974,63,63,0,2
52234,9to4,9,4,0.967479515077129,-6.42761503808188,31,31,0,3
52250,4to9,4,9,0.931567018178174,-7.29579471561974,31,31,0,2
52267,9to4,9,4,0.967479515077129,-6.42761503808188,33,33,0,3
52283,4to9,4,9,0.931567018178174,-7.29579471561974,33,33,0,2
52297,9to4,9,4,0.967479515077129,-6.42761503808188,30,30,0,3
52312,4to9,4,9,0.931567018178174,-7.29579471561974,29,29,0,2
52329,9to14,9,14,0.011122783216851,-10.8933137429243,1351,1351,0,3
52345,14to13,14,13,0.268460546896192,-6.1310928940087,973,698,275,3
52360,13to8,13,8,0.757108978848607,-6.44380042391941,689,689,0,4
52375,8to13,8,13,0.049342575380861,-5.46236163353152,30,30,0,4
52391,13to12,13,12,0.099370363351346,-8.50421596132777,1036,761,275,4
52406,12to13,12,13,0.986842580741535,-4.67657090946632,31,31,0,4
52423,13to8,13,8,0.7799809148121,-6.44380042391941,63,63,0,4
52439,8to9,8,9,0.643324725910363,-2.89449932615566,127,127,0,4
52456,9to4,9,4,0.967479515077129,-6.42761503808188,159,159,0,3
52473,4to3,4,3,0.068432981821826,-9.90680795079812,286,286,0,2
52489,3to4,3,4,0.973602340620664,-3.25601090920318,33,33,0,3
52505,4to9,4,9,0.931567018178174,-7.29579471561974,66,66,0,2
52521,9to4,9,4,0.967479515077129,-6.42761503808188,32,32,0,3
52537,4to9,4,9,0.931567018178174,-7.29579471561974,32,32,0,2
52553,9to4,9,4,0.967479515077129,-6.42761503808188,32,32,0,3
52571,4to9,4,9,0.931567018178174,-7.29579471561974,34,34,0,2
52587,9to4,9,4,0.967479515077129,-6.42761503808188,34,34,0,3
52602,4to9,4,9,0.931567018178174,-7.29579471561974,31,31,0,2
52617,9to4,9,4,0.967479515077129,-6.42761503808188,30,30,0,3
52633,4to9,4,9,0.931567018178174,-7.29579471561974,31,31,0,2
52649,9to4,9,4,0.967479515077129,-6.42761503808188,32,32,0,3
52665,4to9,4,9,0.931567018178174,-7.29579471561974,32,32,0,2
52680,9to4,9,4,0.967479515077129,-6.42761503808188,31,31,0,3
52697,4to3,4,3,0.068432981821826,-9.90680795079812,224,224,0,2
52711,3to4,3,4,0.973602340620664,-3.25601090920318,31,31,0,3
52727,4to9,4,9,0.931567018178174,-7.29579471561974,62,62,0,2
52743,9to4,9,4,0.967479515077129,-6.42761503808188,32,32,0,3
52759,4to9,4,9,0.931567018178174,-7.29579471561974,32,32,0,2
52775,9to4,9,4,0.967479515077129,-6.42761503808188,32,32,0,3
52790,4to9,4,9,0.931567018178174,-7.29579471561974,31,31,0,2
52805,9to4,9,4,0.967479515077129,-6.42761503808188,30,30,0,3
52820,4to9,4,9,0.931567018178174,-7.29579471561974,30,30,0,2
52835,9to14,9,14,0.011122783216851,-10.8933137429243,506,506,0,3
52851,14to13,14,13,0.268460546896192,-6.1310928940087,445,445,0,3
52869,13to8,13,8,0.7799809148121,-6.44380042391941,446,446,0,4
52886,8to3,8,3,0.292008116924097,-3.68436734031584,189,189,0,4
52901,3to4,3,4,0.973602340620664,-3.25601090920318,96,96,0,3
52917,4to9,4,9,0.931567018178174,-7.29579471561974,97,97,0,2
52933,9to14,9,14,0.011122783216851,-10.8933137429243,98,98,0,3
52951,14to13,14,13,0.268460546896192,-6.1310928940087,100,100,0,3
52968,13to8,13,8,0.7799809148121,-6.44380042391941,99,99,0,4
52983,8to9,8,9,0.643324725910363,-2.89449932615566,66,66,0,4
52998,9to4,9,4,0.967479515077129,-6.42761503808188,97,97,0,3
53013,4to9,4,9,0.931567018178174,-7.29579471561974,30,30,0,2
53027,9to4,9,4,0.967479515077129,-6.42761503808188,29,29,0,3
53043,4to9,4,9,0.931567018178174,-7.29579471561974,30,30,0,2
53058,9to4,9,4,0.967479515077129,-6.42761503808188,31,31,0,3
53074,4to9,4,9,0.931567018178174,-7.29579471561974,31,31,0,2
53091,9to4,9,4,0.967479515077129,-6.42761503808188,33,33,0,3
53107,4to9,4,9,0.931567018178174,-7.29579471561974,33,33,0,2
53122,9to4,9,4,0.967479515077129,-6.42761503808188,31,31,0,3
53137,4to3,4,3,0.068432981821826,-9.90680795079812,251,251,0,2
53153,3to4,3,4,0.973602340620664,-3.25601090920318,31,31,0,3
53169,4to9,4,9,0.931567018178174,-7.29579471561974,62,62,0,2
53185,9to4,9,4,0.967479515077129,-6.42761503808188,32,32,0,3
53202,4to9,4,9,0.931567018178174,-7.29579471561974,33,33,0,2
53218,9to4,9,4,0.967479515077129,-6.42761503808188,33,33,0,3
53233,4to9,4,9,0.931567018178174,-7.29579471561974,31,31,0,2
53247,9to4,9,4,0.967479515077129,-6.42761503808188,29,29,0,3
53263,4to9,4,9,0.931567018178174,-7.29579471561974,30,30,0,2
53280,9to4,9,4,0.967479515077129,-6.42761503808188,33,33,0,3
53295,4to9,4,9,0.931567018178174,-7.29579471561974,32,32,0,2
53312,9to4,9,4,0.967479515077129,-6.42761503808188,32,32,0,3
53329,4to9,4,9,0.931567018178174,-7.29579471561974,34,34,0,2
53345,9to4,9,4,0.967479515077129,-6.42761503808188,33,33,0,3
53360,4to9,4,9,0.931567018178174,-7.29579471561974,31,31,0,2
53376,9to4,9,4,0.967479515077129,-6.42761503808188,31,31,0,3
53390,4to3,4,3,0.068432981821826,-9.90680795079812,253,253,0,2
53406,3to4,3,4,0.973602340620664,-3.25601090920318,30,30,0,3
53422,4to9,4,9,0.931567018178174,-7.29579471561974,62,62,0,2
53438,9to4,9,4,0.967479515077129,-6.42761503808188,32,32,0,3
53454,4to9,4,9,0.931567018178174,-7.29579471561974,32,32,0,2
53471,9to4,9,4,0.967479515077129,-6.42761503808188,33,33,0,3
53486,4to9,4,9,0.931567018178174,-7.29579471561974,32,32,0,2
53502,9to4,9,4,0.967479515077129,-6.42761503808188,31,31,0,3
53517,4to3,4,3,0.068432981821826,-9.90680795079812,127,127,0,2
53533,3to4,3,4,0.973602340620664,-3.25601090920318,31,31,0,3
53549,4to9,4,9,0.931567018178174,-7.29579471561974,63,63,0,2
53565,9to14,9,14,0.011122783216851,-10.8933137429243,632,632,0,3
53581,14to13,14,13,0.268460546896192,-6.1310928940087,630,630,0,3
53597,13to8,13,8,0.7799809148121,-6.44380042391941,629,629,0,4
53614,8to7,8,7,0.013152515692869,-6.78673933288308,2367,2000,367,4
53630,7to6,7,6,0.004557238923114,-7.06653848388305,3291,2100,1191,4
53645,6to11,6,11,0.231303547576712,-5.44531840789122,3387,2298,1089,4
53661,11to12,11,12,0.736197825100797,-5.19672028427417,1270,1270,0,4
53677,12to13,12,13,0.986842580741535,-4.67657090946632,96,96,0,4
53692,13to8,13,8,0.7799809148121,-6.44380042391941,95,95,0,4
53709,8to9,8,9,0.644743816706501,-2.89449932615566,160,160,0,4
53725,9to4,9,4,0.967479515077129,-6.42761503808188,192,192,0,3
53742,4to9,4,9,0.931567018178174,-7.29579471561974,33,33,0,2
53757,9to4,9,4,0.967479515077129,-6.42761503808188,32,32,0,3
53772,4to9,4,9,0.931567018178174,-7.29579471561974,30,30,0,2
53788,9to4,9,4,0.967479515077129,-6.42761503808188,31,31,0,3
53804,4to3,4,3,0.068432981821826,-9.90680795079812,287,287,0,2
53820,3to4,3,4,0.973602340620664,-3.25601090920318,32,32,0,3
53837,4to9,4,9,0.931567018178174,-7.29579471561974,65,65,0,2
53854,9to4,9,4,0.967479515077129,-6.42761503808188,34,34,0,3
53870,4to9,4,9,0.931567018178174,-7.29579471561974,33,33,0,2
53885,9to4,9,4,0.967479515077129,-6.42761503808188,31,31,0,3
53900,4to9,4,9,0.931567018178174,-7.29579471561974,30,30,0,2
53915,9to4,9,4,0.967479515077129,-6.42761503808188,30,30,0,3
53932,4to9,4,9,0.931567018178174,-7.29579471561974,32,32,0,2
53948,9to4,9,4,0.967479515077129,-6.42761503808188,33,33,0,3
53964,4to3,4,3,0.068432981821826,-9.90680795079812,160,160,0,2
53980,3to4,3,4,0.973602340620664,-3.25601090920318,32,32,0,3
53998,4to9,4,9,0.931567018178174,-7.29579471561974,66,66,0,2
54014,9to4,9,4,0.967479515077129,-6.42761503808188,34,34,0,3
54028,4to9,4,9,0.931567018178174,-7.29579471561974,30,30,0,2
54044,9to4,9,4,0.967479515077129,-6.42761503808188,30,30,0,3
54059,4to9,4,9,0.931567018178174,-7.29579471561974,31,31,0,2
54073,9to4,9,4,0.967479515077129,-6.42761503808188,29,29,0,3
54088,4to9,4,9,0.931567018178174,-7.29579471561974,29,29,0,2
54105,9to4,9,4,0.967479515077129,-6.42761503808188,32,32,0,3
54120,4to9,4,9,0.931567018178174,-7.29579471561974,32,32,0,2
54135,9to4,9,4,0.967479515077129,-6.42761503808188,30,30,0,3
54150,4to9,4,9,0.931567018178174,-7.29579471561974,30,30,0,2
54166,9to4,9,4,0.967479515077129,-6.42761503808188,31,31,0,3
54181,4to9,4,9,0.931567018178174,-7.29579471561974,31,31,0,2
54197,9to4,9,4,0.967479515077129,-6.42761503808188,31,31,0,3
54213,4to3,4,3,0.068432981821826,-9.90680795079812,249,249,0,2
54230,3to2,3,2,0.003067382369128,-9.01733498965792,3858,2633,1225,3
54246,2to1,2,1,0.004507778661642,-9.09368156309515,3891,2665,1226,3
54261,1to2,1,2,0.499051184043837,-6.55158320144331,31,31,0,3
54277,2to3,2,3,0.987399155558282,-3.70441168844569,64,64,0,3
54293,3to4,3,4,0.974718420548531,-3.25601090920318,96,96,0,3
54309,4to9,4,9,0.931567018178174,-7.29579471561974,128,128,0,2
54324,9to4,9,4,0.967479515077129,-6.42761503808188,31,31,0,3
54339,4to9,4,9,0.931567018178174,-7.29579471561974,30,30,0,2
54354,9to4,9,4,0.967479515077129,-6.42761503808188,30,30,0,3
54369,4to3,4,3,0.068432981821826,-9.90680795079812,92,92,0,2
54384,3to8,3,8,0.015717159871136,-7.39002910242886,692,448,244,3
54400,8to13,8,13,0.035889367026087,-5.79707809272931,723,481,242,4
54416,13to14,13,14,0.11687537365822,-8.34196169043466,851,851,0,4
54432,14to9,14,9,0.729991359600875,-5.13076416031772,93,93,0,3
54448,9to4,9,4,0.967479515077129,-6.42761503808188,94,94,0,3
54464,4to9,4,9,0.931567018178174,-7.29579471561974,32,32,0,2
54479,9to4,9,4,0.967479515077129,-6.42761503808188,31,31,0,3
54496,4to9,4,9,0.931567018178174,-7.29579471561974,32,32,0,2
54510,9to4,9,4,0.967479515077129,-6.42761503808188,31,31,0,3
54525,4to9,4,9,0.931567018178174,-7.29579471561974,29,29,0,2
54540,9to4,9,4,0.967479515077129,-6.42761503808188,30,30,0,3
54555,4to3,4,3,0.068432981821826,-9.90680795079812,186,186,0,2
54572,3to4,3,4,0.98119507610014,-3.25601090920318,32,32,0,3
54587,4to9,4,9,0.931567018178174,-7.29579471561974,62,62,0,2
54603,9to4,9,4,0.967479515077129,-6.42761503808188,31,31,0,3
54619,4to9,4,9,0.931567018178174,-7.29579471561974,32,32,0,2
54634,9to4,9,4,0.967479515077129,-6.42761503808188,31,31,0,3
54649,4to9,4,9,0.931567018178174,-7.29579471561974,30,30,0,2
54665,9to4,9,4,0.967479515077129,-6.42761503808188,31,31,0,3
54681,4to9,4,9,0.931567018178174,-7.29579471561974,32,32,0,2
54697,9to4,9,4,0.967479515077129,-6.42761503808188,32,32,0,3
54712,4to9,4,9,0.931567018178174,-7.29579471561974,31,31,0,2
54728,9to4,9,4,0.967479515077129,-6.42761503808188,31,31,0,3
54745,4to3,4,3,0.068432981821826,-9.90680795079812,190,190,0,2
54761,3to4,3,4,0.98119507610014,-3.25601090920318,33,33,0,3
54776,4to9,4,9,0.931567018178174,-7.29579471561974,64,64,0,2
54792,9to4,9,4,0.967479515077129,-6.42761503808188,31,31,0,3
54809,4to9,4,9,0.931567018178174,-7.29579471561974,33,33,0,2
54826,9to4,9,4,0.967479515077129,-6.42761503808188,34,34,0,3
54841,4to9,4,9,0.931567018178174,-7.29579471561974,32,32,0,2
54855,9to4,9,4,0.967479515077129,-6.42761503808188,29,29,0,3
54871,4to9,4,9,0.931567018178174,-7.29579471561974,30,30,0,2
54887,9to4,9,4,0.967479515077129,-6.42761503808188,32,32,0,3
54903,4to9,4,9,0.931567018178174,-7.29579471561974,32,32,0,2
54917,9to4,9,4,0.967479515077129,-6.42761503808188,30,30,0,3
54931,4to9,4,9,0.931567018178174,-7.29579471561974,28,28,0,2
54946,9to4,9,4,0.967479515077129,-6.42761503808188,29,29,0,3
54963,4to9,4,9,0.931567018178174,-7.29579471561974,32,32,0,2
54979,9to4,9,4,0.967479515077129,-6.42761503808188,33,33,0,3
54995,4to3,4,3,0.068432981821826,-9.90680795079812,250,250,0,2
55011,3to4,3,4,0.98119507610014,-3.25601090920318,32,32,0,3
55028,4to9,4,9,0.931567018178174,-7.29579471561974,65,65,0,2
55044,9to4,9,4,0.967479515077129,-6.42761503808188,33,33,0,3
55061,4to9,4,9,0.931567018178174,-7.29579471561974,33,33,0,2
55077,9to4,9,4,0.967479515077129,-6.42761503808188,33,33,0,3
55093,4to9,4,9,0.931567018178174,-7.29579471561974,32,32,0,2
55109,9to4,9,4,0.967479515077129,-6.42761503808188,32,32,0,3
55126,4to9,4,9,0.931567018178174,-7.29579471561974,33,33,0,2
55143,9to4,9,4,0.967479515077129,-6.42761503808188,34,34,0,3
55157,4to9,4,9,0.931567018178174,-7.29579471561974,31,31,0,2
55172,9to8,9,8,0.021397701706019,-10.2390257703694,788,788,0,3
55188,8to3,8,3,0.296827695589178,-3.68436734031584,193,193,0,4
55204,3to4,3,4,0.98119507610014,-3.25601090920318,61,61,0,3
55220,4to9,4,9,0.931567018178174,-7.29579471561974,63,63,0,2
55235,9to4,9,4,0.967479515077129,-6.42761503808188,31,31,0,3
55251,4to9,4,9,0.931567018178174,-7.29579471561974,31,31,0,2
55267,9to4,9,4,0.967479515077129,-6.42761503808188,32,32,0,3
55282,4to9,4,9,0.931567018178174,-7.29579471561974,31,31,0,2
55298,9to4,9,4,0.967479515077129,-6.42761503808188,31,31,0,3
55313,4to9,4,9,0.931567018178174,-7.29579471561974,31,31,0,2
55327,9to4,9,4,0.967479515077129,-6.42761503808188,29,29,0,3
55343,4to9,4,9,0.931567018178174,-7.29579471561974,30,30,0,2
55358,9to4,9,4,0.967479515077129,-6.42761503808188,31,31,0,3
55373,4to9,4,9,0.931567018178174,-7.29579471561974,30,30,0,2
55387,9to4,9,4,0.967479515077129,-6.42761503808188,29,29,0,3
55402,4to3,4,3,0.068432981821826,-9.90680795079812,214,214,0,2
55417,3to8,3,8,0.015717159871136,-7.39002910242886,245,245,0,3
55432,8to13,8,13,0.035889367026087,-5.79707809272931,1032,1032,0,4
55448,13to12,13,12,0.099370363351346,-8.50421596132777,1787,1787,0,4
55464,12to13,12,13,0.986842580741535,-4.67657090946632,32,32,0,4
55480,13to14,13,14,0.11687537365822,-8.34196169043466,1064,1064,0,4
55496,14to9,14,9,0.729991359600875,-5.13076416031772,123,123,0,3
55513,9to4,9,4,0.967479515077129,-6.42761503808188,126,126,0,3
55528,4to9,4,9,0.931567018178174,-7.29579471561974,32,32,0,2
55544,9to4,9,4,0.967479515077129,-6.42761503808188,31,31,0,3
55560,4to9,4,9,0.931567018178174,-7.29579471561974,32,32,0,2
55575,9to4,9,4,0.967479515077129,-6.42761503808188,31,31,0,3
55591,4to9,4,9,0.931567018178174,-7.29579471561974,31,31,0,2
55607,9to4,9,4,0.967479515077129,-6.42761503808188,32,32,0,3
55622,4to9,4,9,0.931567018178174,-7.29579471561974,31,31,0,2
55638,9to4,9,4,0.967479515077129,-6.42761503808188,31,31,0,3
55655,4to3,4,3,0.068432981821826,-9.90680795079812,253,253,0,2
55671,3to4,3,4,0.98119507610014,-3.25601090920318,33,33,0,3
55686,4to9,4,9,0.931567018178174,-7.29579471561974,64,64,0,2
55703,9to4,9,4,0.967479515077129,-6.42761503808188,32,32,0,3
55719,4to9,4,9,0.931567018178174,-7.29579471561974,33,33,0,2
55734,9to4,9,4,0.967479515077129,-6.42761503808188,31,31,0,3
55749,4to9,4,9,0.931567018178174,-7.29579471561974,30,30,0,2
55765,9to4,9,4,0.967479515077129,-6.42761503808188,31,31,0,3
55780,4to9,4,9,0.931567018178174,-7.29579471561974,31,31,0,2
55796,9to4,9,4,0.967479515077129,-6.42761503808188,31,31,0,3
55811,4to9,4,9,0.931567018178174,-7.29579471561974,31,31,0,2
55826,9to4,9,4,0.967479515077129,-6.42761503808188,30,30,0,3
55841,4to9,4,9,0.931567018178174,-7.29579471561974,30,30,0,2
55857,9to4,9,4,0.967479515077129,-6.42761503808188,31,31,0,3
55872,4to9,4,9,0.931567018178174,-7.29579471561974,31,31,0,2
55888,9to4,9,4,0.967479515077129,-6.42761503808188,31,31,0,3
55904,4to3,4,3,0.068432981821826,-9.90680795079812,249,249,0,2
55918,3to4,3,4,0.98119507610014,-3.25601090920318,30,30,0,3
55934,4to9,4,9,0.931567018178174,-7.29579471561974,62,62,0,2
55950,9to4,9,4,0.967479515077129,-6.42761503808188,32,32,0,3
55966,4to9,4,9,0.931567018178174,-7.29579471561974,32,32,0,2
55981,9to4,9,4,0.967479515077129,-6.42761503808188,31,31,0,3
55995,4to9,4,9,0.931567018178174,-7.29579471561974,29,29,0,2
56012,9to4,9,4,0.967479515077129,-6.42761503808188,31,31,0,3
56028,4to9,4,9,0.931567018178174,-7.29579471561974,33,33,0,2
56044,9to8,9,8,0.021397701706019,-10.2390257703694,627,627,0,3
56059,8to3,8,3,0.296827695589178,-3.68436734031584,155,155,0,4
56075,3to4,3,4,0.98119507610014,-3.25601090920318,63,63,0,3
56092,4to9,4,9,0.931567018178174,-7.29579471561974,64,64,0,2
56107,9to4,9,4,0.967479515077129,-6.42761503808188,32,32,0,3
56123,4to3,4,3,0.068432981821826,-9.90680795079812,64,64,0,2
56139,3to4,3,4,0.98119507610014,-3.25601090920318,32,32,0,3
56156,4to9,4,9,0.931567018178174,-7.29579471561974,64,64,0,2
56171,9to4,9,4,0.967479515077129,-6.42761503808188,32,32,0,3
56187,4to9,4,9,0.931567018178174,-7.29579471561974,31,31,0,2
56203,9to4,9,4,0.967479515077129,-6.42761503808188,32,32,0,3
56219,4to9,4,9,0.931567018178174,-7.29579471561974,32,32,0,2
56236,9to4,9,4,0.967479515077129,-6.42761503808188,33,33,0,3
56252,4to9,4,9,0.931567018178174,-7.29579471561974,33,33,0,2
56269,9to4,9,4,0.967479515077129,-6.42761503808188,33,33,0,3
56286,4to9,4,9,0.931567018178174,-7.29579471561974,34,34,0,2
56302,9to4,9,4,0.967479515077129,-6.42761503808188,33,33,0,3
56319,4to9,4,9,0.931567018178174,-7.29579471561974,33,33,0,2
56334,9to4,9,4,0.967479515077129,-6.42761503808188,32,32,0,3
56350,4to3,4,3,0.068432981821826,-9.90680795079812,227,227,0,2
56365,3to4,3,4,0.98119507610014,-3.25601090920318,31,31,0,3
56381,4to9,4,9,0.931567018178174,-7.29579471561974,62,62,0,2
56397,9to4,9,4,0.967479515077129,-6.42761503808188,32,32,0,3
56413,4to9,4,9,0.931567018178174,-7.29579471561974,32,32,0,2
56429,9to4,9,4,0.967479515077129,-6.42761503808188,32,32,0,3
56444,4to9,4,9,0.931567018178174,-7.29579471561974,31,31,0,2
56461,9to4,9,4,0.967479515077129,-6.42761503808188,32,32,0,3
56476,4to9,4,9,0.931567018178174,-7.29579471561974,32,32,0,2
56492,9to4,9,4,0.967479515077129,-6.42761503808188,31,31,0,3
56508,4to9,4,9,0.931567018178174,-7.29579471561974,32,32,0,2
56525,9to14,9,14,0.011122783216851,-10.8933137429243,1045,1045,0,3
56541,14to9,14,9,0.729991359600875,-5.13076416031772,33,33,0,3
56557,9to4,9,4,0.967479515077129,-6.42761503808188,65,65,0,3
56573,4to9,4,9,0.931567018178174,-7.29579471561974,32,32,0,2
56589,9to4,9,4,0.967479515077129,-6.42761503808188,32,32,0,3
56605,4to3,4,3,0.068432981821826,-9.90680795079812,255,255,0,2
56620,3to4,3,4,0.98119507610014,-3.25601090920318,31,31,0,3
56636,4to3,4,3,0.068432981821826,-9.90680795079812,31,31,0,2
56651,3to4,3,4,0.98119507610014,-3.25601090920318,31,31,0,3
56667,4to9,4,9,0.931567018178174,-7.29579471561974,94,94,0,2
56684,9to8,9,8,0.021397701706019,-10.2390257703694,640,640,0,3
56700,8to13,8,13,0.035889367026087,-5.79707809272931,1236,1236,0,4
56715,13to12,13,12,0.099370363351346,-8.50421596132777,1267,1267,0,4
56732,12to7,12,7,0.006499853016599,-9.70004813592522,3118,2779,339,4
56749,7to2,7,2,0.038881767848448,-4.92272997679187,2488,2488,0,4
56765,2to3,2,3,0.987399155558282,-3.70441168844569,129,129,0,3
56781,3to4,3,4,0.98119507610014,-3.25601090920318,130,130,0,3
56796,4to9,4,9,0.931567018178174,-7.29579471561974,129,129,0,2
56812,9to4,9,4,0.967479515077129,-6.42761503808188,31,31,0,3
56827,4to9,4,9,0.931567018178174,-7.29579471561974,31,31,0,2
56843,9to4,9,4,0.967479515077129,-6.42761503808188,31,31,0,3
56859,4to9,4,9,0.931567018178174,-7.29579471561974,32,32,0,2
56875,9to4,9,4,0.967479515077129,-6.42761503808188,32,32,0,3
56890,4to9,4,9,0.931567018178174,-7.29579471561974,31,31,0,2
56906,9to4,9,4,0.967479515077129,-6.42761503808188,31,31,0,3
56922,4to9,4,9,0.931567018178174,-7.29579471561974,32,32,0,2
56938,9to4,9,4,0.967479515077129,-6.42761503808188,32,32,0,3
56955,4to9,4,9,0.931567018178174,-7.29579471561974,33,33,0,2
56971,9to4,9,4,0.967479515077129,-6.42761503808188,33,33,0,3
56986,4to9,4,9,0.931567018178174,-7.29579471561974,31,31,0,2
57001,9to4,9,4,0.967479515077129,-6.42761503808188,30,30,0,3
57017,4to3,4,3,0.068432981821826,-9.90680795079812,252,252,0,2
57032,3to4,3,4,0.98119507610014,-3.25601090920318,31,31,0,3
57050,4to9,4,9,0.931567018178174,-7.29579471561974,64,64,0,2
57067,9to4,9,4,0.967479515077129,-6.42761503808188,35,35,0,3
57082,4to9,4,9,0.931567018178174,-7.29579471561974,32,32,0,2
57098,9to4,9,4,0.967479515077129,-6.42761503808188,31,31,0,3
57114,4to9,4,9,0.931567018178174,-7.29579471561974,32,32,0,2
57130,9to4,9,4,0.967479515077129,-6.42761503808188,32,32,0,3
57145,4to9,4,9,0.931567018178174,-7.29579471561974,31,31,0,2
57161,9to4,9,4,0.967479515077129,-6.42761503808188,31,31,0,3
57177,4to9,4,9,0.931567018178174,-7.29579471561974,32,32,0,2
57193,9to4,9,4,0.967479515077129,-6.42761503808188,32,32,0,3
57209,4to9,4,9,0.931567018178174,-7.29579471561974,32,32,0,2
57223,9to4,9,4,0.967479515077129,-6.42761503808188,30,30,0,3
57238,4to3,4,3,0.068432981821826,-9.90680795079812,221,221,0,2
57253,3to4,3,4,0.98119507610014,-3.25601090920318,30,30,0,3
57268,4to9,4,9,0.931567018178174,-7.29579471561974,59,59,0,2
57283,9to4,9,4,0.967479515077129,-6.42761503808188,30,30,0,3
57299,4to9,4,9,0.931567018178174,-7.29579471561974,31,31,0,2
57313,9to4,9,4,0.967479515077129,-6.42761503808188,30,30,0,3
57328,4to9,4,9,0.931567018178174,-7.29579471561974,29,29,0,2
57343,9to4,9,4,0.967479515077129,-6.42761503808188,30,30,0,3
57358,4to3,4,3,0.068432981821826,-9.90680795079812,120,120,0,2
57373,3to4,3,4,0.98119507610014,-3.25601090920318,30,30,0,3
57390,4to9,4,9,0.931567018178174,-7.29579471561974,62,62,0,2
57406,9to4,9,4,0.967479515077129,-6.42761503808188,33,33,0,3
57422,4to9,4,9,0.931567018178174,-7.29579471561974,32,32,0,2
57440,9to8,9,8,0.021397701706019,-10.2390257703694,756,756,0,3
57456,8to13,8,13,0.035889367026087,-5.79707809272931,756,756,0,4
57472,13to14,13,14,0.11687537365822,-8.34196169043466,947,947,0,4
57489,14to19,14,19,0.000576198255256,-12.2760732712986,13926,149,13777,3
57506,19to18,19,18,0.024697724929172,-7.4224589031276,6214,182,6032,3
57521,18to17,18,17,0.004302846471189,-9.18173578692739,6182,214,5968,4
57538,17to12,17,12,0.925821901928086,-5.20631123779532,823,823,0,4
57554,12to13,12,13,0.9875792930132,-4.67657090946632,98,98,0,4
57570,13to8,13,8,0.7799809148121,-6.44380042391941,130,130,0,4
57587,8to9,8,9,0.653942766793529,-2.89449932615566,165,165,0,4
57603,9to4,9,4,0.967479515077129,-6.42761503808188,197,197,0,3
57618,4to3,4,3,0.068432981821826,-9.90680795079812,260,260,0,2
57633,3to4,3,4,0.98119507610014,-3.25601090920318,30,30,0,3
57649,4to9,4,9,0.931567018178174,-7.29579471561974,62,62,0,2
57665,9to4,9,4,0.967479515077129,-6.42761503808188,32,32,0,3
57681,4to9,4,9,0.931567018178174,-7.29579471561974,32,32,0,2
57697,9to4,9,4,0.967479515077129,-6.42761503808188,32,32,0,3
57713,4to3,4,3,0.068432981821826,-9.90680795079812,95,95,0,2
57729,3to4,3,4,0.98119507610014,-3.25601090920318,32,32,0,3
57745,4to9,4,9,0.931567018178174,-7.29579471561974,64,64,0,2
57759,9to4,9,4,0.967479515077129,-6.42761503808188,30,30,0,3
57774,4to9,4,9,0.931567018178174,-7.29579471561974,29,29,0,2
57790,9to4,9,4,0.967479515077129,-6.42761503808188,31,31,0,3
57807,4to9,4,9,0.931567018178174,-7.29579471561974,33,33,0,2
57823,9to4,9,4,0.967479515077129,-6.42761503808188,33,33,0,3
57837,4to9,4,9,0.931567018178174,-7.29579471561974,30,30,0,2
57852,9to4,9,4,0.967479515077129,-6.42761503808188,29,29,0,3
57866,4to9,4,9,0.931567018178174,-7.29579471561974,29,29,0,2
57883,9to14,9,14,0.011122783216851,-10.8933137429243,411,411,0,3
57898,14to13,14,13,0.268721866973823,-6.1310928940087,344,344,0,3
57914,13to8,13,8,0.7799809148121,-6.44380042391941,344,344,0,4
57930,8to3,8,3,0.296827695589178,-3.68436734031584,217,217,0,4
57946,3to4,3,4,0.98119507610014,-3.25601090920318,94,94,0,3
57962,4to9,4,9,0.931567018178174,-7.29579471561974,96,96,0,2
57977,9to4,9,4,0.967479515077129,-6.42761503808188,31,31,0,3
57992,4to9,4,9,0.931567018178174,-7.29579471561974,30,30,0,2
58007,9to4,9,4,0.967479515077129,-6.42761503808188,30,30,0,3
58023,4to9,4,9,0.931567018178174,-7.29579471561974,31,31,0,2
58039,9to4,9,4,0.967479515077129,-6.42761503808188,32,32,0,3
58054,4to9,4,9,0.931567018178174,-7.29579471561974,31,31,0,2
58070,9to4,9,4,0.967479515077129,-6.42761503808188,31,31,0,3
58086,4to9,4,9,0.931567018178174,-7.29579471561974,32,32,0,2
58100,9to4,9,4,0.967479515077129,-6.42761503808188,30,30,0,3
58114,4to9,4,9,0.931567018178174,-7.29579471561974,28,28,0,2
58130,9to4,9,4,0.967479515077129,-6.42761503808188,30,30,0,3
58146,4to9,4,9,0.931567018178174,-7.29579471561974,32,32,0,2
58162,9to4,9,4,0.967479515077129,-6.42761503808188,32,32,0,3
58178,4to3,4,3,0.068432981821826,-9.90680795079812,248,248,0,2
58195,3to4,3,4,0.98119507610014,-3.25601090920318,33,33,0,3
58211,4to9,4,9,0.931567018178174,-7.29579471561974,65,65,0,2
58226,9to4,9,4,0.967479515077129,-6.42761503808188,31,31,0,3
58242,4to9,4,9,0.931567018178174,-7.29579471561974,31,31,0,2
58258,9to4,9,4,0.967479515077129,-6.42761503808188,32,32,0,3
58273,4to9,4,9,0.931567018178174,-7.29579471561974,31,31,0,2
58288,9to4,9,4,0.967479515077129,-6.42761503808188,30,30,0,3
58304,4to9,4,9,0.931567018178174,-7.29579471561974,31,31,0,2
58320,9to4,9,4,0.967479515077129,-6.42761503808188,32,32,0,3
58336,4to9,4,9,0.931567018178174,-7.29579471561974,32,32,0,2
58350,9to4,9,4,0.967479515077129,-6.42761503808188,30,30,0,3
58367,4to9,4,9,0.931567018178174,-7.29579471561974,31,31,0,2
58382,9to4,9,4,0.967479515077129,-6.42761503808188,32,32,0,3
58397,4to9,4,9,0.931567018178174,-7.29579471561974,30,30,0,2
58413,9to4,9,4,0.967479515077129,-6.42761503808188,31,31,0,3
58430,4to3,4,3,0.068432981821826,-9.90680795079812,252,252,0,2
58444,3to4,3,4,0.98119507610014,-3.25601090920318,31,31,0,3
58460,4to9,4,9,0.931567018178174,-7.29579471561974,63,63,0,2
58474,9to4,9,4,0.967479515077129,-6.42761503808188,30,30,0,3
58492,4to9,4,9,0.931567018178174,-7.29579471561974,32,32,0,2
58508,9to4,9,4,0.967479515077129,-6.42761503808188,34,34,0,3
58525,4to9,4,9,0.931567018178174,-7.29579471561974,33,33,0,2
58540,9to4,9,4,0.967479515077129,-6.42761503808188,32,32,0,3
58554,4to9,4,9,0.931567018178174,-7.29579471561974,29,29,0,2
58570,9to8,9,8,0.021397701706019,-10.2390257703694,656,656,0,3
58586,8to9,8,9,0.653942766793529,-2.89449932615566,32,32,0,4
58601,9to4,9,4,0.967479515077129,-6.42761503808188,61,61,0,3
58617,4to9,4,9,0.931567018178174,-7.29579471561974,31,31,0,2
58633,9to4,9,4,0.967479515077129,-6.42761503808188,32,32,0,3
58650,4to9,4,9,0.931567018178174,-7.29579471561974,33,33,0,2
58666,9to4,9,4,0.967479515077129,-6.42761503808188,33,33,0,3
58681,4to3,4,3,0.068432981821826,-9.90680795079812,251,251,0,2
58697,3to4,3,4,0.98119507610014,-3.25601090920318,31,31,0,3
58713,4to9,4,9,0.931567018178174,-7.29579471561974,63,63,0,2
58728,9to4,9,4,0.967479515077129,-6.42761503808188,31,31,0,3
58743,4to9,4,9,0.931567018178174,-7.29579471561974,30,30,0,2
58759,9to4,9,4,0.967479515077129,-6.42761503808188,31,31,0,3
58774,4to9,4,9,0.931567018178174,-7.29579471561974,31,31,0,2
58790,9to4,9,4,0.967479515077129,-6.42761503808188,31,31,0,3
58806,4to9,4,9,0.931567018178174,-7.29579471561974,32,32,0,2
58821,9to4,9,4,0.967479515077129,-6.42761503808188,31,31,0,3
58837,4to9,4,9,0.931567018178174,-7.29579471561974,31,31,0,2
58852,9to4,9,4,0.967479515077129,-6.42761503808188,31,31,0,3
58868,4to9,4,9,0.931567018178174,-7.29579471561974,31,31,0,2
58884,9to14,9,14,0.011122783216851,-10.8933137429243,1001,1001,0,3
58901,14to13,14,13,0.268721866973823,-6.1310928940087,1003,1003,0,3
58916,13to8,13,8,0.662836366913566,-7.03339579964195,346,142,204,4
58932,8to3,8,3,0.215391253386247,-4.11464622477799,251,143,108,4
58949,3to4,3,4,0.98119507610014,-3.25601090920318,97,97,0,3
58963,4to9,4,9,0.931567018178174,-7.29579471561974,95,95,0,2
58977,9to8,9,8,0.021397701706019,-10.2390257703694,61,61,0,3
58994,8to7,8,7,0.00613212609328,-7.68240688372304,2262,236,2026,4
59010,7to12,7,12,0.281549684831573,-3.24745378437111,1472,269,1203,4
59026,12to13,12,13,0.9875792930132,-4.67657090946632,125,125,0,4
59042,13to8,13,8,0.662836366913566,-7.03339579964195,65,65,0,4
59059,8to13,8,13,0.040401637444452,-5.79707809272931,33,33,0,4
59075,13to14,13,14,0.179103215374642,-8.34196169043466,191,191,0,4
59091,14to19,14,19,0.000213776102308,-13.2679584148691,1602,13,1589,3
59106,19to24,19,24,0.009907648954617,-8.35273032270012,25536,13,25523,3
59122,24to23,24,23,0.37434926158763,-5.40909976612189,7815,12,7803,2
59137,23to18,23,18,0.795095534722143,-4.41122138755967,1631,429,1202,3
59154,18to13,18,13,0.989068403244238,-3.74424906738557,95,95,0,4
59169,13to8,13,8,0.662836366913566,-7.03339579964195,127,127,0,4
59184,8to9,8,9,0.736161174261175,-2.89449932615566,221,221,0,4
59200,9to4,9,4,0.967479515077129,-6.42761503808188,251,251,0,3
59219,4to3,4,3,0.068432981821826,-9.90680795079812,287,287,0,2
59234,3to4,3,4,0.98119507610014,-3.25601090920318,34,34,0,3
59250,4to9,4,9,0.931567018178174,-7.29579471561974,66,66,0,2
59266,9to14,9,14,0.011122783216851,-10.8933137429243,191,191,0,3
59283,14to13,14,13,0.268819313880134,-6.1310928940087,129,129,0,3
59300,13to8,13,8,0.662836366913566,-7.03339579964195,131,131,0,4
59316,8to3,8,3,0.217305062201093,-4.11464622477799,97,97,0,4
59332,3to4,3,4,0.98119507610014,-3.25601090920318,98,98,0,3
59347,4to3,4,3,0.068432981821826,-9.90680795079812,31,31,0,2
59363,3to4,3,4,0.98119507610014,-3.25601090920318,31,31,0,3
59379,4to9,4,9,0.931567018178174,-7.29579471561974,129,129,0,2
59394,9to4,9,4,0.967479515077129,-6.42761503808188,31,31,0,3
59410,4to9,4,9,0.931567018178174,-7.29579471561974,31,31,0,2
59427,9to4,9,4,0.967479515077129,-6.42761503808188,33,33,0,3
59442,4to9,4,9,0.931567018178174,-7.29579471561974,32,32,0,2
59456,9to4,9,4,0.967479515077129,-6.42761503808188,29,29,0,3
59471,4to9,4,9,0.931567018178174,-7.29579471561974,29,29,0,2
59487,9to4,9,4,0.967479515077129,-6.42761503808188,31,31,0,3
59503,4to9,4,9,0.931567018178174,-7.29579471561974,32,32,0,2
59518,9to4,9,4,0.967479515077129,-6.42761503808188,31,31,0,3
59534,4to3,4,3,0.068432981821826,-9.90680795079812,187,187,0,2
59550,3to4,3,4,0.98119507610014,-3.25601090920318,32,32,0,3
59566,4to9,4,9,0.931567018178174,-7.29579471561974,63,63,0,2
59581,9to4,9,4,0.967479515077129,-6.42761503808188,31,31,0,3
59597,4to9,4,9,0.931567018178174,-7.29579471561974,31,31,0,2
59612,9to4,9,4,0.967479515077129,-6.42761503808188,31,31,0,3
59628,4to9,4,9,0.931567018178174,-7.29579471561974,31,31,0,2
59644,9to4,9,4,0.967479515077129,-6.42761503808188,32,32,0,3
59660,4to9,4,9,0.931567018178174,-7.29579471561974,32,32,0,2
59675,9to4,9,4,0.967479515077129,-6.42761503808188,31,31,0,3
59691,4to9,4,9,0.931567018178174,-7.29579471561974,31,31,0,2
59708,9to4,9,4,0.967479515077129,-6.42761503808188,33,33,0,3
59725,4to9,4,9,0.931567018178174,-7.29579471561974,34,34,0,2
59741,9to4,9,4,0.967479515077129,-6.42761503808188,33,33,0,3
59757,4to9,4,9,0.931567018178174,-7.29579471561974,32,32,0,2
59771,9to4,9,4,0.967479515077129,-6.42761503808188,30,30,0,3
59785,4to3,4,3,0.068432981821826,-9.90680795079812,251,251,0,2
59801,3to8,3,8,0.015717159871136,-7.39002910242886,501,501,0,3
59816,8to9,8,9,0.736161174261175,-2.89449932615566,59,59,0,4
59832,9to4,9,4,0.967479515077129,-6.42761503808188,61,61,0,3
59847,4to9,4,9,0.931567018178174,-7.29579471561974,31,31,0,2
59862,9to4,9,4,0.967479515077129,-6.42761503808188,30,30,0,3
59877,4to9,4,9,0.931567018178174,-7.29579471561974,30,30,0,2
59895,9to4,9,4,0.967479515077129,-6.42761503808188,33,33,0,3
59910,4to9,4,9,0.931567018178174,-7.29579471561974,33,33,0,2
59927,9to4,9,4,0.967479515077129,-6.42761503808188,32,32,0,3
59943,4to9,4,9,0.931567018178174,-7.29579471561974,33,33,0,2
59959,9to4,9,4,0.967479515077129,-6.42761503808188,32,32,0,3
59975,4to9,4,9,0.931567018178174,-7.29579471561974,32,32,0,2
59990,9to4,9,4,0.967479515077129,-6.42761503808188,31,31,0,3
60005,4to3,4,3,0.068432981821826,-9.90680795079812,220,220,0,2
60019,3to4,3,4,0.98119507610014,-3.25601090920318,29,29,0,3
60035,4to9,4,9,0.931567018178174,-7.29579471561974,60,60,0,2
60051,9to4,9,4,0.967479515077129,-6.42761503808188,32,32,0,3
60067,4to9,4,9,0.931567018178174,-7.29579471561974,32,32,0,2
60083,9to4,9,4,0.967479515077129,-6.42761503808188,32,32,0,3
60098,4to9,4,9,0.931567018178174,-7.29579471561974,31,31,0,2
60114,9to4,9,4,0.967479515077129,-6.42761503808188,31,31,0,3
60130,4to9,4,9,0.931567018178174,-7.29579471561974,32,32,0,2
60145,9to4,9,4,0.967479515077129,-6.42761503808188,31,31,0,3
60161,4to9,4,9,0.931567018178174,-7.29579471561974,31,31,0,2
60176,9to4,9,4,0.967479515077129,-6.42761503808188,31,31,0,3
60192,4to9,4,9,0.931567018178174,-7.29579471561974,31,31,0,2
60208,9to8,9,8,0.021397701706019,-10.2390257703694,407,407,0,3
60224,8to3,8,3,0.217305062201093,-4.11464622477799,219,219,0,4
60240,3to4,3,4,0.98119507610014,-3.25601090920318,64,64,0,3
60256,4to9,4,9,0.931567018178174,-7.29579471561974,64,64,0,2
60271,9to4,9,4,0.967479515077129,-6.42761503808188,31,31,0,3
60287,4to9,4,9,0.931567018178174,-7.29579471561974,31,31,0,2
60303,9to4,9,4,0.967479515077129,-6.42761503808188,32,32,0,3
60318,4to9,4,9,0.931567018178174,-7.29579471561974,31,31,0,2
60334,9to4,9,4,0.967479515077129,-6.42761503808188,31,31,0,3
60350,4to9,4,9,0.931567018178174,-7.29579471561974,32,32,0,2
60365,9to4,9,4,0.967479515077129,-6.42761503808188,31,31,0,3
60381,4to9,4,9,0.931567018178174,-7.29579471561974,31,31,0,2
60396,9to4,9,4,0.967479515077129,-6.42761503808188,31,31,0,3
60411,4to9,4,9,0.931567018178174,-7.29579471561974,30,30,0,2
60427,9to4,9,4,0.967479515077129,-6.42761503808188,31,31,0,3
60443,4to9,4,9,0.931567018178174,-7.29579471561974,32,32,0,2
60460,9to4,9,4,0.967479515077129,-6.42761503808188,33,33,0,3
60476,4to3,4,3,0.068432981821826,-9.90680795079812,252,252,0,2
60491,3to4,3,4,0.98119507610014,-3.25601090920318,31,31,0,3
60506,4to9,4,9,0.931567018178174,-7.29579471561974,63,63,0,2
60521,9to4,9,4,0.967479515077129,-6.42761503808188,30,30,0,3
60536,4to9,4,9,0.931567018178174,-7.29579471561974,30,30,0,2
60551,9to4,9,4,0.967479515077129,-6.42761503808188,30,30,0,3
60565,4to9,4,9,0.931567018178174,-7.29579471561974,29,29,0,2
60582,9to14,9,14,0.011122783216851,-10.8933137429243,1316,1316,0,3
60598,14to13,14,13,0.268819313880134,-6.1310928940087,1315,1315,0,3
60615,13to8,13,8,0.662836366913566,-7.03339579964195,407,407,0,4
60632,8to9,8,9,0.736161174261175,-2.89449932615566,67,67,0,4
60647,9to4,9,4,0.967479515077129,-6.42761503808188,96,96,0,3
60661,4to9,4,9,0.931567018178174,-7.29579471561974,29,29,0,2
60675,9to4,9,4,0.967479515077129,-6.42761503808188,28,28,0,3
60692,4to3,4,3,0.068432981821826,-9.90680795079812,216,216,0,2
60709,3to4,3,4,0.98119507610014,-3.25601090920318,34,34,0,3
60724,4to9,4,9,0.931567018178174,-7.29579471561974,63,63,0,2
60741,9to4,9,4,0.967479515077129,-6.42761503808188,32,32,0,3
60759,4to9,4,9,0.931567018178174,-7.29579471561974,35,35,0,2
60774,9to4,9,4,0.967479515077129,-6.42761503808188,33,33,0,3
60790,4to9,4,9,0.931567018178174,-7.29579471561974,31,31,0,2
60805,9to4,9,4,0.967479515077129,-6.42761503808188,31,31,0,3
60821,4to9,4,9,0.931567018178174,-7.29579471561974,31,31,0,2
60837,9to4,9,4,0.967479515077129,-6.42761503808188,32,32,0,3
60853,4to9,4,9,0.931567018178174,-7.29579471561974,32,32,0,2
60868,9to14,9,14,0.011122783216851,-10.8933137429243,286,286,0,3
60884,14to13,14,13,0.268819313880134,-6.1310928940087,286,286,0,3
60900,13to18,13,18,0.002236447439475,-12.7285955289206,1763,82,1681,4
60916,18to13,18,13,0.989068403244238,-3.74424906738557,32,32,0,4
60932,13to12,13,12,0.152821138780222,-8.50421596132777,1922,1922,0,4
60948,12to11,12,11,0.001506577084159,-11.163567103336,7303,2063,5240,4
60964,11to6,11,6,0.079907372651127,-7.49739169298338,7334,2095,5239,4
60980,6to5,6,5,0.065017605547497,-6.78666188302398,10657,2486,8171,4
60995,5to10,5,10,0.205459070216511,-7.52760268036939,10688,2580,8108,3
61011,10to15,10,15,0.040078686402874,-11.8324711904495,10722,629,10093,3
61027,15to16,15,16,0.186842826403028,-6.0988742077545,10753,16,10737,3
61044,16to21,16,21,0.05316861385979,-6.21954956077695,22827,628,22199,4
61060,21to22,21,22,0.196024414900947,-6.411122909082,9738,84,9654,3
61077,22to17,22,17,0.759335239755443,-4.98170361165412,3556,83,3473,3
61094,17to12,17,12,0.925821901928086,-5.20631123779532,162,162,0,4
61110,12to13,12,13,0.989140555034597,-4.67657090946632,194,194,0,4
61128,13to8,13,8,0.66520041530676,-7.03339579964195,513,513,0,4
61145,8to9,8,9,0.736161174261175,-2.89449932615566,292,292,0,4
61162,9to4,9,4,0.967479515077129,-6.42761503808188,325,325,0,3
61178,4to3,4,3,0.068432981821826,-9.90680795079812,486,486,0,2
61196,3to2,3,2,0.0019334370936,-9.48664013919694,4447,2360,2087,3
61212,2to3,2,3,0.987399155558282,-3.70441168844569,34,34,0,3
61228,3to4,3,4,0.982331204100264,-3.25601090920318,66,66,0,3
61245,4to9,4,9,0.931567018178174,-7.29579471561974,100,100,0,2
61260,9to8,9,8,0.021397701706019,-10.2390257703694,132,132,0,3
61277,8to7,8,7,0.00613212609328,-7.68240688372304,2283,2283,0,4
61292,7to12,7,12,0.281549684831573,-3.24745378437111,198,198,0,4
61307,12to13,12,13,0.989140555034597,-4.67657090946632,197,197,0,4
61323,13to14,13,14,0.179741998473544,-8.34196169043466,455,455,0,4
61339,14to9,14,9,0.730966910017558,-5.13076416031772,94,94,0,3
61354,9to4,9,4,0.967479515077129,-6.42761503808188,126,126,0,3
61370,4to9,4,9,0.931567018178174,-7.29579471561974,31,31,0,2
61386,9to4,9,4,0.967479515077129,-6.42761503808188,32,32,0,3
61403,4to9,4,9,0.931567018178174,-7.29579471561974,33,33,0,2
61419,9to4,9,4,0.967479515077129,-6.42761503808188,33,33,0,3
61435,4to9,4,9,0.931567018178174,-7.29579471561974,32,32,0,2
61452,9to8,9,8,0.021397701706019,-10.2390257703694,192,192,0,3
61469,8to3,8,3,0.217305062201093,-4.11464622477799,257,257,0,4
61485,3to4,3,4,0.982331204100264,-3.25601090920318,66,66,0,3
61503,4to9,4,9,0.931567018178174,-7.29579471561974,68,68,0,2
61517,9to4,9,4,0.967479515077129,-6.42761503808188,32,32,0,3
61532,4to3,4,3,0.068432981821826,-9.90680795079812,63,63,0,2
61547,3to4,3,4,0.982331204100264,-3.25601090920318,30,30,0,3
61564,4to9,4,9,0.931567018178174,-7.29579471561974,61,61,0,2
61581,9to4,9,4,0.967479515077129,-6.42761503808188,34,34,0,3
61598,4to9,4,9,0.931567018178174,-7.29579471561974,34,34,0,2
61613,9to4,9,4,0.967479515077129,-6.42761503808188,32,32,0,3
61629,4to9,4,9,0.931567018178174,-7.29579471561974,31,31,0,2
61645,9to4,9,4,0.967479515077129,-6.42761503808188,32,32,0,3
61661,4to9,4,9,0.931567018178174,-7.29579471561974,32,32,0,2
61677,9to4,9,4,0.967479515077129,-6.42761503808188,32,32,0,3
61693,4to9,4,9,0.931567018178174,-7.29579471561974,32,32,0,2
61709,9to4,9,4,0.967479515077129,-6.42761503808188,32,32,0,3
61723,4to9,4,9,0.931567018178174,-7.29579471561974,30,30,0,2
61738,9to4,9,4,0.967479515077129,-6.42761503808188,29,29,0,3
61754,4to3,4,3,0.068432981821826,-9.90680795079812,222,222,0,2
61768,3to4,3,4,0.982331204100264,-3.25601090920318,30,30,0,3
61785,4to9,4,9,0.931567018178174,-7.29579471561974,62,62,0,2
61803,9to4,9,4,0.967479515077129,-6.42761503808188,35,35,0,3
61818,4to9,4,9,0.931567018178174,-7.29579471561974,33,33,0,2
61833,9to4,9,4,0.967479515077129,-6.42761503808188,30,30,0,3
61849,4to9,4,9,0.931567018178174,-7.29579471561974,31,31,0,2
61865,9to4,9,4,0.967479515077129,-6.42761503808188,32,32,0,3
61879,4to9,4,9,0.931567018178174,-7.29579471561974,30,30,0,2
61894,9to4,9,4,0.967479515077129,-6.42761503808188,29,29,0,3
61910,4to9,4,9,0.931567018178174,-7.29579471561974,31,31,0,2
61926,9to4,9,4,0.967479515077129,-6.42761503808188,32,32,0,3
61942,4to3,4,3,0.068432981821826,-9.90680795079812,188,188,0,2
61956,3to4,3,4,0.982331204100264,-3.25601090920318,30,30,0,3
61972,4to9,4,9,0.931567018178174,-7.29579471561974,62,62,0,2
61986,9to4,9,4,0.967479515077129,-6.42761503808188,30,30,0,3
62002,4to3,4,3,0.028534831889967,-10.8234746174648,60,5,55,2
62024,3to4,3,4,0.963781210617831,-3.99285301446634,38,10,28,3
62039,4to9,4,9,0.934747267021994,-8.16146635741079,67,9,58,2
62055,9to4,9,4,0.967479515077129,-6.42761503808188,31,31,0,3
62070,4to9,4,9,0.934747267021994,-8.16146635741079,31,31,0,2
62085,9to4,9,4,0.967479515077129,-6.42761503808188,30,30,0,3
62101,4to9,4,9,0.934747267021994,-8.16146635741079,31,31,0,2
62117,9to4,9,4,0.967479515077129,-6.42761503808188,32,32,0,3
62134,4to9,4,9,0.934747267021994,-8.16146635741079,33,33,0,2
62149,9to4,9,4,0.967479515077129,-6.42761503808188,32,32,0,3
62163,4to9,4,9,0.934747267021994,-8.16146635741079,29,29,0,2
62178,9to8,9,8,0.009555625884737,-11.0572075885512,726,132,594,3
62195,8to3,8,3,0.217305062201093,-4.11464622477799,193,193,0,4
62212,3to4,3,4,0.963781210617831,-3.99285301446634,63,63,0,3
62228,4to9,4,9,0.934747267021994,-8.16146635741079,65,65,0,2
62244,9to4,9,4,0.979186993991755,-6.42761503808188,32,32,0,3
62259,4to9,4,9,0.934747267021994,-8.16146635741079,31,31,0,2
62276,9to4,9,4,0.979186993991755,-6.42761503808188,32,32,0,3
62291,4to9,4,9,0.934747267021994,-8.16146635741079,32,32,0,2
62308,9to8,9,8,0.009555625884737,-11.0572075885512,130,130,0,3
62325,8to13,8,13,0.01964143306229,-6.53971070569591,1018,262,756,4
62341,13to14,13,14,0.094512040539815,-9.08361198513014,1018,263,755,4
62356,14to9,14,9,0.730966910017558,-5.13076416031772,65,65,0,3
62373,9to4,9,4,0.979186993991755,-6.42761503808188,97,97,0,3
62389,4to9,4,9,0.934747267021994,-8.16146635741079,33,33,0,2
62405,9to4,9,4,0.979186993991755,-6.42761503808188,32,32,0,3
62421,4to9,4,9,0.934747267021994,-8.16146635741079,32,32,0,2
62436,9to4,9,4,0.979186993991755,-6.42761503808188,31,31,0,3
62451,4to3,4,3,0.065252732978006,-10.8234746174648,256,256,0,2
62466,3to4,3,4,0.963781210617831,-3.99285301446634,30,30,0,3
62481,4to9,4,9,0.934747267021994,-8.16146635741079,60,60,0,2
62498,9to4,9,4,0.979186993991755,-6.42761503808188,32,32,0,3
62513,4to9,4,9,0.934747267021994,-8.16146635741079,32,32,0,2
62530,9to4,9,4,0.979186993991755,-6.42761503808188,32,32,0,3
62546,4to9,4,9,0.934747267021994,-8.16146635741079,33,33,0,2
62562,9to4,9,4,0.979186993991755,-6.42761503808188,32,32,0,3
62577,4to9,4,9,0.934747267021994,-8.16146635741079,31,31,0,2
62594,9to4,9,4,0.979186993991755,-6.42761503808188,32,32,0,3
62609,4to9,4,9,0.934747267021994,-8.16146635741079,32,32,0,2
62624,9to4,9,4,0.979186993991755,-6.42761503808188,30,30,0,3
62641,4to9,4,9,0.934747267021994,-8.16146635741079,32,32,0,2
62657,9to4,9,4,0.979186993991755,-6.42761503808188,33,33,0,3
62673,4to9,4,9,0.934747267021994,-8.16146635741079,32,32,0,2
62689,9to4,9,4,0.979186993991755,-6.42761503808188,32,32,0,3
62706,4to3,4,3,0.065252732978006,-10.8234746174648,255,255,0,2
62723,3to4,3,4,0.963781210617831,-3.99285301446634,34,34,0,3
62739,4to9,4,9,0.934747267021994,-8.16146635741079,66,66,0,2
62754,9to4,9,4,0.979186993991755,-6.42761503808188,31,31,0,3
62770,4to9,4,9,0.934747267021994,-8.16146635741079,31,31,0,2
62786,9to4,9,4,0.979186993991755,-6.42761503808188,32,32,0,3
62802,4to9,4,9,0.934747267021994,-8.16146635741079,32,32,0,2
62817,9to4,9,4,0.979186993991755,-6.42761503808188,31,31,0,3
62832,4to9,4,9,0.934747267021994,-8.16146635741079,30,30,0,2
62848,9to4,9,4,0.979186993991755,-6.42761503808188,31,31,0,3
62863,4to9,4,9,0.934747267021994,-8.16146635741079,31,31,0,2
62879,9to4,9,4,0.979186993991755,-6.42761503808188,31,31,0,3
62895,4to9,4,9,0.934747267021994,-8.16146635741079,32,32,0,2
62911,9to4,9,4,0.979186993991755,-6.42761503808188,32,32,0,3
62928,4to9,4,9,0.934747267021994,-8.16146635741079,33,33,0,2
62943,9to4,9,4,0.979186993991755,-6.42761503808188,32,32,0,3
62960,4to3,4,3,0.065252732978006,-10.8234746174648,254,254,0,2
62975,3to8,3,8,0.032255488698062,-7.39002910242886,667,667,0,3
62993,8to9,8,9,0.752087479507439,-2.89449932615566,65,65,0,4
63009,9to4,9,4,0.979186993991755,-6.42761503808188,66,66,0,3
63025,4to9,4,9,0.934747267021994,-8.16146635741079,32,32,0,2
63043,9to4,9,4,0.979186993991755,-6.42761503808188,34,34,0,3
63060,4to9,4,9,0.934747267021994,-8.16146635741079,35,35,0,2
63076,9to4,9,4,0.979186993991755,-6.42761503808188,33,33,0,3
63091,4to9,4,9,0.934747267021994,-8.16146635741079,31,31,0,2
63108,9to4,9,4,0.979186993991755,-6.42761503808188,32,32,0,3
63123,4to9,4,9,0.934747267021994,-8.16146635741079,32,32,0,2
63138,9to4,9,4,0.979186993991755,-6.42761503808188,30,30,0,3
63153,4to9,4,9,0.934747267021994,-8.16146635741079,30,30,0,2
63170,9to4,9,4,0.979186993991755,-6.42761503808188,32,32,0,3
63185,4to9,4,9,0.934747267021994,-8.16146635741079,32,32,0,2
63201,9to4,9,4,0.979186993991755,-6.42761503808188,31,31,0,3
63217,4to3,4,3,0.065252732978006,-10.8234746174648,257,257,0,2
63234,3to4,3,4,0.963781210617831,-3.99285301446634,33,33,0,3
63251,4to9,4,9,0.934747267021994,-8.16146635741079,66,66,0,2
63268,9to4,9,4,0.979186993991755,-6.42761503808188,34,34,0,3
63284,4to3,4,3,0.065252732978006,-10.8234746174648,67,67,0,2
63300,3to4,3,4,0.963781210617831,-3.99285301446634,32,32,0,3
63317,4to9,4,9,0.934747267021994,-8.16146635741079,66,66,0,2
63332,9to14,9,14,0.0044124562443,-11.8368051657295,991,56,935,3
63350,14to13,14,13,0.268819313880134,-6.1310928940087,1025,1025,0,3
63366,13to12,13,12,0.168700214882356,-8.50421596132777,2074,2074,0,4
63382,12to13,12,13,0.989140555034597,-4.67657090946632,32,32,0,4
63398,13to12,13,12,0.168700214882356,-8.50421596132777,32,32,0,4
63414,12to13,12,13,0.989140555034597,-4.67657090946632,32,32,0,4
63431,13to8,13,8,0.734318916203536,-7.03339579964195,456,456,0,4
63448,8to9,8,9,0.752087479507439,-2.89449932615566,131,131,0,4
63464,9to4,9,4,0.985965765638335,-6.42761503808188,164,164,0,3
63480,4to9,4,9,0.934747267021994,-8.16146635741079,32,32,0,2
63495,9to4,9,4,0.985965765638335,-6.42761503808188,31,31,0,3
63512,4to9,4,9,0.934747267021994,-8.16146635741079,32,32,0,2
63527,9to4,9,4,0.985965765638335,-6.42761503808188,32,32,0,3
63543,4to3,4,3,0.065252732978006,-10.8234746174648,259,259,0,2
63558,3to4,3,4,0.963781210617831,-3.99285301446634,31,31,0,3
63575,4to9,4,9,0.934747267021994,-8.16146635741079,63,63,0,2
63592,9to4,9,4,0.985965765638335,-6.42761503808188,34,34,0,3
63609,4to9,4,9,0.934747267021994,-8.16146635741079,34,34,0,2
63625,9to4,9,4,0.985965765638335,-6.42761503808188,33,33,0,3
63642,4to9,4,9,0.934747267021994,-8.16146635741079,33,33,0,2
63658,9to4,9,4,0.985965765638335,-6.42761503808188,33,33,0,3
63674,4to9,4,9,0.934747267021994,-8.16146635741079,32,32,0,2
63689,9to4,9,4,0.985965765638335,-6.42761503808188,31,31,0,3
63705,4to9,4,9,0.934747267021994,-8.16146635741079,31,31,0,2
63723,9to14,9,14,0.0044124562443,-11.8368051657295,391,391,0,3
63739,14to13,14,13,0.268819313880134,-6.1310928940087,325,325,0,3
63757,13to8,13,8,0.734318916203536,-7.03339579964195,326,326,0,4
63775,8to3,8,3,0.222006297301744,-4.11464622477799,232,232,0,4
63791,3to4,3,4,0.963781210617831,-3.99285301446634,102,102,0,3
63807,4to9,4,9,0.934747267021994,-8.16146635741079,102,102,0,2
63822,9to4,9,4,0.985965765638335,-6.42761503808188,31,31,0,3
63838,4to9,4,9,0.934747267021994,-8.16146635741079,31,31,0,2
63853,9to4,9,4,0.985965765638335,-6.42761503808188,31,31,0,3
63869,4to9,4,9,0.934747267021994,-8.16146635741079,31,31,0,2
63884,9to4,9,4,0.985965765638335,-6.42761503808188,31,31,0,3
63900,4to9,4,9,0.934747267021994,-8.16146635741079,31,31,0,2
63916,9to4,9,4,0.985965765638335,-6.42761503808188,32,32,0,3
63933,4to9,4,9,0.934747267021994,-8.16146635741079,33,33,0,2
63948,9to4,9,4,0.985965765638335,-6.42761503808188,32,32,0,3
63965,4to9,4,9,0.934747267021994,-8.16146635741079,32,32,0,2
63980,9to4,9,4,0.985965765638335,-6.42761503808188,32,32,0,3
63995,4to9,4,9,0.934747267021994,-8.16146635741079,30,30,0,2
64011,9to4,9,4,0.985965765638335,-6.42761503808188,31,31,0,3
64026,4to3,4,3,0.065252732978006,-10.8234746174648,251,251,0,2
64041,3to4,3,4,0.963781210617831,-3.99285301446634,30,30,0,3
64058,4to9,4,9,0.934747267021994,-8.16146635741079,63,63,0,2
64073,9to4,9,4,0.985965765638335,-6.42761503808188,32,32,0,3
64089,4to9,4,9,0.934747267021994,-8.16146635741079,31,31,0,2
64105,9to4,9,4,0.985965765638335,-6.42761503808188,32,32,0,3
64121,4to9,4,9,0.934747267021994,-8.16146635741079,32,32,0,2
64135,9to4,9,4,0.985965765638335,-6.42761503808188,30,30,0,3
64151,4to3,4,3,0.065252732978006,-10.8234746174648,125,125,0,2
64168,3to4,3,4,0.963781210617831,-3.99285301446634,33,33,0,3
64184,4to9,4,9,0.934747267021994,-8.16146635741079,63,63,0,2
64200,9to4,9,4,0.985965765638335,-6.42761503808188,32,32,0,3
64216,4to9,4,9,0.934747267021994,-8.16146635741079,32,32,0,2
64232,9to4,9,4,0.985965765638335,-6.42761503808188,32,32,0,3
64249,4to9,4,9,0.934747267021994,-8.16146635741079,33,33,0,2
64265,9to4,9,4,0.985965765638335,-6.42761503808188,33,33,0,3
64281,4to9,4,9,0.934747267021994,-8.16146635741079,32,32,0,2
64298,9to14,9,14,0.0044124562443,-11.8368051657295,575,575,0,3
64315,14to13,14,13,0.268819313880134,-6.1310928940087,576,576,0,3
64332,13to8,13,8,0.734318916203536,-7.03339579964195,575,575,0,4
64348,8to3,8,3,0.222006297301744,-4.11464622477799,197,197,0,4
64365,3to4,3,4,0.963781210617831,-3.99285301446634,100,100,0,3
64380,4to9,4,9,0.934747267021994,-8.16146635741079,99,99,0,2
64396,9to4,9,4,0.985965765638335,-6.42761503808188,31,31,0,3
64411,4to9,4,9,0.934747267021994,-8.16146635741079,31,31,0,2
64427,9to4,9,4,0.985965765638335,-6.42761503808188,31,31,0,3
64444,4to9,4,9,0.934747267021994,-8.16146635741079,33,33,0,2
64460,9to4,9,4,0.985965765638335,-6.42761503808188,33,33,0,3
64475,4to9,4,9,0.934747267021994,-8.16146635741079,31,31,0,2
64491,9to4,9,4,0.985965765638335,-6.42761503808188,31,31,0,3
64508,4to9,4,9,0.934747267021994,-8.16146635741079,33,33,0,2
64523,9to4,9,4,0.985965765638335,-6.42761503808188,32,32,0,3
64540,4to3,4,3,0.065252732978006,-10.8234746174648,192,192,0,2
64555,3to4,3,4,0.963781210617831,-3.99285301446634,32,32,0,3
64572,4to9,4,9,0.934747267021994,-8.16146635741079,64,64,0,2
64586,9to4,9,4,0.985965765638335,-6.42761503808188,31,31,0,3
64600,4to9,4,9,0.934747267021994,-8.16146635741079,28,28,0,2
64616,9to4,9,4,0.985965765638335,-6.42761503808188,30,30,0,3
64631,4to9,4,9,0.934747267021994,-8.16146635741079,31,31,0,2
64645,9to4,9,4,0.985965765638335,-6.42761503808188,29,29,0,3
64662,4to9,4,9,0.934747267021994,-8.16146635741079,31,31,0,2
64678,9to4,9,4,0.985965765638335,-6.42761503808188,33,33,0,3
64692,4to9,4,9,0.934747267021994,-8.16146635741079,30,30,0,2
64707,9to4,9,4,0.985965765638335,-6.42761503808188,29,29,0,3
64724,4to9,4,9,0.934747267021994,-8.16146635741079,32,32,0,2
64740,9to14,9,14,0.0044124562443,-11.8368051657295,442,442,0,3
64756,14to13,14,13,0.268819313880134,-6.1310928940087,441,441,0,3
64773,13to8,13,8,0.734318916203536,-7.03339579964195,441,441,0,4
64789,8to3,8,3,0.222006297301744,-4.11464622477799,249,249,0,4
64804,3to4,3,4,0.963781210617831,-3.99285301446634,97,97,0,3
64819,4to9,4,9,0.934747267021994,-8.16146635741079,95,95,0,2
64834,9to4,9,4,0.985965765638335,-6.42761503808188,30,30,0,3
64849,4to9,4,9,0.934747267021994,-8.16146635741079,30,30,0,2
64867,9to4,9,4,0.985965765638335,-6.42761503808188,33,33,0,3
64881,4to9,4,9,0.934747267021994,-8.16146635741079,32,32,0,2
64897,9to4,9,4,0.985965765638335,-6.42761503808188,30,30,0,3
64914,4to9,4,9,0.934747267021994,-8.16146635741079,33,33,0,2
64931,9to4,9,4,0.985965765638335,-6.42761503808188,34,34,0,3
64947,4to9,4,9,0.934747267021994,-8.16146635741079,33,33,0,2
64963,9to4,9,4,0.985965765638335,-6.42761503808188,32,32,0,3
64978,4to9,4,9,0.934747267021994,-8.16146635741079,31,31,0,2
64993,9to4,9,4,0.985965765638335,-6.42761503808188,30,30,0,3
65008,4to9,4,9,0.934747267021994,-8.16146635741079,30,30,0,2
65023,9to4,9,4,0.985965765638335,-6.42761503808188,30,30,0,3
65037,4to3,4,3,0.065252732978006,-10.8234746174648,248,248,0,2
65052,3to2,3,2,0.003234809801239,-9.6904783134708,3856,3070,786,3
65069,2to1,2,1,0.002220766778795,-9.80392825994445,10823,3136,7687,3
65086,1to0,1,0,0.022924362133713,-9.66166911877164,19451,3170,16281,3
65100,0to5,0,5,0.495204555571389,-5.41588025403826,4120,3201,919,2
65116,5to6,5,6,0.566920583335497,-6.65409506288874,4152,3166,986,3
65132,6to7,6,7,0.554254760471745,-4.74667239278666,3855,3166,689,4
65148,7to12,7,12,0.281549684831573,-3.24745378437111,1750,1750,0,4
65164,12to13,12,13,0.989140555034597,-4.67657090946632,408,408,0,4
65181,13to8,13,8,0.734318916203536,-7.03339579964195,408,408,0,4
65198,8to9,8,9,0.752087479507439,-2.89449932615566,190,190,0,4
65213,9to4,9,4,0.985965765638335,-6.42761503808188,190,190,0,3
65229,4to3,4,3,0.065252732978006,-10.8234746174648,192,192,0,2
65246,3to4,3,4,0.96448611017173,-3.99285301446634,33,33,0,3
65261,4to9,4,9,0.934747267021994,-8.16146635741079,63,63,0,2
65276,9to4,9,4,0.985965765638335,-6.42761503808188,30,30,0,3
65291,4to9,4,9,0.934747267021994,-8.16146635741079,30,30,0,2
65305,9to4,9,4,0.985965765638335,-6.42761503808188,29,29,0,3
65321,4to9,4,9,0.934747267021994,-8.16146635741079,30,30,0,2
65337,9to4,9,4,0.985965765638335,-6.42761503808188,32,32,0,3
65354,4to9,4,9,0.934747267021994,-8.16146635741079,33,33,0,2
65370,9to4,9,4,0.985965765638335,-6.42761503808188,33,33,0,3
65385,4to9,4,9,0.934747267021994,-8.16146635741079,31,31,0,2
65400,9to4,9,4,0.985965765638335,-6.42761503808188,30,30,0,3
65416,4to9,4,9,0.934747267021994,-8.16146635741079,31,31,0,2
65433,9to4,9,4,0.985965765638335,-6.42761503808188,33,33,0,3
65448,4to9,4,9,0.934747267021994,-8.16146635741079,32,32,0,2
65465,9to4,9,4,0.985965765638335,-6.42761503808188,32,32,0,3
65481,4to9,4,9,0.934747267021994,-8.16146635741079,33,33,0,2
65495,9to4,9,4,0.985965765638335,-6.42761503808188,30,30,0,3
65512,4to3,4,3,0.065252732978006,-10.8234746174648,283,283,0,2
65527,3to4,3,4,0.96448611017173,-3.99285301446634,32,32,0,3
65543,4to9,4,9,0.934747267021994,-8.16146635741079,62,62,0,2
65559,9to4,9,4,0.985965765638335,-6.42761503808188,32,32,0,3
65575,4to3,4,3,0.065252732978006,-10.8234746174648,63,63,0,2
65590,3to4,3,4,0.96448611017173,-3.99285301446634,31,31,0,3
65608,4to9,4,9,0.934747267021994,-8.16146635741079,65,65,0,2
65623,9to4,9,4,0.985965765638335,-6.42761503808188,33,33,0,3
65639,4to9,4,9,0.934747267021994,-8.16146635741079,31,31,0,2
65654,9to4,9,4,0.985965765638335,-6.42761503808188,31,31,0,3
65669,4to9,4,9,0.934747267021994,-8.16146635741079,30,30,0,2
65686,9to4,9,4,0.985965765638335,-6.42761503808188,32,32,0,3
65702,4to9,4,9,0.934747267021994,-8.16146635741079,33,33,0,2
65718,9to4,9,4,0.985965765638335,-6.42761503808188,32,32,0,3
65735,4to9,4,9,0.934747267021994,-8.16146635741079,33,33,0,2
65751,9to8,9,8,0.009621778117365,-11.0572075885512,570,570,0,3
65768,8to3,8,3,0.222006297301744,-4.11464622477799,193,193,0,4
65786,3to4,3,4,0.96448611017173,-3.99285301446634,68,68,0,3
65803,4to9,4,9,0.934747267021994,-8.16146635741079,68,68,0,2
65818,9to4,9,4,0.985965765638335,-6.42761503808188,32,32,0,3
65834,4to9,4,9,0.934747267021994,-8.16146635741079,31,31,0,2
65849,9to4,9,4,0.985965765638335,-6.42761503808188,31,31,0,3
65866,4to9,4,9,0.934747267021994,-8.16146635741079,32,32,0,2
65882,9to4,9,4,0.985965765638335,-6.42761503808188,33,33,0,3
65897,4to9,4,9,0.934747267021994,-8.16146635741079,31,31,0,2
65914,9to4,9,4,0.985965765638335,-6.42761503808188,32,32,0,3
65930,4to9,4,9,0.934747267021994,-8.16146635741079,33,33,0,2
65946,9to4,9,4,0.985965765638335,-6.42761503808188,32,32,0,3
65961,4to9,4,9,0.934747267021994,-8.16146635741079,31,31,0,2
65976,9to4,9,4,0.985965765638335,-6.42761503808188,30,30,0,3
65993,4to9,4,9,0.934747267021994,-8.16146635741079,32,32,0,2
66008,9to4,9,4,0.985965765638335,-6.42761503808188,32,32,0,3
66024,4to3,4,3,0.065252732978006,-10.8234746174648,256,256,0,2
66039,3to4,3,4,0.96448611017173,-3.99285301446634,31,31,0,3
66055,4to9,4,9,0.934747267021994,-8.16146635741079,62,62,0,2
66071,9to4,9,4,0.985965765638335,-6.42761503808188,32,32,0,3
66086,4to9,4,9,0.934747267021994,-8.16146635741079,31,31,0,2
66102,9to4,9,4,0.985965765638335,-6.42761503808188,31,31,0,3
66117,4to9,4,9,0.934747267021994,-8.16146635741079,31,31,0,2
66132,9to4,9,4,0.985965765638335,-6.42761503808188,30,30,0,3
66148,4to9,4,9,0.934747267021994,-8.16146635741079,31,31,0,2
66164,9to14,9,14,0.0044124562443,-11.8368051657295,1424,1424,0,3
66181,14to13,14,13,0.268819313880134,-6.1310928940087,1017,1017,0,3
66196,13to8,13,8,0.734318916203536,-7.03339579964195,445,445,0,4
66211,8to3,8,3,0.222006297301744,-4.11464622477799,187,187,0,4
66227,3to8,3,8,0.032279080027032,-7.39002910242886,31,31,0,3
66243,8to9,8,9,0.752087479507439,-2.89449932615566,95,95,0,4
66259,9to8,9,8,0.009621778117365,-11.0572075885512,32,32,0,3
66275,8to9,8,9,0.752087479507439,-2.89449932615566,32,32,0,4
66291,9to4,9,4,0.985965765638335,-6.42761503808188,159,159,0,3
66306,4to9,4,9,0.934747267021994,-8.16146635741079,31,31,0,2
66322,9to4,9,4,0.985965765638335,-6.42761503808188,31,31,0,3
66340,4to9,4,9,0.934747267021994,-8.16146635741079,34,34,0,2
66357,9to8,9,8,0.009621778117365,-11.0572075885512,98,98,0,3
66372,8to3,8,3,0.222006297301744,-4.11464622477799,161,161,0,4
66388,3to4,3,4,0.96448611017173,-3.99285301446634,66,66,0,3
66403,4to9,4,9,0.934747267021994,-8.16146635741079,63,63,0,2
66418,9to4,9,4,0.985965765638335,-6.42761503808188,30,30,0,3
66434,4to9,4,9,0.934747267021994,-8.16146635741079,31,31,0,2
66451,9to14,9,14,0.0044124562443,-11.8368051657295,287,287,0,3
66466,14to13,14,13,0.268819313880134,-6.1310928940087,285,285,0,3
66483,13to12,13,12,0.168700214882356,-8.50421596132777,1335,1335,0,4
66498,12to13,12,13,0.989140555034597,-4.67657090946632,32,32,0,4
66513,13to8,13,8,0.734318916203536,-7.03339579964195,156,156,0,4
66528,8to13,8,13,0.01964143306229,-6.53971070569591,30,30,0,4
66544,13to18,13,18,0.000962494254066,-13.6720753304798,5644,319,5325,4
66560,18to17,18,17,0.001692308534412,-10.1175373554118,5483,352,5131,4
66576,17to16,17,16,0.012162879184016,-9.55624360929486,5549,547,5002,4
66593,16to11,16,11,0.697719085595443,-3.76178154554919,5645,4724,921,4
66610,11to10,11,10,0.086187242418036,-7.43584904975363,5615,4758,857,4
66626,10to5,10,5,0.401609493679219,-9.52783566457202,1526,1526,0,3
66641,5to6,5,6,0.566920583335497,-6.65409506288874,1525,1525,0,3
66657,6to7,6,7,0.554254760471745,-4.74667239278666,1525,1525,0,4
66673,7to8,7,8,0.659548900827281,-2.39620659892225,160,160,0,4
66688,8to9,8,9,0.752087479507439,-2.89449932615566,254,254,0,4
66704,9to4,9,4,0.985965765638335,-6.42761503808188,286,286,0,3
66719,4to3,4,3,0.065252732978006,-10.8234746174648,347,347,0,2
66735,3to4,3,4,0.96448611017173,-3.99285301446634,31,31,0,3
66752,4to9,4,9,0.934747267021994,-8.16146635741079,64,64,0,2
66767,9to4,9,4,0.985965765638335,-6.42761503808188,32,32,0,3
66783,4to9,4,9,0.934747267021994,-8.16146635741079,31,31,0,2
66797,9to4,9,4,0.985965765638335,-6.42761503808188,30,30,0,3
66813,4to9,4,9,0.934747267021994,-8.16146635741079,30,30,0,2
66829,9to4,9,4,0.985965765638335,-6.42761503808188,32,32,0,3
66844,4to3,4,3,0.065252732978006,-10.8234746174648,125,125,0,2
66859,3to4,3,4,0.96448611017173,-3.99285301446634,30,30,0,3
66875,4to9,4,9,0.934747267021994,-8.16146635741079,62,62,0,2
66890,9to4,9,4,0.985965765638335,-6.42761503808188,31,31,0,3
66905,4to9,4,9,0.934747267021994,-8.16146635741079,30,30,0,2
66921,9to4,9,4,0.985965765638335,-6.42761503808188,31,31,0,3
66936,4to9,4,9,0.934747267021994,-8.16146635741079,31,31,0,2
66950,9to4,9,4,0.985965765638335,-6.42761503808188,29,29,0,3
66965,4to9,4,9,0.934747267021994,-8.16146635741079,29,29,0,2
66982,9to4,9,4,0.985965765638335,-6.42761503808188,32,32,0,3
66997,4to9,4,9,0.934747267021994,-8.16146635741079,32,32,0,2
67013,9to4,9,4,0.985965765638335,-6.42761503808188,31,31,0,3
67028,4to9,4,9,0.934747267021994,-8.16146635741079,31,31,0,2
67043,9to4,9,4,0.985965765638335,-6.42761503808188,30,30,0,3
67060,4to9,4,9,0.934747267021994,-8.16146635741079,32,32,0,2
67076,9to4,9,4,0.985965765638335,-6.42761503808188,33,33,0,3
67092,4to3,4,3,0.065252732978006,-10.8234746174648,248,248,0,2
67107,3to4,3,4,0.96448611017173,-3.99285301446634,31,31,0,3
67123,4to9,4,9,0.934747267021994,-8.16146635741079,63,63,0,2
67137,9to4,9,4,0.985965765638335,-6.42761503808188,30,30,0,3
67151,4to9,4,9,0.934747267021994,-8.16146635741079,28,28,0,2
67168,9to4,9,4,0.985965765638335,-6.42761503808188,31,31,0,3
67183,4to9,4,9,0.934747267021994,-8.16146635741079,32,32,0,2
67199,9to4,9,4,0.985965765638335,-6.42761503808188,31,31,0,3
67214,4to9,4,9,0.934747267021994,-8.16146635741079,31,31,0,2
67229,9to4,9,4,0.985965765638335,-6.42761503808188,30,30,0,3
67245,4to9,4,9,0.934747267021994,-8.16146635741079,31,31,0,2
67261,9to4,9,4,0.985965765638335,-6.42761503808188,32,32,0,3
67278,4to9,4,9,0.934747267021994,-8.16146635741079,33,33,0,2
67293,9to4,9,4,0.985965765638335,-6.42761503808188,32,32,0,3
67309,4to9,4,9,0.934747267021994,-8.16146635741079,31,31,0,2
67324,9to4,9,4,0.985965765638335,-6.42761503808188,31,31,0,3
67340,4to3,4,3,0.065252732978006,-10.8234746174648,248,248,0,2
67357,3to8,3,8,0.032279080027032,-7.39002910242886,684,684,0,3
67373,8to9,8,9,0.752087479507439,-2.89449932615566,64,64,0,4
67391,9to4,9,4,0.985965765638335,-6.42761503808188,67,67,0,3
67408,4to9,4,9,0.934747267021994,-8.16146635741079,35,35,0,2
67424,9to8,9,8,0.009621778117365,-11.0572075885512,67,67,0,3
67439,8to3,8,3,0.222006297301744,-4.11464622477799,99,99,0,4
67456,3to4,3,4,0.96448611017173,-3.99285301446634,65,65,0,3
67472,4to9,4,9,0.934747267021994,-8.16146635741079,64,64,0,2
67489,9to8,9,8,0.009621778117365,-11.0572075885512,65,65,0,3
67505,8to13,8,13,0.01964143306229,-6.53971070569591,977,977,0,4
67521,13to12,13,12,0.122624206170417,-8.87897511354357,1038,649,389,4
67538,12to13,12,13,0.989140555034597,-4.67657090946632,33,33,0,4
67554,13to8,13,8,0.776427878567666,-7.03339579964195,65,65,0,4
67569,8to9,8,9,0.752087479507439,-2.89449932615566,97,97,0,4
67584,9to4,9,4,0.985965765638335,-6.42761503808188,128,128,0,3
67600,4to9,4,9,0.934747267021994,-8.16146635741079,31,31,0,2
67616,9to8,9,8,0.009621778117365,-11.0572075885512,62,62,0,3
67633,8to3,8,3,0.222006297301744,-4.11464622477799,194,194,0,4
67649,3to4,3,4,0.96448611017173,-3.99285301446634,65,65,0,3
67666,4to9,4,9,0.934747267021994,-8.16146635741079,66,66,0,2
67682,9to4,9,4,0.985965765638335,-6.42761503808188,33,33,0,3
67698,4to3,4,3,0.065252732978006,-10.8234746174648,65,65,0,2
67714,3to4,3,4,0.96448611017173,-3.99285301446634,32,32,0,3
67731,4to9,4,9,0.934747267021994,-8.16146635741079,65,65,0,2
67746,9to4,9,4,0.985965765638335,-6.42761503808188,32,32,0,3
67762,4to9,4,9,0.934747267021994,-8.16146635741079,31,31,0,2
67776,9to4,9,4,0.985965765638335,-6.42761503808188,30,30,0,3
67791,4to9,4,9,0.934747267021994,-8.16146635741079,29,29,0,2
67807,9to4,9,4,0.985965765638335,-6.42761503808188,31,31,0,3
67821,4to9,4,9,0.934747267021994,-8.16146635741079,30,30,0,2
67836,9to4,9,4,0.985965765638335,-6.42761503808188,29,29,0,3
67852,4to9,4,9,0.934747267021994,-8.16146635741079,31,31,0,2
67868,9to4,9,4,0.985965765638335,-6.42761503808188,32,32,0,3
67884,4to9,4,9,0.934747267021994,-8.16146635741079,32,32,0,2
67901,9to4,9,4,0.985965765638335,-6.42761503808188,33,33,0,3
67918,4to9,4,9,0.934747267021994,-8.16146635741079,34,34,0,2
67934,9to4,9,4,0.985965765638335,-6.42761503808188,33,33,0,3
67950,4to3,4,3,0.065252732978006,-10.8234746174648,252,252,0,2
67967,3to4,3,4,0.96448611017173,-3.99285301446634,33,33,0,3
67984,4to9,4,9,0.934747267021994,-8.16146635741079,66,66,0,2
67999,9to4,9,4,0.985965765638335,-6.42761503808188,32,32,0,3
68014,4to9,4,9,0.934747267021994,-8.16146635741079,30,30,0,2
68030,9to4,9,4,0.985965765638335,-6.42761503808188,31,31,0,3
68046,4to3,4,3,0.065252732978006,-10.8234746174648,96,96,0,2
68061,3to4,3,4,0.96448611017173,-3.99285301446634,31,31,0,3
68077,4to9,4,9,0.934747267021994,-8.16146635741079,63,63,0,2
68093,9to4,9,4,0.985965765638335,-6.42761503808188,32,32,0,3
68108,4to9,4,9,0.934747267021994,-8.16146635741079,31,31,0,2
68123,9to4,9,4,0.985965765638335,-6.42761503808188,30,30,0,3
68140,4to9,4,9,0.934747267021994,-8.16146635741079,32,32,0,2
68155,9to8,9,8,0.009621778117365,-11.0572075885512,539,539,0,3
68171,8to3,8,3,0.222006297301744,-4.11464622477799,125,125,0,4
68189,3to4,3,4,0.96448611017173,-3.99285301446634,66,66,0,3
68204,4to9,4,9,0.934747267021994,-8.16146635741079,64,64,0,2
68220,9to4,9,4,0.985965765638335,-6.42761503808188,31,31,0,3
68235,4to9,4,9,0.934747267021994,-8.16146635741079,31,31,0,2
68252,9to4,9,4,0.985965765638335,-6.42761503808188,32,32,0,3
68268,4to3,4,3,0.065252732978006,-10.8234746174648,97,97,0,2
68285,3to2,3,2,0.003234809801239,-9.6904783134708,3233,3233,0,3
68299,2to3,2,3,0.989667574691522,-3.70441168844569,31,31,0,3
68315,3to4,3,4,0.96448611017173,-3.99285301446634,63,63,0,3
68331,4to9,4,9,0.934747267021994,-8.16146635741079,96,96,0,2
68347,9to4,9,4,0.985965765638335,-6.42761503808188,32,32,0,3
68363,4to9,4,9,0.934747267021994,-8.16146635741079,32,32,0,2
68378,9to4,9,4,0.985965765638335,-6.42761503808188,31,31,0,3
68393,4to9,4,9,0.934747267021994,-8.16146635741079,30,30,0,2
68408,9to4,9,4,0.985965765638335,-6.42761503808188,30,30,0,3
68423,4to9,4,9,0.934747267021994,-8.16146635741079,30,30,0,2
68438,9to4,9,4,0.985965765638335,-6.42761503808188,30,30,0,3
68453,4to9,4,9,0.934747267021994,-8.16146635741079,30,30,0,2
68469,9to4,9,4,0.985965765638335,-6.42761503808188,31,31,0,3
68485,4to9,4,9,0.934747267021994,-8.16146635741079,32,32,0,2
68500,9to4,9,4,0.985965765638335,-6.42761503808188,31,31,0,3
68515,4to9,4,9,0.934747267021994,-8.16146635741079,30,30,0,2
68530,9to4,9,4,0.985965765638335,-6.42761503808188,30,30,0,3
68545,4to3,4,3,0.065252732978006,-10.8234746174648,246,246,0,2
68562,3to4,3,4,0.96448611017173,-3.99285301446634,32,32,0,3
68579,4to9,4,9,0.934747267021994,-8.16146635741079,64,64,0,2
68593,9to4,9,4,0.985965765638335,-6.42761503808188,31,31,0,3
68608,4to9,4,9,0.934747267021994,-8.16146635741079,29,29,0,2
68625,9to4,9,4,0.985965765638335,-6.42761503808188,32,32,0,3
68640,4to9,4,9,0.934747267021994,-8.16146635741079,32,32,0,2
68655,9to4,9,4,0.985965765638335,-6.42761503808188,30,30,0,3
68671,4to9,4,9,0.934747267021994,-8.16146635741079,31,31,0,2
68687,9to4,9,4,0.985965765638335,-6.42761503808188,32,32,0,3
68703,4to9,4,9,0.934747267021994,-8.16146635741079,32,32,0,2
68719,9to4,9,4,0.985965765638335,-6.42761503808188,32,32,0,3
68735,4to9,4,9,0.934747267021994,-8.16146635741079,32,32,0,2
68751,9to4,9,4,0.985965765638335,-6.42761503808188,32,32,0,3
68766,4to9,4,9,0.934747267021994,-8.16146635741079,31,31,0,2
68782,9to4,9,4,0.985965765638335,-6.42761503808188,31,31,0,3
68797,4to9,4,9,0.934747267021994,-8.16146635741079,31,31,0,2
68813,9to4,9,4,0.985965765638335,-6.42761503808188,31,31,0,3
68829,4to3,4,3,0.065252732978006,-10.8234746174648,284,284,0,2
68845,3to8,3,8,0.032279080027032,-7.39002910242886,690,690,0,3
68861,8to3,8,3,0.222006297301744,-4.11464622477799,32,32,0,4
68877,3to4,3,4,0.96448611017173,-3.99285301446634,64,64,0,3
68893,4to9,4,9,0.934747267021994,-8.16146635741079,96,96,0,2
68909,9to4,9,4,0.985965765638335,-6.42761503808188,32,32,0,3
68925,4to9,4,9,0.934747267021994,-8.16146635741079,32,32,0,2
68941,9to4,9,4,0.985965765638335,-6.42761503808188,32,32,0,3
68958,4to9,4,9,0.934747267021994,-8.16146635741079,33,33,0,2
68974,9to4,9,4,0.985965765638335,-6.42761503808188,33,33,0,3
68991,4to9,4,9,0.934747267021994,-8.16146635741079,33,33,0,2
69006,9to4,9,4,0.985965765638335,-6.42761503808188,32,32,0,3
69022,4to9,4,9,0.934747267021994,-8.16146635741079,31,31,0,2
69036,9to4,9,4,0.985965765638335,-6.42761503808188,30,30,0,3
69051,4to9,4,9,0.934747267021994,-8.16146635741079,29,29,0,2
69067,9to4,9,4,0.985965765638335,-6.42761503808188,31,31,0,3
69083,4to9,4,9,0.934747267021994,-8.16146635741079,32,32,0,2
69097,9to4,9,4,0.985965765638335,-6.42761503808188,30,30,0,3
69113,4to3,4,3,0.065252732978006,-10.8234746174648,252,252,0,2
69128,3to4,3,4,0.96448611017173,-3.99285301446634,31,31,0,3
69143,4to9,4,9,0.934747267021994,-8.16146635741079,60,60,0,2
69159,9to4,9,4,0.985965765638335,-6.42761503808188,31,31,0,3
69176,4to9,4,9,0.934747267021994,-8.16146635741079,33,33,0,2
69192,9to4,9,4,0.985965765638335,-6.42761503808188,33,33,0,3
69207,4to9,4,9,0.934747267021994,-8.16146635741079,31,31,0,2
69222,9to4,9,4,0.985965765638335,-6.42761503808188,30,30,0,3
69239,4to9,4,9,0.934747267021994,-8.16146635741079,32,32,0,2
69255,9to14,9,14,0.0044124562443,-11.8368051657295,2804,2804,0,3
69271,14to13,14,13,0.268819313880134,-6.1310928940087,1733,1733,0,3
69287,13to8,13,8,0.776427878567666,-7.03339579964195,442,442,0,4
69303,8to3,8,3,0.222006297301744,-4.11464622477799,190,190,0,4
69319,3to4,3,4,0.96448611017173,-3.99285301446634,97,97,0,3
69336,4to9,4,9,0.934747267021994,-8.16146635741079,97,97,0,2
69352,9to4,9,4,0.985965765638335,-6.42761503808188,33,33,0,3
69368,4to9,4,9,0.934747267021994,-8.16146635741079,32,32,0,2
69384,9to4,9,4,0.985965765638335,-6.42761503808188,32,32,0,3
69400,4to9,4,9,0.934747267021994,-8.16146635741079,32,32,0,2
69417,9to4,9,4,0.985965765638335,-6.42761503808188,33,33,0,3
69433,4to9,4,9,0.934747267021994,-8.16146635741079,33,33,0,2
69448,9to4,9,4,0.985965765638335,-6.42761503808188,31,31,0,3
69464,4to9,4,9,0.934747267021994,-8.16146635741079,31,31,0,2
69479,9to4,9,4,0.985965765638335,-6.42761503808188,31,31,0,3
69495,4to9,4,9,0.934747267021994,-8.16146635741079,31,31,0,2
69512,9to4,9,4,0.985965765638335,-6.42761503808188,33,33,0,3
69528,4to9,4,9,0.934747267021994,-8.16146635741079,33,33,0,2
69545,9to4,9,4,0.985965765638335,-6.42761503808188,33,33,0,3
69561,4to9,4,9,0.934747267021994,-8.16146635741079,33,33,0,2
69577,9to4,9,4,0.985965765638335,-6.42761503808188,32,32,0,3
69593,4to3,4,3,0.065252732978006,-10.8234746174648,290,290,0,2
69608,3to4,3,4,0.96448611017173,-3.99285301446634,31,31,0,3
69625,4to9,4,9,0.934747267021994,-8.16146635741079,64,64,0,2
69641,9to4,9,4,0.985965765638335,-6.42761503808188,33,33,0,3
69657,4to9,4,9,0.934747267021994,-8.16146635741079,32,32,0,2
69673,9to4,9,4,0.985965765638335,-6.42761503808188,32,32,0,3
69688,4to9,4,9,0.934747267021994,-8.16146635741079,31,31,0,2
69703,9to4,9,4,0.985965765638335,-6.42761503808188,30,30,0,3
69719,4to9,4,9,0.934747267021994,-8.16146635741079,31,31,0,2
69735,9to4,9,4,0.985965765638335,-6.42761503808188,32,32,0,3
69751,4to9,4,9,0.934747267021994,-8.16146635741079,32,32,0,2
69768,9to4,9,4,0.985965765638335,-6.42761503808188,33,33,0,3
69783,4to9,4,9,0.934747267021994,-8.16146635741079,32,32,0,2
69798,9to4,9,4,0.985965765638335,-6.42761503808188,30,30,0,3
69814,4to9,4,9,0.934747267021994,-8.16146635741079,31,31,0,2
69830,9to4,9,4,0.985965765638335,-6.42761503808188,32,32,0,3
69845,4to3,4,3,0.065252732978006,-10.8234746174648,252,252,0,2
69860,3to8,3,8,0.032279080027032,-7.39002910242886,573,573,0,3
69876,8to9,8,9,0.752087479507439,-2.89449932615566,62,62,0,4
69892,9to4,9,4,0.985965765638335,-6.42761503808188,62,62,0,3
69907,4to9,4,9,0.934747267021994,-8.16146635741079,31,31,0,2
69922,9to4,9,4,0.985965765638335,-6.42761503808188,30,30,0,3
69937,4to9,4,9,0.934747267021994,-8.16146635741079,30,30,0,2
69953,9to4,9,4,0.985965765638335,-6.42761503808188,31,31,0,3
69969,4to9,4,9,0.934747267021994,-8.16146635741079,32,32,0,2
69984,9to4,9,4,0.985965765638335,-6.42761503808188,31,31,0,3
70001,4to9,4,9,0.934747267021994,-8.16146635741079,32,32,0,2
70016,9to4,9,4,0.985965765638335,-6.42761503808188,32,32,0,3
70033,4to9,4,9,0.934747267021994,-8.16146635741079,32,32,0,2
70048,9to4,9,4,0.985965765638335,-6.42761503808188,32,32,0,3
70063,4to9,4,9,0.934747267021994,-8.16146635741079,30,30,0,2
70078,9to4,9,4,0.985965765638335,-6.42761503808188,30,30,0,3
70092,4to3,4,3,0.065252732978006,-10.8234746174648,247,247,0,2
70108,3to4,3,4,0.96448611017173,-3.99285301446634,30,30,0,3
70125,4to9,4,9,0.934747267021994,-8.16146635741079,62,62,0,2
70142,9to4,9,4,0.985965765638335,-6.42761503808188,34,34,0,3
70158,4to9,4,9,0.934747267021994,-8.16146635741079,33,33,0,2
70173,9to4,9,4,0.985965765638335,-6.42761503808188,31,31,0,3
70188,4to9,4,9,0.934747267021994,-8.16146635741079,30,30,0,2
70204,9to4,9,4,0.985965765638335,-6.42761503808188,31,31,0,3
70220,4to9,4,9,0.934747267021994,-8.16146635741079,32,32,0,2
70236,9to4,9,4,0.985965765638335,-6.42761503808188,32,32,0,3
70250,4to9,4,9,0.934747267021994,-8.16146635741079,30,30,0,2
70266,9to8,9,8,0.009621778117365,-11.0572075885512,406,406,0,3
70283,8to3,8,3,0.222006297301744,-4.11464622477799,191,191,0,4
70301,3to4,3,4,0.96448611017173,-3.99285301446634,65,65,0,3
70317,4to9,4,9,0.934747267021994,-8.16146635741079,67,67,0,2
70333,9to4,9,4,0.985965765638335,-6.42761503808188,32,32,0,3
70348,4to9,4,9,0.934747267021994,-8.16146635741079,31,31,0,2
70364,9to14,9,14,0.0044124562443,-11.8368051657295,1109,1109,0,3
70380,14to13,14,13,0.268819313880134,-6.1310928940087,1109,1109,0,3
70397,13to12,13,12,0.122624206170417,-8.87897511354357,2876,2876,0,4
70413,12to7,12,7,0.006510128620524,-9.70004813592522,3756,3756,0,4
70428,7to2,7,2,0.052721995472903,-4.92272997679187,2143,2143,0,4
70445,2to3,2,3,0.989667574691522,-3.70441168844569,162,162,0,3
70462,3to4,3,4,0.96448611017173,-3.99285301446634,129,129,0,3
70480,4to9,4,9,0.934747267021994,-8.16146635741079,132,132,0,2
70494,9to4,9,4,0.985965765638335,-6.42761503808188,32,32,0,3
70510,4to9,4,9,0.934747267021994,-8.16146635741079,30,30,0,2
70526,9to4,9,4,0.985965765638335,-6.42761503808188,32,32,0,3
70541,4to9,4,9,0.934747267021994,-8.16146635741079,31,31,0,2
70557,9to4,9,4,0.985965765638335,-6.42761503808188,31,31,0,3
70572,4to9,4,9,0.934747267021994,-8.16146635741079,31,31,0,2
70587,9to4,9,4,0.985965765638335,-6.42761503808188,30,30,0,3
70603,4to9,4,9,0.934747267021994,-8.16146635741079,31,31,0,2
70618,9to4,9,4,0.985965765638335,-6.42761503808188,31,31,0,3
70633,4to9,4,9,0.934747267021994,-8.16146635741079,30,30,0,2
70648,9to4,9,4,0.985965765638335,-6.42761503808188,30,30,0,3
70664,4to9,4,9,0.934747267021994,-8.16146635741079,31,31,0,2
70681,9to4,9,4,0.985965765638335,-6.42761503808188,33,33,0,3
70698,4to9,4,9,0.934747267021994,-8.16146635741079,34,34,0,2
70714,9to14,9,14,0.0044124562443,-11.8368051657295,350,350,0,3
70729,14to13,14,13,0.268819313880134,-6.1310928940087,349,349,0,3
70746,13to8,13,8,0.776427878567666,-7.03339579964195,480,480,0,4
70762,8to3,8,3,0.222006297301744,-4.11464622477799,317,317,0,4
70779,3to4,3,4,0.96448611017173,-3.99285301446634,98,98,0,3
70796,4to9,4,9,0.934747267021994,-8.16146635741079,98,98,0,2
70813,9to4,9,4,0.985965765638335,-6.42761503808188,34,34,0,3
70829,4to9,4,9,0.934747267021994,-8.16146635741079,33,33,0,2
70845,9to4,9,4,0.985965765638335,-6.42761503808188,32,32,0,3
70862,4to9,4,9,0.934747267021994,-8.16146635741079,33,33,0,2
70878,9to8,9,8,0.009621778117365,-11.0572075885512,132,132,0,3
70895,8to7,8,7,0.006264790128527,-7.68240688372304,482,482,0,4
70911,7to2,7,2,0.052721995472903,-4.92272997679187,483,483,0,4
70927,2to3,2,3,0.989667574691522,-3.70441168844569,165,165,0,3
70944,3to4,3,4,0.96448611017173,-3.99285301446634,99,99,0,3
70960,4to9,4,9,0.934747267021994,-8.16146635741079,98,98,0,2
70975,9to4,9,4,0.985965765638335,-6.42761503808188,31,31,0,3
70993,4to9,4,9,0.934747267021994,-8.16146635741079,33,33,0,2
71008,9to4,9,4,0.985965765638335,-6.42761503808188,33,33,0,3
71025,4to9,4,9,0.934747267021994,-8.16146635741079,32,32,0,2
71041,9to4,9,4,0.985965765638335,-6.42761503808188,33,33,0,3
71055,4to9,4,9,0.934747267021994,-8.16146635741079,30,30,0,2
71070,9to4,9,4,0.985965765638335,-6.42761503808188,29,29,0,3
71086,4to9,4,9,0.934747267021994,-8.16146635741079,31,31,0,2
71102,9to4,9,4,0.985965765638335,-6.42761503808188,32,32,0,3
71117,4to9,4,9,0.934747267021994,-8.16146635741079,31,31,0,2
71134,9to4,9,4,0.985965765638335,-6.42761503808188,32,32,0,3
71149,4to9,4,9,0.934747267021994,-8.16146635741079,32,32,0,2
71165,9to4,9,4,0.985965765638335,-6.42761503808188,31,31,0,3
71181,4to3,4,3,0.065252732978006,-10.8234746174648,254,254,0,2
71196,3to8,3,8,0.032279080027032,-7.39002910242886,318,318,0,3
71211,8to9,8,9,0.752087479507439,-2.89449932615566,62,62,0,4
71227,9to4,9,4,0.985965765638335,-6.42761503808188,62,62,0,3
71244,4to9,4,9,0.934747267021994,-8.16146635741079,33,33,0,2
71259,9to4,9,4,0.985965765638335,-6.42761503808188,32,32,0,3
71274,4to9,4,9,0.934747267021994,-8.16146635741079,30,30,0,2
71289,9to4,9,4,0.985965765638335,-6.42761503808188,30,30,0,3
71303,4to9,4,9,0.934747267021994,-8.16146635741079,29,29,0,2
71319,9to4,9,4,0.985965765638335,-6.42761503808188,30,30,0,3
71336,4to9,4,9,0.934747267021994,-8.16146635741079,33,33,0,2
71351,9to4,9,4,0.985965765638335,-6.42761503808188,32,32,0,3
71367,4to9,4,9,0.934747267021994,-8.16146635741079,31,31,0,2
71382,9to4,9,4,0.985965765638335,-6.42761503808188,31,31,0,3
71398,4to9,4,9,0.934747267021994,-8.16146635741079,31,31,0,2
71414,9to4,9,4,0.985965765638335,-6.42761503808188,32,32,0,3
71430,4to3,4,3,0.065252732978006,-10.8234746174648,249,249,0,2
71446,3to4,3,4,0.96448611017173,-3.99285301446634,32,32,0,3
71462,4to9,4,9,0.934747267021994,-8.16146635741079,64,64,0,2
71477,9to4,9,4,0.985965765638335,-6.42761503808188,31,31,0,3
71492,4to9,4,9,0.934747267021994,-8.16146635741079,30,30,0,2
71509,9to4,9,4,0.985965765638335,-6.42761503808188,32,32,0,3
71525,4to9,4,9,0.934747267021994,-8.16146635741079,33,33,0,2
71541,9to14,9,14,0.0044124562443,-11.8368051657295,827,827,0,3
71557,14to13,14,13,0.268819313880134,-6.1310928940087,828,828,0,3
71574,13to8,13,8,0.776427878567666,-7.03339579964195,378,378,0,4
71590,8to9,8,9,0.752087479507439,-2.89449932615566,65,65,0,4
71607,9to4,9,4,0.985965765638335,-6.42761503808188,98,98,0,3
71622,4to9,4,9,0.934747267021994,-8.16146635741079,32,32,0,2
71638,9to4,9,4,0.985965765638335,-6.42761503808188,31,31,0,3
71655,4to9,4,9,0.934747267021994,-8.16146635741079,33,33,0,2
71670,9to4,9,4,0.985965765638335,-6.42761503808188,32,32,0,3
71685,4to3,4,3,0.065252732978006,-10.8234746174648,255,255,0,2
71701,3to4,3,4,0.96448611017173,-3.99285301446634,31,31,0,3
71718,4to9,4,9,0.934747267021994,-8.16146635741079,63,63,0,2
71733,9to4,9,4,0.985965765638335,-6.42761503808188,32,32,0,3
71748,4to9,4,9,0.934747267021994,-8.16146635741079,30,30,0,2
71763,9to4,9,4,0.985965765638335,-6.42761503808188,30,30,0,3
71779,4to9,4,9,0.934747267021994,-8.16146635741079,31,31,0,2
71796,9to8,9,8,0.009621778117365,-11.0572075885512,222,222,0,3
71812,8to3,8,3,0.222006297301744,-4.11464622477799,127,127,0,4
71829,3to4,3,4,0.96448611017173,-3.99285301446634,66,66,0,3
71844,4to9,4,9,0.934747267021994,-8.16146635741079,65,65,0,2
71860,9to4,9,4,0.985965765638335,-6.42761503808188,31,31,0,3
71876,4to9,4,9,0.934747267021994,-8.16146635741079,32,32,0,2
71892,9to4,9,4,0.985965765638335,-6.42761503808188,32,32,0,3
71909,4to9,4,9,0.934747267021994,-8.16146635741079,33,33,0,2
71925,9to4,9,4,0.985965765638335,-6.42761503808188,33,33,0,3
71941,4to9,4,9,0.934747267021994,-8.16146635741079,32,32,0,2
71957,9to4,9,4,0.985965765638335,-6.42761503808188,32,32,0,3
71972,4to9,4,9,0.934747267021994,-8.16146635741079,31,31,0,2
71989,9to8,9,8,0.009621778117365,-11.0572075885512,193,193,0,3
72005,8to3,8,3,0.222006297301744,-4.11464622477799,193,193,0,4
72021,3to4,3,4,0.96448611017173,-3.99285301446634,64,64,0,3
72036,4to9,4,9,0.934747267021994,-8.16146635741079,64,64,0,2
72053,9to4,9,4,0.985965765638335,-6.42761503808188,32,32,0,3
72069,4to9,4,9,0.934747267021994,-8.16146635741079,33,33,0,2
72085,9to14,9,14,0.001754992946941,-12.7614375186707,544,41,503,3
72101,14to13,14,13,0.127276877221594,-7.05572524694988,544,41,503,3
72118,13to18,13,18,0.00038137776705,-14.6526996577134,5574,108,5466,4
72134,18to19,18,19,0.001879646382501,-10.015730618506,13043,106,12937,4
72149,19to24,19,24,0.003716298203383,-9.33954317250461,13043,172,12871,3
72166,24to23,24,23,0.182363347788297,-6.39591362690079,13044,172,12872,2
72183,23to22,23,22,0.066779063192005,-6.99345235118695,11123,239,10884,3
72200,22to17,22,17,0.588618751193625,-5.77248375349809,5640,1180,4460,3
72215,17to12,17,12,0.94229745560439,-5.20631123779532,1818,1818,0,4
72232,12to13,12,13,0.989140555034597,-4.67657090946632,131,131,0,4
72249,13to14,13,14,0.099995260720473,-9.08361198513014,164,164,0,4
72266,14to19,14,19,0.000255159020367,-13.2679584148691,132,132,0,3
72280,19to14,19,14,0.971008788472262,-3.77393571952463,31,31,0,3
72296,14to9,14,9,0.872467963758039,-5.13076416031772,227,227,0,3
72313,9to4,9,4,0.988597546089054,-6.42761503808188,260,260,0,3
72328,4to3,4,3,0.065252732978006,-10.8234746174648,323,323,0,2
72344,3to4,3,4,0.96448611017173,-3.99285301446634,31,31,0,3
72361,4to9,4,9,0.934747267021994,-8.16146635741079,65,65,0,2
72377,9to4,9,4,0.988597546089054,-6.42761503808188,33,33,0,3
72392,4to9,4,9,0.934747267021994,-8.16146635741079,31,31,0,2
72408,9to4,9,4,0.988597546089054,-6.42761503808188,31,31,0,3
72423,4to9,4,9,0.934747267021994,-8.16146635741079,31,31,0,2
72439,9to4,9,4,0.988597546089054,-6.42761503808188,31,31,0,3
72454,4to9,4,9,0.934747267021994,-8.16146635741079,31,31,0,2
72470,9to4,9,4,0.988597546089054,-6.42761503808188,31,31,0,3
72487,4to9,4,9,0.934747267021994,-8.16146635741079,33,33,0,2
72503,9to4,9,4,0.988597546089054,-6.42761503808188,33,33,0,3
72518,4to9,4,9,0.934747267021994,-8.16146635741079,31,31,0,2
72535,9to4,9,4,0.988597546089054,-6.42761503808188,32,32,0,3
72551,4to9,4,9,0.934747267021994,-8.16146635741079,33,33,0,2
72567,9to4,9,4,0.988597546089054,-6.42761503808188,32,32,0,3
72584,4to3,4,3,0.065252732978006,-10.8234746174648,256,256,0,2
72599,3to8,3,8,0.028064426898572,-7.53429139751082,610,522,88,3
72613,8to9,8,9,0.752087479507439,-2.89449932615566,62,62,0,4
72630,9to4,9,4,0.988597546089054,-6.42761503808188,63,63,0,3
72646,4to9,4,9,0.934747267021994,-8.16146635741079,33,33,0,2
72661,9to4,9,4,0.988597546089054,-6.42761503808188,31,31,0,3
72676,4to9,4,9,0.934747267021994,-8.16146635741079,30,30,0,2
72690,9to4,9,4,0.988597546089054,-6.42761503808188,29,29,0,3
72706,4to9,4,9,0.934747267021994,-8.16146635741079,30,30,0,2
72724,9to14,9,14,0.001754992946941,-12.7614375186707,444,444,0,3
72741,14to13,14,13,0.127276877221594,-7.05572524694988,509,509,0,3
72757,13to8,13,8,0.776921237319119,-7.03339579964195,158,158,0,4
72774,8to3,8,3,0.222006297301744,-4.11464622477799,190,190,0,4
72790,3to4,3,4,0.968686674939622,-3.99285301446634,100,100,0,3
72805,4to9,4,9,0.934747267021994,-8.16146635741079,99,99,0,2
72821,9to4,9,4,0.988597546089054,-6.42761503808188,31,31,0,3
72836,4to9,4,9,0.934747267021994,-8.16146635741079,31,31,0,2
72851,9to4,9,4,0.988597546089054,-6.42761503808188,30,30,0,3
72868,4to9,4,9,0.934747267021994,-8.16146635741079,32,32,0,2
72883,9to4,9,4,0.988597546089054,-6.42761503808188,32,32,0,3
72898,4to9,4,9,0.934747267021994,-8.16146635741079,30,30,0,2
72914,9to4,9,4,0.988597546089054,-6.42761503808188,31,31,0,3
72930,4to9,4,9,0.934747267021994,-8.16146635741079,32,32,0,2
72945,9to14,9,14,0.001754992946941,-12.7614375186707,221,221,0,3
72961,14to13,14,13,0.127276877221594,-7.05572524694988,220,220,0,3
72978,13to8,13,8,0.776921237319119,-7.03339579964195,221,221,0,4
72994,8to3,8,3,0.222006297301744,-4.11464622477799,220,220,0,4
73010,3to4,3,4,0.968686674939622,-3.99285301446634,96,96,0,3
73026,4to9,4,9,0.934747267021994,-8.16146635741079,96,96,0,2
73042,9to4,9,4,0.988597546089054,-6.42761503808188,32,32,0,3
73058,4to9,4,9,0.934747267021994,-8.16146635741079,32,32,0,2
73073,9to4,9,4,0.988597546089054,-6.42761503808188,31,31,0,3
73089,4to9,4,9,0.934747267021994,-8.16146635741079,31,31,0,2
73105,9to4,9,4,0.988597546089054,-6.42761503808188,32,32,0,3
73122,4to9,4,9,0.934747267021994,-8.16146635741079,33,33,0,2
73138,9to4,9,4,0.988597546089054,-6.42761503808188,33,33,0,3
73153,4to9,4,9,0.934747267021994,-8.16146635741079,31,31,0,2
73169,9to4,9,4,0.988597546089054,-6.42761503808188,31,31,0,3
73185,4to9,4,9,0.934747267021994,-8.16146635741079,32,32,0,2
73201,9to4,9,4,0.988597546089054,-6.42761503808188,32,32,0,3
73217,4to9,4,9,0.934747267021994,-8.16146635741079,32,32,0,2
73233,9to4,9,4,0.988597546089054,-6.42761503808188,32,32,0,3
73249,4to3,4,3,0.065252732978006,-10.8234746174648,255,255,0,2
73264,3to4,3,4,0.968686674939622,-3.99285301446634,31,31,0,3
73281,4to9,4,9,0.934747267021994,-8.16146635741079,64,64,0,2
73297,9to4,9,4,0.988597546089054,-6.42761503808188,33,33,0,3
73312,4to9,4,9,0.934747267021994,-8.16146635741079,31,31,0,2
73328,9to4,9,4,0.988597546089054,-6.42761503808188,31,31,0,3
73344,4to9,4,9,0.934747267021994,-8.16146635741079,32,32,0,2
73358,9to4,9,4,0.988597546089054,-6.42761503808188,30,30,0,3
73374,4to9,4,9,0.934747267021994,-8.16146635741079,30,30,0,2
73390,9to4,9,4,0.988597546089054,-6.42761503808188,32,32,0,3
73404,4to9,4,9,0.896785583682752,-8.66146635741079,30,15,15,2
73420,9to4,9,4,0.980077698389452,-6.99428170474855,30,13,17,3
73436,4to3,4,3,0.043418119169771,-11.7539559008873,187,13,174,2
73452,3to4,3,4,0.968686674939622,-3.99285301446634,32,32,0,3
73467,4to9,4,9,0.956581880830229,-8.66146635741079,63,63,0,2
73484,9to4,9,4,0.980077698389452,-6.99428170474855,32,32,0,3
73499,4to9,4,9,0.956581880830229,-8.66146635741079,32,32,0,2
73516,9to14,9,14,0.001451405549631,-13.5109996902994,571,143,428,3
73531,14to13,14,13,0.127276877221594,-7.05572524694988,570,570,0,3
73548,13to8,13,8,0.776921237319119,-7.03339579964195,570,570,0,4
73563,8to3,8,3,0.222006297301744,-4.11464622477799,127,127,0,4
73580,3to4,3,4,0.968686674939622,-3.99285301446634,96,96,0,3
73598,4to9,4,9,0.956581880830229,-8.66146635741079,99,99,0,2
73614,9to8,9,8,0.016883292665076,-11.0572075885512,66,66,0,3
73629,8to7,8,7,0.002324005135065,-8.67801771035069,2734,12,2722,4
73646,7to12,7,12,0.12950516298513,-4.21600724349061,1431,45,1386,4
73661,12to13,12,13,0.97331007661179,-5.59195552485093,130,11,119,4
73675,13to8,13,8,0.71835949141909,-7.34487120947802,61,42,19,4
73692,8to9,8,9,0.755069979295685,-2.89449932615566,94,94,0,4
73708,9to4,9,4,0.981665301785293,-6.99428170474855,128,128,0,3
73723,4to9,4,9,0.956581880830229,-8.66146635741079,31,31,0,2
73737,9to4,9,4,0.981665301785293,-6.99428170474855,29,29,0,3
73752,4to9,4,9,0.956581880830229,-8.66146635741079,29,29,0,2
73769,9to4,9,4,0.981665301785293,-6.99428170474855,32,32,0,3
73785,4to3,4,3,0.043418119169771,-11.7539559008873,222,222,0,2
73802,3to4,3,4,0.968686674939622,-3.99285301446634,33,33,0,3
73818,4to9,4,9,0.956581880830229,-8.66146635741079,66,66,0,2
73834,9to4,9,4,0.981665301785293,-6.99428170474855,32,32,0,3
73849,4to9,4,9,0.956581880830229,-8.66146635741079,31,31,0,2
73864,9to4,9,4,0.981665301785293,-6.99428170474855,30,30,0,3
73879,4to9,4,9,0.956581880830229,-8.66146635741079,30,30,0,2
73894,9to4,9,4,0.981665301785293,-6.99428170474855,30,30,0,3
73910,4to9,4,9,0.956581880830229,-8.66146635741079,31,31,0,2
73924,9to4,9,4,0.981665301785293,-6.99428170474855,30,30,0,3
73940,4to9,4,9,0.956581880830229,-8.66146635741079,30,30,0,2
73954,9to4,9,4,0.981665301785293,-6.99428170474855,30,30,0,3
73970,4to9,4,9,0.956581880830229,-8.66146635741079,30,30,0,2
73987,9to4,9,4,0.981665301785293,-6.99428170474855,33,33,0,3
74002,4to9,4,9,0.956581880830229,-8.66146635741079,32,32,0,2
74019,9to4,9,4,0.981665301785293,-6.99428170474855,32,32,0,3
74035,4to9,4,9,0.956581880830229,-8.66146635741079,33,33,0,2
74051,9to4,9,4,0.981665301785293,-6.99428170474855,32,32,0,3
74066,4to9,4,9,0.956581880830229,-8.66146635741079,31,31,0,2
74082,9to4,9,4,0.981665301785293,-6.99428170474855,31,31,0,3
74098,4to9,4,9,0.956581880830229,-8.66146635741079,32,32,0,2
74113,9to4,9,4,0.981665301785293,-6.99428170474855,31,31,0,3
74128,4to9,4,9,0.956581880830229,-8.66146635741079,30,30,0,2
74143,9to14,9,14,0.001451405549631,-13.5109996902994,627,627,0,3
74159,14to13,14,13,0.127276877221594,-7.05572524694988,498,498,0,3
74176,13to8,13,8,0.71835949141909,-7.34487120947802,501,501,0,4
74192,8to3,8,3,0.222886691873829,-4.11464622477799,407,407,0,4
74208,3to4,3,4,0.968686674939622,-3.99285301446634,95,95,0,3
74223,4to9,4,9,0.956581880830229,-8.66146635741079,95,95,0,2
74240,9to4,9,4,0.981665301785293,-6.99428170474855,32,32,0,3
74256,4to9,4,9,0.956581880830229,-8.66146635741079,33,33,0,2
74272,9to4,9,4,0.981665301785293,-6.99428170474855,32,32,0,3
74288,4to9,4,9,0.956581880830229,-8.66146635741079,32,32,0,2
74304,9to4,9,4,0.981665301785293,-6.99428170474855,32,32,0,3
74319,4to9,4,9,0.956581880830229,-8.66146635741079,31,31,0,2
74334,9to4,9,4,0.981665301785293,-6.99428170474855,30,30,0,3
74350,4to9,4,9,0.956581880830229,-8.66146635741079,31,31,0,2
74366,9to4,9,4,0.981665301785293,-6.99428170474855,32,32,0,3
74382,4to9,4,9,0.956581880830229,-8.66146635741079,32,32,0,2
74397,9to4,9,4,0.981665301785293,-6.99428170474855,31,31,0,3
74413,4to9,4,9,0.956581880830229,-8.66146635741079,31,31,0,2
74431,9to14,9,14,0.001451405549631,-13.5109996902994,288,288,0,3
74447,14to13,14,13,0.127276877221594,-7.05572524694988,288,288,0,3
74462,13to14,13,14,0.126245617227499,-9.08361198513014,31,31,0,4
74478,14to9,14,9,0.872467963758039,-5.13076416031772,65,65,0,3
74493,9to8,9,8,0.016883292665076,-11.0572075885512,317,317,0,3
74508,8to9,8,9,0.755069979295685,-2.89449932615566,30,30,0,4
74523,9to4,9,4,0.981665301785293,-6.99428170474855,126,126,0,3
74538,4to9,4,9,0.956581880830229,-8.66146635741079,30,30,0,2
74553,9to4,9,4,0.981665301785293,-6.99428170474855,30,30,0,3
74569,4to3,4,3,0.043418119169771,-11.7539559008873,377,377,0,2
74584,3to4,3,4,0.968686674939622,-3.99285301446634,31,31,0,3
74601,4to9,4,9,0.956581880830229,-8.66146635741079,63,63,0,2
74617,9to8,9,8,0.016883292665076,-11.0572075885512,124,124,0,3
74633,8to9,8,9,0.755069979295685,-2.89449932615566,32,32,0,4
74649,9to4,9,4,0.981665301785293,-6.99428170474855,65,65,0,3
74666,4to9,4,9,0.956581880830229,-8.66146635741079,33,33,0,2
74681,9to4,9,4,0.981665301785293,-6.99428170474855,32,32,0,3
74697,4to9,4,9,0.956581880830229,-8.66146635741079,31,31,0,2
74712,9to4,9,4,0.981665301785293,-6.99428170474855,31,31,0,3
74729,4to9,4,9,0.956581880830229,-8.66146635741079,32,32,0,2
74745,9to4,9,4,0.981665301785293,-6.99428170474855,33,33,0,3
74761,4to9,4,9,0.956581880830229,-8.66146635741079,32,32,0,2
74777,9to4,9,4,0.981665301785293,-6.99428170474855,32,32,0,3
74794,4to9,4,9,0.956581880830229,-8.66146635741079,33,33,0,2
74810,9to4,9,4,0.981665301785293,-6.99428170474855,33,33,0,3
74825,4to9,4,9,0.956581880830229,-8.66146635741079,31,31,0,2
74841,9to4,9,4,0.981665301785293,-6.99428170474855,31,31,0,3
74857,4to9,4,9,0.956581880830229,-8.66146635741079,32,32,0,2
74873,9to4,9,4,0.981665301785293,-6.99428170474855,32,32,0,3
74889,4to9,4,9,0.956581880830229,-8.66146635741079,32,32,0,2
74905,9to4,9,4,0.981665301785293,-6.99428170474855,32,32,0,3
74921,4to9,4,9,0.956581880830229,-8.66146635741079,32,32,0,2
74935,9to4,9,4,0.981665301785293,-6.99428170474855,30,30,0,3
74951,4to3,4,3,0.043418119169771,-11.7539559008873,382,382,0,2
74966,3to4,3,4,0.968686674939622,-3.99285301446634,31,31,0,3
74981,4to9,4,9,0.956581880830229,-8.66146635741079,60,60,0,2
74997,9to4,9,4,0.981665301785293,-6.99428170474855,31,31,0,3
75014,4to9,4,9,0.956581880830229,-8.66146635741079,33,33,0,2
75030,9to4,9,4,0.981665301785293,-6.99428170474855,33,33,0,3
75047,4to9,4,9,0.956581880830229,-8.66146635741079,33,33,0,2
75063,9to4,9,4,0.981665301785293,-6.99428170474855,33,33,0,3
75079,4to9,4,9,0.956581880830229,-8.66146635741079,32,32,0,2
75095,9to4,9,4,0.981665301785293,-6.99428170474855,32,32,0,3
75112,4to9,4,9,0.956581880830229,-8.66146635741079,33,33,0,2
75128,9to4,9,4,0.981665301785293,-6.99428170474855,33,33,0,3
75143,4to9,4,9,0.956581880830229,-8.66146635741079,31,31,0,2
75159,9to4,9,4,0.981665301785293,-6.99428170474855,31,31,0,3
75173,4to3,4,3,0.043418119169771,-11.7539559008873,222,222,0,2
75189,3to8,3,8,0.028064426898572,-7.53429139751082,572,572,0,3
75205,8to9,8,9,0.755069979295685,-2.89449932615566,62,62,0,4
75222,9to4,9,4,0.981665301785293,-6.99428170474855,63,63,0,3
75237,4to9,4,9,0.956581880830229,-8.66146635741079,32,32,0,2
75252,9to4,9,4,0.981665301785293,-6.99428170474855,30,30,0,3
75267,4to9,4,9,0.956581880830229,-8.66146635741079,30,30,0,2
75282,9to4,9,4,0.981665301785293,-6.99428170474855,30,30,0,3
75298,4to9,4,9,0.956581880830229,-8.66146635741079,31,31,0,2
75314,9to4,9,4,0.981665301785293,-6.99428170474855,32,32,0,3
75328,4to9,4,9,0.956581880830229,-8.66146635741079,30,30,0,2
75344,9to4,9,4,0.981665301785293,-6.99428170474855,30,30,0,3
75359,4to9,4,9,0.956581880830229,-8.66146635741079,31,31,0,2
75374,9to4,9,4,0.981665301785293,-6.99428170474855,30,30,0,3
75389,4to9,4,9,0.956581880830229,-8.66146635741079,30,30,0,2
75404,9to4,9,4,0.981665301785293,-6.99428170474855,30,30,0,3
75419,4to9,4,9,0.956581880830229,-8.66146635741079,30,30,0,2
75434,9to4,9,4,0.981665301785293,-6.99428170474855,30,30,0,3
75449,4to9,4,9,0.956581880830229,-8.66146635741079,30,30,0,2
75465,9to4,9,4,0.981665301785293,-6.99428170474855,31,31,0,3
75482,4to9,4,9,0.956581880830229,-8.66146635741079,33,33,0,2
75498,9to4,9,4,0.981665301785293,-6.99428170474855,33,33,0,3
75513,4to9,4,9,0.956581880830229,-8.66146635741079,31,31,0,2
75529,9to4,9,4,0.981665301785293,-6.99428170474855,31,31,0,3
75545,4to3,4,3,0.043418119169771,-11.7539559008873,372,372,0,2
75560,3to4,3,4,0.968686674939622,-3.99285301446634,31,31,0,3
75576,4to9,4,9,0.956581880830229,-8.66146635741079,63,63,0,2
75593,9to4,9,4,0.981665301785293,-6.99428170474855,33,33,0,3
75609,4to9,4,9,0.956581880830229,-8.66146635741079,33,33,0,2
75625,9to4,9,4,0.981665301785293,-6.99428170474855,32,32,0,3
75643,4to3,4,3,0.043418119169771,-11.7539559008873,98,98,0,2
75658,3to4,3,4,0.968686674939622,-3.99285301446634,33,33,0,3
75673,4to9,4,9,0.956581880830229,-8.66146635741079,64,64,0,2
75689,9to4,9,4,0.981665301785293,-6.99428170474855,31,31,0,3
75705,4to9,4,9,0.956581880830229,-8.66146635741079,32,32,0,2
75721,9to4,9,4,0.981665301785293,-6.99428170474855,32,32,0,3
75737,4to9,4,9,0.956581880830229,-8.66146635741079,32,32,0,2
75751,9to4,9,4,0.981665301785293,-6.99428170474855,30,30,0,3
75766,4to9,4,9,0.956581880830229,-8.66146635741079,29,29,0,2
75781,9to4,9,4,0.981665301785293,-6.99428170474855,30,30,0,3
75796,4to9,4,9,0.956581880830229,-8.66146635741079,30,30,0,2
75810,9to4,9,4,0.981665301785293,-6.99428170474855,29,29,0,3
75827,4to9,4,9,0.956581880830229,-8.66146635741079,31,31,0,2
75842,9to4,9,4,0.981665301785293,-6.99428170474855,32,32,0,3
75859,4to9,4,9,0.956581880830229,-8.66146635741079,32,32,0,2
75874,9to4,9,4,0.981665301785293,-6.99428170474855,32,32,0,3
75890,4to9,4,9,0.956581880830229,-8.66146635741079,31,31,0,2
75906,9to8,9,8,0.016883292665076,-11.0572075885512,717,717,0,3
75923,8to3,8,3,0.222886691873829,-4.11464622477799,280,280,0,4
75940,3to2,3,2,0.001967799533757,-10.193162743775,5029,2501,2528,3
75955,2to1,2,1,0.001029209112606,-10.5741836338192,10886,2501,8385,3
75970,1to6,1,6,0.293176122201938,-7.38795991284642,9329,2501,6828,3
75986,6to11,6,11,0.154439270145739,-6.17916276006838,9393,2500,6893,4
76003,11to12,11,12,0.80888028927346,-5.19672028427417,2357,2357,0,4
76020,12to13,12,13,0.97331007661179,-5.59195552485093,1573,1573,0,4
76037,13to14,13,14,0.126245617227499,-9.08361198513014,1575,1575,0,4
76053,14to9,14,9,0.872467963758039,-5.13076416031772,163,163,0,3
76070,9to4,9,4,0.981665301785293,-6.99428170474855,196,196,0,3
76085,4to9,4,9,0.956581880830229,-8.66146635741079,32,32,0,2
76101,9to4,9,4,0.981665301785293,-6.99428170474855,31,31,0,3
76116,4to9,4,9,0.956581880830229,-8.66146635741079,31,31,0,2
76131,9to4,9,4,0.981665301785293,-6.99428170474855,30,30,0,3
76146,4to9,4,9,0.956581880830229,-8.66146635741079,30,30,0,2
76162,9to4,9,4,0.981665301785293,-6.99428170474855,31,31,0,3
76178,4to9,4,9,0.956581880830229,-8.66146635741079,32,32,0,2
76194,9to4,9,4,0.981665301785293,-6.99428170474855,32,32,0,3
76210,4to9,4,9,0.956581880830229,-8.66146635741079,32,32,0,2
76224,9to4,9,4,0.981665301785293,-6.99428170474855,30,30,0,3
76239,4to9,4,9,0.956581880830229,-8.66146635741079,29,29,0,2
76255,9to4,9,4,0.981665301785293,-6.99428170474855,31,31,0,3
76269,4to9,4,9,0.956581880830229,-8.66146635741079,30,30,0,2
76285,9to4,9,4,0.981665301785293,-6.99428170474855,30,30,0,3
76301,4to3,4,3,0.043418119169771,-11.7539559008873,378,378,0,2
76318,3to4,3,4,0.969931703079532,-3.99285301446634,33,33,0,3
76335,4to9,4,9,0.956581880830229,-8.66146635741079,66,66,0,2
76351,9to4,9,4,0.981665301785293,-6.99428170474855,33,33,0,3
76367,4to9,4,9,0.956581880830229,-8.66146635741079,32,32,0,2
76382,9to4,9,4,0.981665301785293,-6.99428170474855,31,31,0,3
76399,4to9,4,9,0.956581880830229,-8.66146635741079,32,32,0,2
76413,9to4,9,4,0.981665301785293,-6.99428170474855,31,31,0,3
76429,4to9,4,9,0.956581880830229,-8.66146635741079,30,30,0,2
76444,9to4,9,4,0.981665301785293,-6.99428170474855,31,31,0,3
76459,4to9,4,9,0.956581880830229,-8.66146635741079,30,30,0,2
76474,9to4,9,4,0.981665301785293,-6.99428170474855,30,30,0,3
76490,4to9,4,9,0.956581880830229,-8.66146635741079,31,31,0,2
76505,9to4,9,4,0.981665301785293,-6.99428170474855,31,31,0,3
76521,4to9,4,9,0.956581880830229,-8.66146635741079,31,31,0,2
76537,9to4,9,4,0.981665301785293,-6.99428170474855,32,32,0,3
76553,4to9,4,9,0.956581880830229,-8.66146635741079,32,32,0,2
76568,9to4,9,4,0.981665301785293,-6.99428170474855,31,31,0,3
76584,4to9,4,9,0.956581880830229,-8.66146635741079,31,31,0,2
76601,9to4,9,4,0.981665301785293,-6.99428170474855,33,33,0,3
76616,4to9,4,9,0.956581880830229,-8.66146635741079,32,32,0,2
76632,9to4,9,4,0.981665301785293,-6.99428170474855,31,31,0,3
76648,4to9,4,9,0.956581880830229,-8.66146635741079,32,32,0,2
76663,9to4,9,4,0.981665301785293,-6.99428170474855,31,31,0,3
76679,4to3,4,3,0.043418119169771,-11.7539559008873,378,378,0,2
76695,3to8,3,8,0.028100497386711,-7.53429139751082,789,789,0,3
76710,8to9,8,9,0.755069979295685,-2.89449932615566,62,62,0,4
76725,9to4,9,4,0.981665301785293,-6.99428170474855,62,62,0,3
76741,4to9,4,9,0.956581880830229,-8.66146635741079,31,31,0,2
76757,9to4,9,4,0.981665301785293,-6.99428170474855,32,32,0,3
76774,4to9,4,9,0.956581880830229,-8.66146635741079,33,33,0,2
76790,9to4,9,4,0.981665301785293,-6.99428170474855,33,33,0,3
76805,4to9,4,9,0.956581880830229,-8.66146635741079,31,31,0,2
76822,9to4,9,4,0.981665301785293,-6.99428170474855,32,32,0,3
76837,4to9,4,9,0.956581880830229,-8.66146635741079,32,32,0,2
76853,9to4,9,4,0.981665301785293,-6.99428170474855,31,31,0,3
76870,4to9,4,9,0.956581880830229,-8.66146635741079,33,33,0,2
76886,9to4,9,4,0.981665301785293,-6.99428170474855,33,33,0,3
76902,4to9,4,9,0.956581880830229,-8.66146635741079,32,32,0,2
76917,9to4,9,4,0.981665301785293,-6.99428170474855,31,31,0,3
76931,4to9,4,9,0.956581880830229,-8.66146635741079,29,29,0,2
76947,9to4,9,4,0.981665301785293,-6.99428170474855,30,30,0,3
76964,4to9,4,9,0.956581880830229,-8.66146635741079,33,33,0,2
76981,9to4,9,4,0.981665301785293,-6.99428170474855,34,34,0,3
76995,4to9,4,9,0.956581880830229,-8.66146635741079,31,31,0,2
77010,9to4,9,4,0.981665301785293,-6.99428170474855,29,29,0,3
77026,4to3,4,3,0.043418119169771,-11.7539559008873,347,347,0,2
77042,3to4,3,4,0.969931703079532,-3.99285301446634,32,32,0,3
77058,4to9,4,9,0.956581880830229,-8.66146635741079,63,63,0,2
77073,9to4,9,4,0.981665301785293,-6.99428170474855,31,31,0,3
77087,4to9,4,9,0.956581880830229,-8.66146635741079,29,29,0,2
77105,9to4,9,4,0.981665301785293,-6.99428170474855,32,32,0,3
77120,4to9,4,9,0.956581880830229,-8.66146635741079,33,33,0,2
77136,9to4,9,4,0.981665301785293,-6.99428170474855,31,31,0,3
77150,4to9,4,9,0.956581880830229,-8.66146635741079,30,30,0,2
77166,9to4,9,4,0.981665301785293,-6.99428170474855,30,30,0,3
77180,4to9,4,9,0.956581880830229,-8.66146635741079,30,30,0,2
77194,9to4,9,4,0.981665301785293,-6.99428170474855,28,28,0,3
77210,4to9,4,9,0.956581880830229,-8.66146635741079,30,30,0,2
77226,9to4,9,4,0.981665301785293,-6.99428170474855,32,32,0,3
77242,4to9,4,9,0.956581880830229,-8.66146635741079,32,32,0,2
77257,9to4,9,4,0.981665301785293,-6.99428170474855,31,31,0,3
77274,4to9,4,9,0.956581880830229,-8.66146635741079,32,32,0,2
77290,9to4,9,4,0.981665301785293,-6.99428170474855,33,33,0,3
77306,4to9,4,9,0.956581880830229,-8.66146635741079,32,32,0,2
77321,9to4,9,4,0.981665301785293,-6.99428170474855,31,31,0,3
77338,4to9,4,9,0.956581880830229,-8.66146635741079,32,32,0,2
77354,9to4,9,4,0.981665301785293,-6.99428170474855,33,33,0,3
77369,4to9,4,9,0.956581880830229,-8.66146635741079,31,31,0,2
77386,9to4,9,4,0.981665301785293,-6.99428170474855,32,32,0,3
77402,4to9,4,9,0.956581880830229,-8.66146635741079,33,33,0,2
77418,9to4,9,4,0.981665301785293,-6.99428170474855,32,32,0,3
77434,4to9,4,9,0.956581880830229,-8.66146635741079,32,32,0,2
77450,9to4,9,4,0.981665301785293,-6.99428170474855,32,32,0,3
77467,4to3,4,3,0.043418119169771,-11.7539559008873,441,441,0,2
77484,3to8,3,8,0.028100497386711,-7.53429139751082,789,789,0,3
77501,8to9,8,9,0.755069979295685,-2.89449932615566,67,67,0,4
77516,9to4,9,4,0.981665301785293,-6.99428170474855,66,66,0,3
77532,4to9,4,9,0.956581880830229,-8.66146635741079,31,31,0,2
77546,9to4,9,4,0.981665301785293,-6.99428170474855,30,30,0,3
77561,4to9,4,9,0.956581880830229,-8.66146635741079,29,29,0,2
77578,9to4,9,4,0.981665301785293,-6.99428170474855,32,32,0,3
77594,4to9,4,9,0.956581880830229,-8.66146635741079,33,33,0,2
77609,9to4,9,4,0.981665301785293,-6.99428170474855,31,31,0,3
77624,4to9,4,9,0.956581880830229,-8.66146635741079,30,30,0,2
77638,9to4,9,4,0.981665301785293,-6.99428170474855,29,29,0,3
77653,4to9,4,9,0.956581880830229,-8.66146635741079,29,29,0,2
77669,9to4,9,4,0.981665301785293,-6.99428170474855,31,31,0,3
77685,4to9,4,9,0.956581880830229,-8.66146635741079,32,32,0,2
77701,9to4,9,4,0.981665301785293,-6.99428170474855,32,32,0,3
77715,4to9,4,9,0.956581880830229,-8.66146635741079,30,30,0,2
77730,9to4,9,4,0.981665301785293,-6.99428170474855,29,29,0,3
77746,4to9,4,9,0.956581880830229,-8.66146635741079,31,31,0,2
77760,9to4,9,4,0.981665301785293,-6.99428170474855,30,30,0,3
77777,4to9,4,9,0.956581880830229,-8.66146635741079,31,31,0,2
77792,9to4,9,4,0.981665301785293,-6.99428170474855,32,32,0,3
77808,4to9,4,9,0.956581880830229,-8.66146635741079,31,31,0,2
77823,9to4,9,4,0.981665301785293,-6.99428170474855,31,31,0,3
77840,4to3,4,3,0.043418119169771,-11.7539559008873,373,373,0,2
77856,3to4,3,4,0.969931703079532,-3.99285301446634,33,33,0,3
77873,4to9,4,9,0.956581880830229,-8.66146635741079,65,65,0,2
77889,9to4,9,4,0.981665301785293,-6.99428170474855,33,33,0,3
77904,4to9,4,9,0.956581880830229,-8.66146635741079,31,31,0,2
77919,9to4,9,4,0.981665301785293,-6.99428170474855,30,30,0,3
77936,4to3,4,3,0.043418119169771,-11.7539559008873,96,96,0,2
77953,3to4,3,4,0.969931703079532,-3.99285301446634,34,34,0,3
77968,4to9,4,9,0.956581880830229,-8.66146635741079,64,64,0,2
77986,9to4,9,4,0.981665301785293,-6.99428170474855,33,33,0,3
78000,4to9,4,9,0.956581880830229,-8.66146635741079,32,32,0,2
78015,9to4,9,4,0.981665301785293,-6.99428170474855,29,29,0,3
78031,4to9,4,9,0.956581880830229,-8.66146635741079,31,31,0,2
78045,9to4,9,4,0.981665301785293,-6.99428170474855,30,30,0,3
78062,4to9,4,9,0.956581880830229,-8.66146635741079,31,31,0,2
78076,9to4,9,4,0.981665301785293,-6.99428170474855,31,31,0,3
78093,4to9,4,9,0.956581880830229,-8.66146635741079,31,31,0,2
78110,9to4,9,4,0.981665301785293,-6.99428170474855,34,34,0,3
78124,4to9,4,9,0.956581880830229,-8.66146635741079,31,31,0,2
78138,9to4,9,4,0.981665301785293,-6.99428170474855,28,28,0,3
78154,4to9,4,9,0.956581880830229,-8.66146635741079,30,30,0,2
78168,9to4,9,4,0.981665301785293,-6.99428170474855,30,30,0,3
78184,4to9,4,9,0.956581880830229,-8.66146635741079,30,30,0,2
78199,9to4,9,4,0.981665301785293,-6.99428170474855,31,31,0,3
78215,4to3,4,3,0.043418119169771,-11.7539559008873,279,279,0,2
78230,3to8,3,8,0.028100497386711,-7.53429139751082,746,746,0,3
78247,8to13,8,13,0.008138626439491,-7.43643275329358,2227,230,1997,4
78263,13to12,13,12,0.069387876152312,-9.77853263566746,2260,227,2033,4
78279,12to7,12,7,0.0160003420693,-9.70004813592522,4650,4650,0,4
78295,7to2,7,2,0.063879469306829,-4.92272997679187,2355,2355,0,4
78311,2to3,2,3,0.990849445336188,-3.70441168844569,96,96,0,3
78326,3to4,3,4,0.969931703079532,-3.99285301446634,127,127,0,3
78343,4to9,4,9,0.956581880830229,-8.66146635741079,159,159,0,2
78358,9to4,9,4,0.981665301785293,-6.99428170474855,32,32,0,3
78374,4to9,4,9,0.956581880830229,-8.66146635741079,31,31,0,2
78390,9to4,9,4,0.981665301785293,-6.99428170474855,32,32,0,3
78405,4to9,4,9,0.956581880830229,-8.66146635741079,31,31,0,2
78420,9to4,9,4,0.981665301785293,-6.99428170474855,30,30,0,3
78435,4to9,4,9,0.956581880830229,-8.66146635741079,30,30,0,2
78449,9to4,9,4,0.981665301785293,-6.99428170474855,29,29,0,3
78466,4to9,4,9,0.956581880830229,-8.66146635741079,31,31,0,2
78482,9to4,9,4,0.981665301785293,-6.99428170474855,33,33,0,3
78497,4to9,4,9,0.956581880830229,-8.66146635741079,31,31,0,2
78513,9to4,9,4,0.981665301785293,-6.99428170474855,31,31,0,3
78529,4to9,4,9,0.956581880830229,-8.66146635741079,32,32,0,2
78546,9to4,9,4,0.981665301785293,-6.99428170474855,33,33,0,3
78563,4to3,4,3,0.043418119169771,-11.7539559008873,252,252,0,2
78578,3to4,3,4,0.969931703079532,-3.99285301446634,32,32,0,3
78595,4to9,4,9,0.956581880830229,-8.66146635741079,66,66,0,2
78611,9to4,9,4,0.981665301785293,-6.99428170474855,33,33,0,3
78626,4to9,4,9,0.956581880830229,-8.66146635741079,31,31,0,2
78640,9to4,9,4,0.981665301785293,-6.99428170474855,29,29,0,3
78655,4to9,4,9,0.956581880830229,-8.66146635741079,29,29,0,2
78670,9to4,9,4,0.981665301785293,-6.99428170474855,30,30,0,3
78686,4to9,4,9,0.956581880830229,-8.66146635741079,31,31,0,2
78702,9to4,9,4,0.981665301785293,-6.99428170474855,32,32,0,3
78719,4to9,4,9,0.956581880830229,-8.66146635741079,33,33,0,2
78734,9to4,9,4,0.981665301785293,-6.99428170474855,32,32,0,3
78749,4to3,4,3,0.043418119169771,-11.7539559008873,186,186,0,2
78764,3to8,3,8,0.028100497386711,-7.53429139751082,534,534,0,3
78780,8to9,8,9,0.763990115179857,-2.89449932615566,61,61,0,4
78795,9to4,9,4,0.981665301785293,-6.99428170474855,61,61,0,3
78811,4to9,4,9,0.956581880830229,-8.66146635741079,31,31,0,2
78827,9to4,9,4,0.981665301785293,-6.99428170474855,32,32,0,3
78843,4to9,4,9,0.956581880830229,-8.66146635741079,32,32,0,2
78859,9to4,9,4,0.981665301785293,-6.99428170474855,32,32,0,3
78875,4to9,4,9,0.956581880830229,-8.66146635741079,32,32,0,2
78890,9to4,9,4,0.981665301785293,-6.99428170474855,31,31,0,3
78907,4to9,4,9,0.956581880830229,-8.66146635741079,32,32,0,2
78921,9to4,9,4,0.981665301785293,-6.99428170474855,31,31,0,3
78937,4to9,4,9,0.956581880830229,-8.66146635741079,30,30,0,2
78954,9to4,9,4,0.981665301785293,-6.99428170474855,33,33,0,3
78969,4to9,4,9,0.956581880830229,-8.66146635741079,32,32,0,2
78984,9to4,9,4,0.981665301785293,-6.99428170474855,30,30,0,3
79000,4to3,4,3,0.043418119169771,-11.7539559008873,251,251,0,2
79015,3to4,3,4,0.969931703079532,-3.99285301446634,31,31,0,3
79031,4to9,4,9,0.956581880830229,-8.66146635741079,62,62,0,2
79046,9to4,9,4,0.981665301785293,-6.99428170474855,31,31,0,3
79062,4to9,4,9,0.956581880830229,-8.66146635741079,31,31,0,2
79077,9to4,9,4,0.981665301785293,-6.99428170474855,31,31,0,3
79093,4to9,4,9,0.956581880830229,-8.66146635741079,31,31,0,2
79108,9to4,9,4,0.981665301785293,-6.99428170474855,31,31,0,3
79123,4to9,4,9,0.956581880830229,-8.66146635741079,30,30,0,2
79138,9to4,9,4,0.981665301785293,-6.99428170474855,30,30,0,3
79154,4to9,4,9,0.956581880830229,-8.66146635741079,31,31,0,2
79170,9to14,9,14,0.000775950491976,-14.1378748897887,3133,1169,1964,3
79185,14to13,14,13,0.077832929180623,-7.60263356251491,938,425,513,3
79202,13to8,13,8,0.786111737091529,-7.37455157477482,438,425,13,4
79217,8to13,8,13,0.008138626439491,-7.43643275329358,32,32,0,4
79235,13to18,13,18,0.000214010435002,-15.5837099148442,7117,491,6626,4
79251,18to13,18,13,0.99482338198104,-3.74424906738557,34,34,0,4
79267,13to12,13,12,0.071054470690197,-9.77853263566746,1004,1004,0,4
79283,12to11,12,11,0.001536569625199,-12.0452777493778,3297,390,2907,4
79299,11to10,11,10,0.060344008886633,-7.82019769818928,12689,7812,4877,4
79316,10to5,10,5,0.204177463978915,-10.4894589900251,12690,487,12203,3
79332,5to0,5,0,0.085116892458237,-8.67998195795424,14246,487,13759,3
79348,0to1,0,1,0.302106515329069,-6.25316708944191,3393,487,2906,2
79364,1to6,1,6,0.149793084081681,-8.2441767661169,3394,488,2906,3
79380,6to7,6,7,0.534436869291918,-5.21442897770946,1101,586,515,4
79397,7to8,7,8,0.799128208043706,-2.39620659892225,195,195,0,4
79414,8to9,8,9,0.763990115179857,-2.89449932615566,260,260,0,4
79429,9to4,9,4,0.982329336361777,-6.99428170474855,291,291,0,3
79444,4to3,4,3,0.043418119169771,-11.7539559008873,444,444,0,2
79458,3to4,3,4,0.969931703079532,-3.99285301446634,29,29,0,3
79473,4to3,4,3,0.043418119169771,-11.7539559008873,29,29,0,2
79489,3to4,3,4,0.969931703079532,-3.99285301446634,31,31,0,3
79505,4to9,4,9,0.956581880830229,-8.66146635741079,91,91,0,2
79521,9to4,9,4,0.982329336361777,-6.99428170474855,32,32,0,3
79537,4to9,4,9,0.956581880830229,-8.66146635741079,32,32,0,2
79554,9to4,9,4,0.982329336361777,-6.99428170474855,33,33,0,3
79569,4to9,4,9,0.956581880830229,-8.66146635741079,32,32,0,2
79584,9to4,9,4,0.982329336361777,-6.99428170474855,30,30,0,3
79601,4to9,4,9,0.956581880830229,-8.66146635741079,32,32,0,2
79616,9to4,9,4,0.982329336361777,-6.99428170474855,32,32,0,3
79632,4to9,4,9,0.956581880830229,-8.66146635741079,31,31,0,2
79648,9to4,9,4,0.982329336361777,-6.99428170474855,32,32,0,3
79663,4to9,4,9,0.956581880830229,-8.66146635741079,31,31,0,2
79678,9to4,9,4,0.982329336361777,-6.99428170474855,30,30,0,3
79695,4to9,4,9,0.956581880830229,-8.66146635741079,32,32,0,2
79710,9to4,9,4,0.982329336361777,-6.99428170474855,32,32,0,3
79725,4to9,4,9,0.956581880830229,-8.66146635741079,30,30,0,2
79739,9to4,9,4,0.982329336361777,-6.99428170474855,29,29,0,3
79755,4to9,4,9,0.956581880830229,-8.66146635741079,30,30,0,2
79772,9to4,9,4,0.982329336361777,-6.99428170474855,33,33,0,3
79787,4to9,4,9,0.956581880830229,-8.66146635741079,32,32,0,2
79802,9to4,9,4,0.982329336361777,-6.99428170474855,30,30,0,3
79818,4to3,4,3,0.043418119169771,-11.7539559008873,345,345,0,2
79835,3to4,3,4,0.969931703079532,-3.99285301446634,33,33,0,3
79851,4to9,4,9,0.956581880830229,-8.66146635741079,64,64,0,2
79865,9to4,9,4,0.982329336361777,-6.99428170474855,30,30,0,3
79881,4to9,4,9,0.956581880830229,-8.66146635741079,30,30,0,2
79897,9to4,9,4,0.982329336361777,-6.99428170474855,32,32,0,3
79912,4to9,4,9,0.956581880830229,-8.66146635741079,31,31,0,2
79927,9to4,9,4,0.982329336361777,-6.99428170474855,30,30,0,3
79943,4to9,4,9,0.956581880830229,-8.66146635741079,31,31,0,2
79960,9to4,9,4,0.982329336361777,-6.99428170474855,33,33,0,3
79974,4to9,4,9,0.956581880830229,-8.66146635741079,31,31,0,2
79990,9to4,9,4,0.982329336361777,-6.99428170474855,30,30,0,3
80005,4to9,4,9,0.956581880830229,-8.66146635741079,31,31,0,2
80021,9to4,9,4,0.982329336361777,-6.99428170474855,31,31,0,3
80036,4to9,4,9,0.956581880830229,-8.66146635741079,31,31,0,2
80051,9to8,9,8,0.016894713146247,-11.0572075885512,654,654,0,3
80067,8to3,8,3,0.225519798251787,-4.11464622477799,249,249,0,4
80082,3to4,3,4,0.969931703079532,-3.99285301446634,61,61,0,3
80098,4to9,4,9,0.956581880830229,-8.66146635741079,62,62,0,2
80114,9to4,9,4,0.982329336361777,-6.99428170474855,32,32,0,3
80128,4to9,4,9,0.956581880830229,-8.66146635741079,30,30,0,2
80144,9to4,9,4,0.982329336361777,-6.99428170474855,30,30,0,3
80160,4to9,4,9,0.956581880830229,-8.66146635741079,32,32,0,2
80176,9to8,9,8,0.016894713146247,-11.0572075885512,125,125,0,3
80193,8to3,8,3,0.225519798251787,-4.11464622477799,126,126,0,4
80210,3to8,3,8,0.028100497386711,-7.53429139751082,34,34,0,3
80225,8to9,8,9,0.763990115179857,-2.89449932615566,65,65,0,4
80241,9to8,9,8,0.016894713146247,-11.0572075885512,31,31,0,3
80257,8to9,8,9,0.763990115179857,-2.89449932615566,32,32,0,4
80273,9to4,9,4,0.982329336361777,-6.99428170474855,129,129,0,3
80290,4to9,4,9,0.956581880830229,-8.66146635741079,33,33,0,2
80306,9to4,9,4,0.982329336361777,-6.99428170474855,33,33,0,3
80322,4to9,4,9,0.956581880830229,-8.66146635741079,32,32,0,2
80336,9to4,9,4,0.982329336361777,-6.99428170474855,30,30,0,3
80352,4to9,4,9,0.956581880830229,-8.66146635741079,30,30,0,2
80367,9to4,9,4,0.982329336361777,-6.99428170474855,31,31,0,3
80383,4to9,4,9,0.956581880830229,-8.66146635741079,31,31,0,2
80398,9to4,9,4,0.982329336361777,-6.99428170474855,31,31,0,3
80412,4to9,4,9,0.956581880830229,-8.66146635741079,29,29,0,2
80428,9to4,9,4,0.982329336361777,-6.99428170474855,30,30,0,3
80444,4to9,4,9,0.956581880830229,-8.66146635741079,32,32,0,2
80462,9to4,9,4,0.982329336361777,-6.99428170474855,34,34,0,3
80478,4to9,4,9,0.956581880830229,-8.66146635741079,34,34,0,2
80493,9to4,9,4,0.982329336361777,-6.99428170474855,31,31,0,3
80508,4to9,4,9,0.956581880830229,-8.66146635741079,30,30,0,2
80524,9to4,9,4,0.982329336361777,-6.99428170474855,31,31,0,3
80540,4to9,4,9,0.956581880830229,-8.66146635741079,32,32,0,2
80554,9to4,9,4,0.982329336361777,-6.99428170474855,30,30,0,3
80570,4to3,4,3,0.043418119169771,-11.7539559008873,377,377,0,2
80585,3to4,3,4,0.969931703079532,-3.99285301446634,31,31,0,3
80601,4to9,4,9,0.956581880830229,-8.66146635741079,61,61,0,2
80618,9to4,9,4,0.982329336361777,-6.99428170474855,33,33,0,3
80633,4to9,4,9,0.956581880830229,-8.66146635741079,32,32,0,2
80649,9to4,9,4,0.982329336361777,-6.99428170474855,31,31,0,3
80665,4to9,4,9,0.956581880830229,-8.66146635741079,32,32,0,2
80680,9to4,9,4,0.982329336361777,-6.99428170474855,31,31,0,3
80696,4to9,4,9,0.956581880830229,-8.66146635741079,31,31,0,2
80712,9to4,9,4,0.982329336361777,-6.99428170474855,32,32,0,3
80728,4to9,4,9,0.956581880830229,-8.66146635741079,32,32,0,2
80743,9to4,9,4,0.982329336361777,-6.99428170474855,31,31,0,3
80759,4to9,4,9,0.956581880830229,-8.66146635741079,31,31,0,2
80774,9to4,9,4,0.982329336361777,-6.99428170474855,31,31,0,3
80789,4to3,4,3,0.043418119169771,-11.7539559008873,219,219,0,2
80806,3to8,3,8,0.028100497386711,-7.53429139751082,565,565,0,3
80823,8to9,8,9,0.763990115179857,-2.89449932615566,64,64,0,4
80838,9to4,9,4,0.982329336361777,-6.99428170474855,64,64,0,3
80854,4to9,4,9,0.956581880830229,-8.66146635741079,31,31,0,2
80871,9to4,9,4,0.982329336361777,-6.99428170474855,33,33,0,3
80886,4to9,4,9,0.956581880830229,-8.66146635741079,32,32,0,2
80901,9to4,9,4,0.982329336361777,-6.99428170474855,30,30,0,3
80917,4to9,4,9,0.956581880830229,-8.66146635741079,31,31,0,2
80931,9to4,9,4,0.982329336361777,-6.99428170474855,30,30,0,3
80946,4to9,4,9,0.956581880830229,-8.66146635741079,29,29,0,2
80960,9to4,9,4,0.982329336361777,-6.99428170474855,29,29,0,3
80975,4to9,4,9,0.956581880830229,-8.66146635741079,29,29,0,2
80990,9to4,9,4,0.982329336361777,-6.99428170474855,30,30,0,3
81005,4to9,4,9,0.956581880830229,-8.66146635741079,30,30,0,2
81020,9to4,9,4,0.982329336361777,-6.99428170474855,30,30,0,3
81036,4to9,4,9,0.956581880830229,-8.66146635741079,31,31,0,2
81051,9to4,9,4,0.982329336361777,-6.99428170474855,31,31,0,3
81066,4to9,4,9,0.956581880830229,-8.66146635741079,30,30,0,2
81081,9to8,9,8,0.016894713146247,-11.0572075885512,275,275,0,3
81097,8to3,8,3,0.225519798251787,-4.11464622477799,308,308,0,4
81114,3to4,3,4,0.969931703079532,-3.99285301446634,63,63,0,3
81130,4to9,4,9,0.956581880830229,-8.66146635741079,64,64,0,2
81146,9to4,9,4,0.982329336361777,-6.99428170474855,32,32,0,3
81161,4to9,4,9,0.956581880830229,-8.66146635741079,31,31,0,2
81178,9to4,9,4,0.982329336361777,-6.99428170474855,32,32,0,3
81194,4to9,4,9,0.956581880830229,-8.66146635741079,33,33,0,2
81210,9to4,9,4,0.982329336361777,-6.99428170474855,32,32,0,3
81225,4to9,4,9,0.956581880830229,-8.66146635741079,31,31,0,2
81241,9to4,9,4,0.982329336361777,-6.99428170474855,31,31,0,3
81257,4to9,4,9,0.956581880830229,-8.66146635741079,32,32,0,2
81272,9to4,9,4,0.982329336361777,-6.99428170474855,31,31,0,3
81288,4to9,4,9,0.956581880830229,-8.66146635741079,31,31,0,2
81303,9to4,9,4,0.982329336361777,-6.99428170474855,31,31,0,3
81319,4to9,4,9,0.956581880830229,-8.66146635741079,31,31,0,2
81335,9to4,9,4,0.982329336361777,-6.99428170474855,32,32,0,3
81352,4to9,4,9,0.956581880830229,-8.66146635741079,33,33,0,2
81367,9to4,9,4,0.982329336361777,-6.99428170474855,32,32,0,3
81383,4to9,4,9,0.956581880830229,-8.66146635741079,31,31,0,2
81399,9to4,9,4,0.982329336361777,-6.99428170474855,32,32,0,3
81415,4to9,4,9,0.956581880830229,-8.66146635741079,32,32,0,2
81431,9to4,9,4,0.982329336361777,-6.99428170474855,32,32,0,3
81447,4to9,4,9,0.956581880830229,-8.66146635741079,32,32,0,2
81461,9to4,9,4,0.982329336361777,-6.99428170474855,30,30,0,3
81477,4to3,4,3,0.043418119169771,-11.7539559008873,380,380,0,2
81492,3to4,3,4,0.969931703079532,-3.99285301446634,31,31,0,3
81507,4to9,4,9,0.956581880830229,-8.66146635741079,60,60,0,2
81522,9to4,9,4,0.982329336361777,-6.99428170474855,30,30,0,3
81537,4to9,4,9,0.956581880830229,-8.66146635741079,30,30,0,2
81554,9to4,9,4,0.982329336361777,-6.99428170474855,32,32,0,3
81571,4to9,4,9,0.956581880830229,-8.66146635741079,34,34,0,2
81587,9to4,9,4,0.982329336361777,-6.99428170474855,33,33,0,3
81602,4to9,4,9,0.956581880830229,-8.66146635741079,31,31,0,2
81617,9to4,9,4,0.982329336361777,-6.99428170474855,30,30,0,3
81632,4to9,4,9,0.956581880830229,-8.66146635741079,30,30,0,2
81646,9to4,9,4,0.982329336361777,-6.99428170474855,29,29,0,3
81662,4to9,4,9,0.956581880830229,-8.66146635741079,30,30,0,2
81678,9to4,9,4,0.982329336361777,-6.99428170474855,32,32,0,3
81694,4to9,4,9,0.956581880830229,-8.66146635741079,32,32,0,2
81709,9to4,9,4,0.982329336361777,-6.99428170474855,31,31,0,3
81725,4to9,4,9,0.956581880830229,-8.66146635741079,31,31,0,2
81740,9to4,9,4,0.982329336361777,-6.99428170474855,31,31,0,3
81757,4to9,4,9,0.956581880830229,-8.66146635741079,32,32,0,2
81773,9to4,9,4,0.982329336361777,-6.99428170474855,33,33,0,3
81787,4to9,4,9,0.956581880830229,-8.66146635741079,30,30,0,2
81803,9to4,9,4,0.982329336361777,-6.99428170474855,30,30,0,3
81818,4to9,4,9,0.956581880830229,-8.66146635741079,31,31,0,2
81833,9to4,9,4,0.982329336361777,-6.99428170474855,30,30,0,3
81850,4to3,4,3,0.043418119169771,-11.7539559008873,373,373,0,2
81867,3to8,3,8,0.028100497386711,-7.53429139751082,786,786,0,3
81882,8to9,8,9,0.763990115179857,-2.89449932615566,64,64,0,4
81897,9to4,9,4,0.982329336361777,-6.99428170474855,64,64,0,3
81913,4to9,4,9,0.956581880830229,-8.66146635741079,31,31,0,2
81928,9to4,9,4,0.982329336361777,-6.99428170474855,31,31,0,3
81943,4to9,4,9,0.956581880830229,-8.66146635741079,30,30,0,2
81959,9to4,9,4,0.982329336361777,-6.99428170474855,31,31,0,3
81974,4to9,4,9,0.956581880830229,-8.66146635741079,31,31,0,2
81990,9to4,9,4,0.982329336361777,-6.99428170474855,31,31,0,3
82007,4to9,4,9,0.956581880830229,-8.66146635741079,33,33,0,2
82022,9to4,9,4,0.982329336361777,-6.99428170474855,32,32,0,3
82038,4to9,4,9,0.956581880830229,-8.66146635741079,31,31,0,2
82054,9to4,9,4,0.982329336361777,-6.99428170474855,32,32,0,3
82071,4to9,4,9,0.956581880830229,-8.66146635741079,33,33,0,2
82087,9to4,9,4,0.982329336361777,-6.99428170474855,33,33,0,3
82102,4to9,4,9,0.956581880830229,-8.66146635741079,31,31,0,2
82117,9to4,9,4,0.982329336361777,-6.99428170474855,30,30,0,3
82132,4to9,4,9,0.956581880830229,-8.66146635741079,30,30,0,2
82146,9to4,9,4,0.982329336361777,-6.99428170474855,29,29,0,3
82162,4to9,4,9,0.956581880830229,-8.66146635741079,30,30,0,2
82180,9to4,9,4,0.982329336361777,-6.99428170474855,34,34,0,3
82196,4to9,4,9,0.956581880830229,-8.66146635741079,34,34,0,2
82212,9to4,9,4,0.982329336361777,-6.99428170474855,32,32,0,3
82228,4to3,4,3,0.043418119169771,-11.7539559008873,378,378,0,2
82245,3to4,3,4,0.969931703079532,-3.99285301446634,33,33,0,3
82262,4to9,4,9,0.956581880830229,-8.66146635741079,66,66,0,2
82276,9to4,9,4,0.982329336361777,-6.99428170474855,31,31,0,3
82292,4to9,4,9,0.956581880830229,-8.66146635741079,30,30,0,2
82308,9to4,9,4,0.982329336361777,-6.99428170474855,32,32,0,3
82324,4to9,4,9,0.956581880830229,-8.66146635741079,32,32,0,2
82339,9to4,9,4,0.982329336361777,-6.99428170474855,31,31,0,3
82355,4to9,4,9,0.956581880830229,-8.66146635741079,31,31,0,2
82369,9to4,9,4,0.982329336361777,-6.99428170474855,30,30,0,3
82385,4to9,4,9,0.956581880830229,-8.66146635741079,30,30,0,2
82399,9to4,9,4,0.982329336361777,-6.99428170474855,30,30,0,3
82415,4to9,4,9,0.956581880830229,-8.66146635741079,30,30,0,2
82430,9to4,9,4,0.982329336361777,-6.99428170474855,31,31,0,3
82446,4to9,4,9,0.956581880830229,-8.66146635741079,31,31,0,2
82461,9to4,9,4,0.982329336361777,-6.99428170474855,31,31,0,3
82477,4to9,4,9,0.956581880830229,-8.66146635741079,31,31,0,2
82492,9to4,9,4,0.982329336361777,-6.99428170474855,31,31,0,3
82509,4to9,4,9,0.956581880830229,-8.66146635741079,32,32,0,2
82525,9to4,9,4,0.982329336361777,-6.99428170474855,33,33,0,3
82542,4to9,4,9,0.956581880830229,-8.66146635741079,33,33,0,2
82558,9to4,9,4,0.982329336361777,-6.99428170474855,33,33,0,3
82575,4to9,4,9,0.956581880830229,-8.66146635741079,33,33,0,2
82589,9to4,9,4,0.982329336361777,-6.99428170474855,31,31,0,3
82605,4to3,4,3,0.043418119169771,-11.7539559008873,377,377,0,2
82620,3to8,3,8,0.028100497386711,-7.53429139751082,753,753,0,3
82637,8to9,8,9,0.763990115179857,-2.89449932615566,62,62,0,4
82653,9to4,9,4,0.982329336361777,-6.99428170474855,64,64,0,3
82668,4to9,4,9,0.956581880830229,-8.66146635741079,31,31,0,2
82684,9to4,9,4,0.982329336361777,-6.99428170474855,31,31,0,3
82700,4to9,4,9,0.956581880830229,-8.66146635741079,32,32,0,2
82715,9to4,9,4,0.982329336361777,-6.99428170474855,31,31,0,3
82731,4to9,4,9,0.956581880830229,-8.66146635741079,31,31,0,2
82747,9to8,9,8,0.016894713146247,-11.0572075885512,127,127,0,3
82763,8to3,8,3,0.225519798251787,-4.11464622477799,158,158,0,4
82779,3to4,3,4,0.969931703079532,-3.99285301446634,64,64,0,3
82795,4to9,4,9,0.956581880830229,-8.66146635741079,64,64,0,2
82810,9to4,9,4,0.982329336361777,-6.99428170474855,31,31,0,3
82826,4to9,4,9,0.956581880830229,-8.66146635741079,31,31,0,2
82843,9to4,9,4,0.982329336361777,-6.99428170474855,33,33,0,3
82859,4to9,4,9,0.956581880830229,-8.66146635741079,33,33,0,2
82875,9to4,9,4,0.982329336361777,-6.99428170474855,32,32,0,3
82890,4to9,4,9,0.956581880830229,-8.66146635741079,31,31,0,2
82906,9to4,9,4,0.982329336361777,-6.99428170474855,31,31,0,3
82921,4to9,4,9,0.956581880830229,-8.66146635741079,31,31,0,2
82937,9to4,9,4,0.982329336361777,-6.99428170474855,31,31,0,3
82952,4to9,4,9,0.956581880830229,-8.66146635741079,31,31,0,2
82967,9to4,9,4,0.982329336361777,-6.99428170474855,30,30,0,3
82983,4to9,4,9,0.956581880830229,-8.66146635741079,31,31,0,2
82997,9to4,9,4,0.982329336361777,-6.99428170474855,30,30,0,3
83014,4to9,4,9,0.956581880830229,-8.66146635741079,31,31,0,2
83029,9to4,9,4,0.982329336361777,-6.99428170474855,32,32,0,3
83046,4to9,4,9,0.956581880830229,-8.66146635741079,32,32,0,2
83062,9to4,9,4,0.982329336361777,-6.99428170474855,33,33,0,3
83078,4to9,4,9,0.956581880830229,-8.66146635741079,32,32,0,2
83094,9to8,9,8,0.016894713146247,-11.0572075885512,347,347,0,3
83110,8to3,8,3,0.225519798251787,-4.11464622477799,347,347,0,4
83125,3to4,3,4,0.969931703079532,-3.99285301446634,63,63,0,3
83141,4to9,4,9,0.956581880830229,-8.66146635741079,63,63,0,2
83156,9to4,9,4,0.982329336361777,-6.99428170474855,31,31,0,3
83171,4to9,4,9,0.956581880830229,-8.66146635741079,30,30,0,2
83188,9to4,9,4,0.982329336361777,-6.99428170474855,32,32,0,3
83204,4to9,4,9,0.956581880830229,-8.66146635741079,33,33,0,2
83220,9to4,9,4,0.982329336361777,-6.99428170474855,32,32,0,3
83236,4to3,4,3,0.043418119169771,-11.7539559008873,126,126,0,2
83251,3to4,3,4,0.969931703079532,-3.99285301446634,31,31,0,3
83268,4to3,4,3,0.043418119169771,-11.7539559008873,32,32,0,2
83284,3to4,3,4,0.969931703079532,-3.99285301446634,33,33,0,3
83300,4to9,4,9,0.956581880830229,-8.66146635741079,96,96,0,2
83316,9to4,9,4,0.982329336361777,-6.99428170474855,32,32,0,3
83333,4to3,4,3,0.043418119169771,-11.7539559008873,65,65,0,2
83348,3to4,3,4,0.969931703079532,-3.99285301446634,32,32,0,3
83365,4to9,4,9,0.956581880830229,-8.66146635741079,65,65,0,2
83381,9to4,9,4,0.982329336361777,-6.99428170474855,33,33,0,3
83399,4to9,4,9,0.956581880830229,-8.66146635741079,34,34,0,2
83414,9to4,9,4,0.982329336361777,-6.99428170474855,33,33,0,3
83431,4to9,4,9,0.956581880830229,-8.66146635741079,32,32,0,2
83447,9to4,9,4,0.982329336361777,-6.99428170474855,33,33,0,3
83463,4to9,4,9,0.956581880830229,-8.66146635741079,32,32,0,2
83478,9to4,9,4,0.982329336361777,-6.99428170474855,31,31,0,3
83492,4to9,4,9,0.956581880830229,-8.66146635741079,29,29,0,2
83508,9to4,9,4,0.982329336361777,-6.99428170474855,30,30,0,3
83524,4to9,4,9,0.956581880830229,-8.66146635741079,32,32,0,2
83540,9to4,9,4,0.982329336361777,-6.99428170474855,32,32,0,3
83556,4to9,4,9,0.956581880830229,-8.66146635741079,32,32,0,2
83572,9to4,9,4,0.982329336361777,-6.99428170474855,32,32,0,3
83587,4to9,4,9,0.956581880830229,-8.66146635741079,31,31,0,2
83603,9to4,9,4,0.982329336361777,-6.99428170474855,31,31,0,3
83619,4to9,4,9,0.956581880830229,-8.66146635741079,32,32,0,2
83634,9to4,9,4,0.982329336361777,-6.99428170474855,31,31,0,3
83649,4to9,4,9,0.956581880830229,-8.66146635741079,30,30,0,2
83666,9to4,9,4,0.982329336361777,-6.99428170474855,32,32,0,3
83681,4to9,4,9,0.956581880830229,-8.66146635741079,32,32,0,2
83696,9to4,9,4,0.982329336361777,-6.99428170474855,30,30,0,3
83713,4to3,4,3,0.043418119169771,-11.7539559008873,380,380,0,2
83729,3to8,3,8,0.028100497386711,-7.53429139751082,635,635,0,3
83745,8to13,8,13,0.008138626439491,-7.43643275329358,4494,4494,0,4
83762,13to14,13,14,0.142361190933839,-9.08361198513014,4592,4592,0,4
83779,14to9,14,9,0.921897455817478,-5.13076416031772,98,98,0,3
83796,9to4,9,4,0.982329336361777,-6.99428170474855,100,100,0,3
83812,4to9,4,9,0.956581880830229,-8.66146635741079,33,33,0,2
83828,9to4,9,4,0.982329336361777,-6.99428170474855,32,32,0,3
83843,4to9,4,9,0.956581880830229,-8.66146635741079,31,31,0,2
83859,9to4,9,4,0.982329336361777,-6.99428170474855,31,31,0,3
83875,4to9,4,9,0.956581880830229,-8.66146635741079,32,32,0,2
83892,9to14,9,14,0.000775950491976,-14.1378748897887,130,130,0,3
83906,14to9,14,9,0.921897455817478,-5.13076416031772,31,31,0,3
83923,9to4,9,4,0.982329336361777,-6.99428170474855,64,64,0,3
83939,4to9,4,9,0.956581880830229,-8.66146635741079,33,33,0,2
83954,9to4,9,4,0.982329336361777,-6.99428170474855,31,31,0,3
83970,4to9,4,9,0.956581880830229,-8.66146635741079,31,31,0,2
83986,9to8,9,8,0.016894713146247,-11.0572075885512,257,257,0,3
84003,8to3,8,3,0.225519798251787,-4.11464622477799,290,290,0,4
84019,3to4,3,4,0.969931703079532,-3.99285301446634,65,65,0,3
84036,4to9,4,9,0.956581880830229,-8.66146635741079,66,66,0,2
84051,9to4,9,4,0.982329336361777,-6.99428170474855,32,32,0,3
84066,4to9,4,9,0.956581880830229,-8.66146635741079,30,30,0,2
84082,9to4,9,4,0.982329336361777,-6.99428170474855,31,31,0,3
84098,4to9,4,9,0.956581880830229,-8.66146635741079,32,32,0,2
84114,9to4,9,4,0.982329336361777,-6.99428170474855,32,32,0,3
84130,4to3,4,3,0.043418119169771,-11.7539559008873,127,127,0,2
84146,3to4,3,4,0.969931703079532,-3.99285301446634,32,32,0,3
84163,4to9,4,9,0.956581880830229,-8.66146635741079,65,65,0,2
84179,9to4,9,4,0.982329336361777,-6.99428170474855,33,33,0,3
84193,4to9,4,9,0.956581880830229,-8.66146635741079,30,30,0,2
84208,9to4,9,4,0.982329336361777,-6.99428170474855,29,29,0,3
84223,4to9,4,9,0.956581880830229,-8.66146635741079,30,30,0,2
84240,9to8,9,8,0.016894713146247,-11.0572075885512,254,254,0,3
84255,8to3,8,3,0.225519798251787,-4.11464622477799,125,125,0,4
84271,3to4,3,4,0.969931703079532,-3.99285301446634,63,63,0,3
84287,4to9,4,9,0.956581880830229,-8.66146635741079,64,64,0,2
84303,9to4,9,4,0.982329336361777,-6.99428170474855,32,32,0,3
84319,4to9,4,9,0.956581880830229,-8.66146635741079,32,32,0,2
84334,9to4,9,4,0.982329336361777,-6.99428170474855,31,31,0,3
84349,4to9,4,9,0.956581880830229,-8.66146635741079,30,30,0,2
84364,9to4,9,4,0.982329336361777,-6.99428170474855,30,30,0,3
84380,4to9,4,9,0.956581880830229,-8.66146635741079,31,31,0,2
84395,9to4,9,4,0.982329336361777,-6.99428170474855,31,31,0,3
84409,4to9,4,9,0.956581880830229,-8.66146635741079,29,29,0,2
84424,9to4,9,4,0.982329336361777,-6.99428170474855,29,29,0,3
84440,4to3,4,3,0.043418119169771,-11.7539559008873,185,185,0,2
84456,3to4,3,4,0.969931703079532,-3.99285301446634,32,32,0,3
84471,4to9,4,9,0.956581880830229,-8.66146635741079,62,62,0,2
84486,9to4,9,4,0.982329336361777,-6.99428170474855,30,30,0,3
84502,4to9,4,9,0.956581880830229,-8.66146635741079,31,31,0,2
84517,9to4,9,4,0.982329336361777,-6.99428170474855,31,31,0,3
84532,4to9,4,9,0.956581880830229,-8.66146635741079,30,30,0,2
84547,9to4,9,4,0.982329336361777,-6.99428170474855,30,30,0,3
84563,4to9,4,9,0.956581880830229,-8.66146635741079,31,31,0,2
84579,9to4,9,4,0.982329336361777,-6.99428170474855,32,32,0,3
84596,4to9,4,9,0.956581880830229,-8.66146635741079,33,33,0,2
84612,9to8,9,8,0.016894713146247,-11.0572075885512,372,372,0,3
84626,8to3,8,3,0.225519798251787,-4.11464622477799,186,186,0,4
84643,3to4,3,4,0.969931703079532,-3.99285301446634,64,64,0,3
84660,4to9,4,9,0.956581880830229,-8.66146635741079,64,64,0,2
84677,9to4,9,4,0.982329336361777,-6.99428170474855,34,34,0,3
84692,4to9,4,9,0.956581880830229,-8.66146635741079,32,32,0,2
84708,9to4,9,4,0.982329336361777,-6.99428170474855,31,31,0,3
84723,4to9,4,9,0.956581880830229,-8.66146635741079,31,31,0,2
84739,9to4,9,4,0.982329336361777,-6.99428170474855,31,31,0,3
84757,4to3,4,3,0.043418119169771,-11.7539559008873,131,131,0,2
84772,3to4,3,4,0.969931703079532,-3.99285301446634,33,33,0,3
84789,4to9,4,9,0.956581880830229,-8.66146635741079,66,66,0,2
84804,9to4,9,4,0.982329336361777,-6.99428170474855,32,32,0,3
84821,4to9,4,9,0.956581880830229,-8.66146635741079,32,32,0,2
84835,9to4,9,4,0.982329336361777,-6.99428170474855,31,31,0,3
84851,4to9,4,9,0.956581880830229,-8.66146635741079,30,30,0,2
84867,9to4,9,4,0.982329336361777,-6.99428170474855,32,32,0,3
84882,4to9,4,9,0.956581880830229,-8.66146635741079,31,31,0,2
84898,9to4,9,4,0.982329336361777,-6.99428170474855,31,31,0,3
84913,4to9,4,9,0.956581880830229,-8.66146635741079,31,31,0,2
84930,9to4,9,4,0.982329336361777,-6.99428170474855,32,32,0,3
84944,4to9,4,9,0.956581880830229,-8.66146635741079,31,31,0,2
84959,9to4,9,4,0.982329336361777,-6.99428170474855,29,29,0,3
84974,4to9,4,9,0.956581880830229,-8.66146635741079,30,30,0,2
84988,9to4,9,4,0.982329336361777,-6.99428170474855,29,29,0,3
85004,4to9,4,9,0.956581880830229,-8.66146635741079,30,30,0,2
85018,9to4,9,4,0.982329336361777,-6.99428170474855,30,30,0,3
85032,4to9,4,9,0.956581880830229,-8.66146635741079,28,28,0,2
85047,9to4,9,4,0.982329336361777,-6.99428170474855,29,29,0,3
85062,4to9,4,9,0.956581880830229,-8.66146635741079,30,30,0,2
85077,9to4,9,4,0.982329336361777,-6.99428170474855,30,30,0,3
85092,4to3,4,3,0.043418119169771,-11.7539559008873,335,335,0,2
85109,3to4,3,4,0.969931703079532,-3.99285301446634,32,32,0,3
85124,4to9,4,9,0.956581880830229,-8.66146635741079,62,62,0,2
85140,9to4,9,4,0.982329336361777,-6.99428170474855,31,31,0,3
85155,4to9,4,9,0.956581880830229,-8.66146635741079,31,31,0,2
85171,9to4,9,4,0.982329336361777,-6.99428170474855,31,31,0,3
85186,4to9,4,9,0.956581880830229,-8.66146635741079,31,31,0,2
85201,9to4,9,4,0.982329336361777,-6.99428170474855,30,30,0,3
85217,4to9,4,9,0.956581880830229,-8.66146635741079,31,31,0,2
85233,9to4,9,4,0.982329336361777,-6.99428170474855,32,32,0,3
85248,4to9,4,9,0.956581880830229,-8.66146635741079,31,31,0,2
85264,9to4,9,4,0.982329336361777,-6.99428170474855,31,31,0,3
85280,4to9,4,9,0.956581880830229,-8.66146635741079,32,32,0,2
85295,9to4,9,4,0.982329336361777,-6.99428170474855,31,31,0,3
85312,4to9,4,9,0.956581880830229,-8.66146635741079,32,32,0,2
85328,9to4,9,4,0.982329336361777,-6.99428170474855,33,33,0,3
85343,4to9,4,9,0.956581880830229,-8.66146635741079,31,31,0,2
85359,9to4,9,4,0.982329336361777,-6.99428170474855,31,31,0,3
85374,4to9,4,9,0.956581880830229,-8.66146635741079,31,31,0,2
85390,9to4,9,4,0.982329336361777,-6.99428170474855,31,31,0,3
85408,4to9,4,9,0.956581880830229,-8.66146635741079,34,34,0,2
85425,9to4,9,4,0.982329336361777,-6.99428170474855,35,35,0,3
85441,4to9,4,9,0.956581880830229,-8.66146635741079,33,33,0,2
85457,9to4,9,4,0.982329336361777,-6.99428170474855,32,32,0,3
85473,4to3,4,3,0.043418119169771,-11.7539559008873,381,381,0,2
85488,3to8,3,8,0.028100497386711,-7.53429139751082,876,876,0,3
85504,8to9,8,9,0.763990115179857,-2.89449932615566,63,63,0,4
85519,9to4,9,4,0.982329336361777,-6.99428170474855,62,62,0,3
85535,4to9,4,9,0.956581880830229,-8.66146635741079,31,31,0,2
85550,9to4,9,4,0.982329336361777,-6.99428170474855,31,31,0,3
85565,4to9,4,9,0.956581880830229,-8.66146635741079,30,30,0,2
85582,9to4,9,4,0.982329336361777,-6.99428170474855,32,32,0,3
85596,4to9,4,9,0.956581880830229,-8.66146635741079,31,31,0,2
85610,9to4,9,4,0.982329336361777,-6.99428170474855,28,28,0,3
85626,4to9,4,9,0.956581880830229,-8.66146635741079,30,30,0,2
85642,9to4,9,4,0.982329336361777,-6.99428170474855,32,32,0,3
85658,4to9,4,9,0.956581880830229,-8.66146635741079,32,32,0,2
85673,9to4,9,4,0.982329336361777,-6.99428170474855,31,31,0,3
85689,4to9,4,9,0.956581880830229,-8.66146635741079,31,31,0,2
85703,9to4,9,4,0.982329336361777,-6.99428170474855,30,30,0,3
85718,4to9,4,9,0.956581880830229,-8.66146635741079,29,29,0,2
85733,9to4,9,4,0.982329336361777,-6.99428170474855,30,30,0,3
85749,4to9,4,9,0.956581880830229,-8.66146635741079,31,31,0,2
85764,9to4,9,4,0.982329336361777,-6.99428170474855,31,31,0,3
85780,4to9,4,9,0.956581880830229,-8.66146635741079,31,31,0,2
85796,9to4,9,4,0.982329336361777,-6.99428170474855,32,32,0,3
85812,4to9,4,9,0.956581880830229,-8.66146635741079,32,32,0,2
85827,9to4,9,4,0.982329336361777,-6.99428170474855,31,31,0,3
85843,4to3,4,3,0.043418119169771,-11.7539559008873,370,370,0,2
85858,3to4,3,4,0.969931703079532,-3.99285301446634,31,31,0,3
85874,4to9,4,9,0.956581880830229,-8.66146635741079,62,62,0,2
85890,9to4,9,4,0.982329336361777,-6.99428170474855,32,32,0,3
85906,4to9,4,9,0.956581880830229,-8.66146635741079,32,32,0,2
85921,9to4,9,4,0.982329336361777,-6.99428170474855,31,31,0,3
85937,4to9,4,9,0.956581880830229,-8.66146635741079,31,31,0,2
85954,9to4,9,4,0.982329336361777,-6.99428170474855,33,33,0,3
85970,4to9,4,9,0.956581880830229,-8.66146635741079,33,33,0,2
85986,9to4,9,4,0.982329336361777,-6.99428170474855,32,32,0,3
86001,4to9,4,9,0.956581880830229,-8.66146635741079,31,31,0,2
86017,9to4,9,4,0.982329336361777,-6.99428170474855,31,31,0,3
86034,4to9,4,9,0.956581880830229,-8.66146635741079,33,33,0,2
86049,9to4,9,4,0.982329336361777,-6.99428170474855,32,32,0,3
86065,4to9,4,9,0.956581880830229,-8.66146635741079,31,31,0,2
86081,9to4,9,4,0.982329336361777,-6.99428170474855,32,32,0,3
86096,4to9,4,9,0.956581880830229,-8.66146635741079,31,31,0,2
86112,9to4,9,4,0.982329336361777,-6.99428170474855,31,31,0,3
86128,4to9,4,9,0.956581880830229,-8.66146635741079,32,32,0,2
86143,9to4,9,4,0.982329336361777,-6.99428170474855,31,31,0,3
86160,4to9,4,9,0.956581880830229,-8.66146635741079,32,32,0,2
86175,9to8,9,8,0.016894713146247,-11.0572075885512,687,687,0,3
86192,8to3,8,3,0.225519798251787,-4.11464622477799,349,349,0,4
86209,3to4,3,4,0.969931703079532,-3.99285301446634,66,66,0,3
86224,4to9,4,9,0.956581880830229,-8.66146635741079,64,64,0,2
86240,9to4,9,4,0.982329336361777,-6.99428170474855,31,31,0,3
86257,4to9,4,9,0.956581880830229,-8.66146635741079,33,33,0,2
86274,9to8,9,8,0.016894713146247,-11.0572075885512,99,99,0,3
86289,8to7,8,7,0.002351460128865,-8.67801771035069,6909,6909,0,4
86306,7to12,7,12,0.068525656203016,-4.92022659283001,7039,2082,4957,4
86321,12to13,12,13,0.970729373081392,-5.77169154969565,2576,2113,463,4
86337,13to14,13,14,0.142361190933839,-9.08361198513014,2445,2445,0,4
86352,14to9,14,9,0.921897455817478,-5.13076416031772,95,95,0,3
86370,9to4,9,4,0.982329336361777,-6.99428170474855,130,130,0,3
86386,4to9,4,9,0.956581880830229,-8.66146635741079,34,34,0,2
86400,9to4,9,4,0.982329336361777,-6.99428170474855,30,30,0,3
86416,4to9,4,9,0.956581880830229,-8.66146635741079,30,30,0,2
86431,9to4,9,4,0.982329336361777,-6.99428170474855,31,31,0,3
86446,4to9,4,9,0.956581880830229,-8.66146635741079,30,30,0,2
86462,9to4,9,4,0.982329336361777,-6.99428170474855,31,31,0,3
86478,4to9,4,9,0.956581880830229,-8.66146635741079,32,32,0,2
86493,9to4,9,4,0.982329336361777,-6.99428170474855,31,31,0,3
86510,4to9,4,9,0.956581880830229,-8.66146635741079,32,32,0,2
86524,9to4,9,4,0.982329336361777,-6.99428170474855,31,31,0,3
86539,4to3,4,3,0.043418119169771,-11.7539559008873,347,347,0,2
86556,3to2,3,2,0.001967799533757,-10.193162743775,8261,8261,0,3
86572,2to3,2,3,0.990849445336188,-3.70441168844569,33,33,0,3
86590,3to4,3,4,0.969931703079532,-3.99285301446634,66,66,0,3
86607,4to9,4,9,0.956581880830229,-8.66146635741079,97,97,0,2
86622,9to4,9,4,0.982329336361777,-6.99428170474855,32,32,0,3
86638,4to9,4,9,0.956581880830229,-8.66146635741079,31,31,0,2
86654,9to4,9,4,0.982329336361777,-6.99428170474855,32,32,0,3
86670,4to9,4,9,0.956581880830229,-8.66146635741079,32,32,0,2
86685,9to4,9,4,0.982329336361777,-6.99428170474855,31,31,0,3
86701,4to9,4,9,0.956581880830229,-8.66146635741079,31,31,0,2
86717,9to4,9,4,0.982329336361777,-6.99428170474855,32,32,0,3
86732,4to9,4,9,0.956581880830229,-8.66146635741079,31,31,0,2
86746,9to4,9,4,0.982329336361777,-6.99428170474855,29,29,0,3
86763,4to9,4,9,0.956581880830229,-8.66146635741079,31,31,0,2
86779,9to4,9,4,0.982329336361777,-6.99428170474855,33,33,0,3
86795,4to9,4,9,0.956581880830229,-8.66146635741079,32,32,0,2
86810,9to4,9,4,0.982329336361777,-6.99428170474855,31,31,0,3
86826,4to9,4,9,0.956581880830229,-8.66146635741079,31,31,0,2
86841,9to4,9,4,0.982329336361777,-6.99428170474855,31,31,0,3
86856,4to9,4,9,0.956581880830229,-8.66146635741079,30,30,0,2
86871,9to4,9,4,0.982329336361777,-6.99428170474855,30,30,0,3
86887,4to9,4,9,0.956581880830229,-8.66146635741079,31,31,0,2
86902,9to4,9,4,0.982329336361777,-6.99428170474855,31,31,0,3
86918,4to9,4,9,0.956581880830229,-8.66146635741079,31,31,0,2
86933,9to4,9,4,0.982329336361777,-6.99428170474855,31,31,0,3
86948,4to3,4,3,0.043418119169771,-11.7539559008873,376,376,0,2
86964,3to8,3,8,0.028100497386711,-7.53429139751082,690,690,0,3
86978,8to9,8,9,0.763990115179857,-2.89449932615566,60,60,0,4
86993,9to4,9,4,0.982329336361777,-6.99428170474855,60,60,0,3
87009,4to9,4,9,0.956581880830229,-8.66146635741079,31,31,0,2
87025,9to4,9,4,0.982329336361777,-6.99428170474855,32,32,0,3
87041,4to9,4,9,0.956581880830229,-8.66146635741079,32,32,0,2
87056,9to4,9,4,0.982329336361777,-6.99428170474855,31,31,0,3
87072,4to9,4,9,0.956581880830229,-8.66146635741079,31,31,0,2
87088,9to4,9,4,0.982329336361777,-6.99428170474855,32,32,0,3
87104,4to9,4,9,0.956581880830229,-8.66146635741079,32,32,0,2
87121,9to4,9,4,0.982329336361777,-6.99428170474855,33,33,0,3
87136,4to9,4,9,0.956581880830229,-8.66146635741079,32,32,0,2
87152,9to4,9,4,0.982329336361777,-6.99428170474855,31,31,0,3
87167,4to9,4,9,0.956581880830229,-8.66146635741079,31,31,0,2
87182,9to4,9,4,0.982329336361777,-6.99428170474855,30,30,0,3
87197,4to9,4,9,0.956581880830229,-8.66146635741079,30,30,0,2
87212,9to4,9,4,0.982329336361777,-6.99428170474855,30,30,0,3
87227,4to9,4,9,0.956581880830229,-8.66146635741079,30,30,0,2
87242,9to4,9,4,0.982329336361777,-6.99428170474855,30,30,0,3
87257,4to9,4,9,0.956581880830229,-8.66146635741079,30,30,0,2
87271,9to4,9,4,0.982329336361777,-6.99428170474855,29,29,0,3
87286,4to3,4,3,0.043418119169771,-11.7539559008873,338,338,0,2
87301,3to4,3,4,0.969931703079532,-3.99285301446634,30,30,0,3
87317,4to9,4,9,0.956581880830229,-8.66146635741079,60,60,0,2
87332,9to4,9,4,0.982329336361777,-6.99428170474855,31,31,0,3
87347,4to9,4,9,0.956581880830229,-8.66146635741079,30,30,0,2
87364,9to4,9,4,0.982329336361777,-6.99428170474855,32,32,0,3
87380,4to9,4,9,0.956581880830229,-8.66146635741079,33,33,0,2
87396,9to4,9,4,0.982329336361777,-6.99428170474855,32,32,0,3
87412,4to9,4,9,0.956581880830229,-8.66146635741079,32,32,0,2
87427,9to4,9,4,0.982329336361777,-6.99428170474855,31,31,0,3
87442,4to9,4,9,0.956581880830229,-8.66146635741079,30,30,0,2
87458,9to4,9,4,0.982329336361777,-6.99428170474855,31,31,0,3
87473,4to9,4,9,0.956581880830229,-8.66146635741079,31,31,0,2
87490,9to4,9,4,0.982329336361777,-6.99428170474855,32,32,0,3
87507,4to9,4,9,0.956581880830229,-8.66146635741079,34,34,0,2
87524,9to4,9,4,0.982329336361777,-6.99428170474855,34,34,0,3
87539,4to9,4,9,0.956581880830229,-8.66146635741079,32,32,0,2
87556,9to4,9,4,0.982329336361777,-6.99428170474855,32,32,0,3
87571,4to9,4,9,0.956581880830229,-8.66146635741079,32,32,0,2
87586,9to4,9,4,0.982329336361777,-6.99428170474855,30,30,0,3
87602,4to9,4,9,0.956581880830229,-8.66146635741079,31,31,0,2
87618,9to4,9,4,0.982329336361777,-6.99428170474855,32,32,0,3
87632,4to9,4,9,0.956581880830229,-8.66146635741079,30,30,0,2
87648,9to8,9,8,0.016894713146247,-11.0572075885512,684,684,0,3
87665,8to3,8,3,0.225519798251787,-4.11464622477799,379,379,0,4
87681,3to4,3,4,0.969931703079532,-3.99285301446634,63,63,0,3
87697,4to9,4,9,0.956581880830229,-8.66146635741079,65,65,0,2
87711,9to4,9,4,0.982329336361777,-6.99428170474855,30,30,0,3
87726,4to9,4,9,0.956581880830229,-8.66146635741079,29,29,0,2
87742,9to4,9,4,0.982329336361777,-6.99428170474855,31,31,0,3
87758,4to9,4,9,0.956581880830229,-8.66146635741079,32,32,0,2
87774,9to4,9,4,0.982329336361777,-6.99428170474855,32,32,0,3
87789,4to9,4,9,0.956581880830229,-8.66146635741079,31,31,0,2
87805,9to4,9,4,0.982329336361777,-6.99428170474855,31,31,0,3
87820,4to9,4,9,0.956581880830229,-8.66146635741079,31,31,0,2
87836,9to4,9,4,0.982329336361777,-6.99428170474855,31,31,0,3
87852,4to9,4,9,0.956581880830229,-8.66146635741079,32,32,0,2
87867,9to4,9,4,0.982329336361777,-6.99428170474855,31,31,0,3
87883,4to9,4,9,0.956581880830229,-8.66146635741079,31,31,0,2
87899,9to4,9,4,0.982329336361777,-6.99428170474855,32,32,0,3
87915,4to9,4,9,0.956581880830229,-8.66146635741079,32,32,0,2
87931,9to4,9,4,0.982329336361777,-6.99428170474855,32,32,0,3
87946,4to9,4,9,0.956581880830229,-8.66146635741079,31,31,0,2
87963,9to4,9,4,0.982329336361777,-6.99428170474855,32,32,0,3
87978,4to9,4,9,0.956581880830229,-8.66146635741079,32,32,0,2
87993,9to4,9,4,0.982329336361777,-6.99428170474855,30,30,0,3
88008,4to9,4,9,0.956581880830229,-8.66146635741079,30,30,0,2
88023,9to4,9,4,0.982329336361777,-6.99428170474855,30,30,0,3
88040,4to3,4,3,0.043418119169771,-11.7539559008873,375,375,0,2
88056,3to4,3,4,0.969931703079532,-3.99285301446634,33,33,0,3
88071,4to9,4,9,0.956581880830229,-8.66146635741079,63,63,0,2
88087,9to4,9,4,0.982329336361777,-6.99428170474855,31,31,0,3
88103,4to9,4,9,0.956581880830229,-8.66146635741079,32,32,0,2
88120,9to4,9,4,0.982329336361777,-6.99428170474855,33,33,0,3
88134,4to9,4,9,0.956581880830229,-8.66146635741079,31,31,0,2
88149,9to4,9,4,0.982329336361777,-6.99428170474855,29,29,0,3
88165,4to9,4,9,0.956581880830229,-8.66146635741079,31,31,0,2
88180,9to4,9,4,0.982329336361777,-6.99428170474855,31,31,0,3
88195,4to9,4,9,0.956581880830229,-8.66146635741079,30,30,0,2
88211,9to4,9,4,0.982329336361777,-6.99428170474855,31,31,0,3
88227,4to9,4,9,0.956581880830229,-8.66146635741079,32,32,0,2
88243,9to4,9,4,0.982329336361777,-6.99428170474855,32,32,0,3
88259,4to9,4,9,0.956581880830229,-8.66146635741079,32,32,0,2
88275,9to4,9,4,0.982329336361777,-6.99428170474855,32,32,0,3
88292,4to9,4,9,0.956581880830229,-8.66146635741079,33,33,0,2
88307,9to4,9,4,0.982329336361777,-6.99428170474855,32,32,0,3
88323,4to3,4,3,0.043418119169771,-11.7539559008873,283,283,0,2
88339,3to8,3,8,0.028100497386711,-7.53429139751082,691,691,0,3
88354,8to9,8,9,0.763990115179857,-2.89449932615566,62,62,0,4
88371,9to4,9,4,0.982329336361777,-6.99428170474855,64,64,0,3
88386,4to9,4,9,0.956581880830229,-8.66146635741079,32,32,0,2
88402,9to4,9,4,0.982329336361777,-6.99428170474855,31,31,0,3
88418,4to9,4,9,0.956581880830229,-8.66146635741079,32,32,0,2
88433,9to4,9,4,0.982329336361777,-6.99428170474855,31,31,0,3
88449,4to9,4,9,0.92036585147042,-9.30662764773337,31,11,20,2
88464,9to4,9,4,0.982329336361777,-6.99428170474855,31,31,0,3
88479,4to9,4,9,0.92036585147042,-9.30662764773337,30,30,0,2
88495,9to4,9,4,0.982329336361777,-6.99428170474855,31,31,0,3
88511,4to9,4,9,0.92036585147042,-9.30662764773337,32,32,0,2
88526,9to4,9,4,0.982329336361777,-6.99428170474855,31,31,0,3
88542,4to3,4,3,0.07963414852958,-11.7539559008873,219,219,0,2
88557,3to4,3,4,0.969931703079532,-3.99285301446634,31,31,0,3
88574,4to9,4,9,0.92036585147042,-9.30662764773337,63,63,0,2
88591,9to4,9,4,0.982329336361777,-6.99428170474855,34,34,0,3
88606,4to9,4,9,0.92036585147042,-9.30662764773337,32,32,0,2
88620,9to4,9,4,0.982329336361777,-6.99428170474855,29,29,0,3
88637,4to9,4,9,0.92036585147042,-9.30662764773337,31,31,0,2
88653,9to4,9,4,0.982329336361777,-6.99428170474855,33,33,0,3
88669,4to9,4,9,0.92036585147042,-9.30662764773337,32,32,0,2
88686,9to4,9,4,0.982329336361777,-6.99428170474855,33,33,0,3
88702,4to9,4,9,0.92036585147042,-9.30662764773337,33,33,0,2
88718,9to4,9,4,0.982329336361777,-6.99428170474855,32,32,0,3
88734,4to9,4,9,0.92036585147042,-9.30662764773337,32,32,0,2
88750,9to4,9,4,0.982329336361777,-6.99428170474855,32,32,0,3
88766,4to3,4,3,0.07963414852958,-11.7539559008873,224,224,0,2
88782,3to8,3,8,0.021767780958129,-7.79614241331218,443,327,116,3
88797,8to9,8,9,0.763990115179857,-2.89449932615566,63,63,0,4
88814,9to4,9,4,0.982329336361777,-6.99428170474855,64,64,0,3
88830,4to9,4,9,0.92036585147042,-9.30662764773337,33,33,0,2
88845,9to4,9,4,0.982329336361777,-6.99428170474855,31,31,0,3
88861,4to9,4,9,0.92036585147042,-9.30662764773337,31,31,0,2
88876,9to4,9,4,0.982329336361777,-6.99428170474855,31,31,0,3
88891,4to9,4,9,0.92036585147042,-9.30662764773337,30,30,0,2
88907,9to4,9,4,0.982329336361777,-6.99428170474855,31,31,0,3
88923,4to9,4,9,0.92036585147042,-9.30662764773337,32,32,0,2
88939,9to4,9,4,0.982329336361777,-6.99428170474855,32,32,0,3
88953,4to9,4,9,0.92036585147042,-9.30662764773337,30,30,0,2
88969,9to4,9,4,0.982329336361777,-6.99428170474855,30,30,0,3
88985,4to3,4,3,0.07963414852958,-11.7539559008873,219,219,0,2
89001,3to2,3,2,0.001980621349595,-10.193162743775,2445,2445,0,3
89018,2to7,2,7,0.003665816475469,-9.30840515363262,2729,546,2183,3
89034,7to8,7,8,0.855108372325079,-2.39620659892225,252,252,0,4
89050,8to9,8,9,0.763990115179857,-2.89449932615566,97,97,0,4
89066,9to4,9,4,0.982329336361777,-6.99428170474855,97,97,0,3
89082,4to9,4,9,0.92036585147042,-9.30662764773337,32,32,0,2
89096,9to4,9,4,0.982329336361777,-6.99428170474855,30,30,0,3
89112,4to9,4,9,0.92036585147042,-9.30662764773337,30,30,0,2
89127,9to4,9,4,0.982329336361777,-6.99428170474855,31,31,0,3
89144,4to9,4,9,0.92036585147042,-9.30662764773337,32,32,0,2
89159,9to4,9,4,0.982329336361777,-6.99428170474855,32,32,0,3
89175,4to3,4,3,0.07963414852958,-11.7539559008873,190,190,0,2
89190,3to4,3,4,0.976251597692276,-3.99285301446634,31,31,0,3
89207,4to9,4,9,0.92036585147042,-9.30662764773337,63,63,0,2
89223,9to4,9,4,0.982329336361777,-6.99428170474855,33,33,0,3
89237,4to9,4,9,0.92036585147042,-9.30662764773337,30,30,0,2
89252,9to4,9,4,0.982329336361777,-6.99428170474855,29,29,0,3
89269,4to9,4,9,0.92036585147042,-9.30662764773337,32,32,0,2
89284,9to4,9,4,0.982329336361777,-6.99428170474855,32,32,0,3
89300,4to9,4,9,0.92036585147042,-9.30662764773337,31,31,0,2
89316,9to4,9,4,0.982329336361777,-6.99428170474855,32,32,0,3
89331,4to9,4,9,0.92036585147042,-9.30662764773337,31,31,0,2
89347,9to4,9,4,0.982329336361777,-6.99428170474855,31,31,0,3
89364,4to9,4,9,0.92036585147042,-9.30662764773337,33,33,0,2
89381,9to4,9,4,0.982329336361777,-6.99428170474855,34,34,0,3
89397,4to3,4,3,0.07963414852958,-11.7539559008873,222,222,0,2
89413,3to4,3,4,0.976251597692276,-3.99285301446634,32,32,0,3
89429,4to9,4,9,0.92036585147042,-9.30662764773337,65,65,0,2
89445,9to4,9,4,0.982329336361777,-6.99428170474855,32,32,0,3
89460,4to9,4,9,0.92036585147042,-9.30662764773337,31,31,0,2
89476,9to4,9,4,0.982329336361777,-6.99428170474855,31,31,0,3
89493,4to9,4,9,0.92036585147042,-9.30662764773337,33,33,0,2
89507,9to4,9,4,0.982329336361777,-6.99428170474855,31,31,0,3
89523,4to9,4,9,0.92036585147042,-9.30662764773337,30,30,0,2
89540,9to4,9,4,0.982329336361777,-6.99428170474855,33,33,0,3
89557,4to9,4,9,0.92036585147042,-9.30662764773337,34,34,0,2
89573,9to4,9,4,0.982329336361777,-6.99428170474855,33,33,0,3
89588,4to9,4,9,0.92036585147042,-9.30662764773337,31,31,0,2
89604,9to4,9,4,0.982329336361777,-6.99428170474855,31,31,0,3
89620,4to3,4,3,0.07963414852958,-11.7539559008873,223,223,0,2
89636,3to4,3,4,0.976251597692276,-3.99285301446634,32,32,0,3
89651,4to9,4,9,0.92036585147042,-9.30662764773337,63,63,0,2
89665,9to4,9,4,0.982329336361777,-6.99428170474855,29,29,0,3
89681,4to9,4,9,0.92036585147042,-9.30662764773337,30,30,0,2
89696,9to4,9,4,0.982329336361777,-6.99428170474855,31,31,0,3
89711,4to9,4,9,0.92036585147042,-9.30662764773337,30,30,0,2
89728,9to4,9,4,0.982329336361777,-6.99428170474855,32,32,0,3
89744,4to9,4,9,0.92036585147042,-9.30662764773337,33,33,0,2
89758,9to4,9,4,0.982329336361777,-6.99428170474855,30,30,0,3
89774,4to9,4,9,0.92036585147042,-9.30662764773337,30,30,0,2
89789,9to4,9,4,0.982329336361777,-6.99428170474855,31,31,0,3
89805,4to9,4,9,0.92036585147042,-9.30662764773337,31,31,0,2
89819,9to4,9,4,0.982329336361777,-6.99428170474855,30,30,0,3
89835,4to3,4,3,0.07963414852958,-11.7539559008873,215,215,0,2
89851,3to8,3,8,0.021767780958129,-7.79614241331218,817,817,0,3
89867,8to9,8,9,0.763990115179857,-2.89449932615566,62,62,0,4
89884,9to4,9,4,0.982329336361777,-6.99428170474855,65,65,0,3
89899,4to9,4,9,0.92036585147042,-9.30662764773337,32,32,0,2
89915,9to8,9,8,0.016894713146247,-11.0572075885512,64,64,0,3
89932,8to13,8,13,0.008138626439491,-7.43643275329358,3611,3611,0,4
89947,13to14,13,14,0.085225418839129,-9.66117431199995,3610,1525,2085,4
89962,14to19,14,19,0.000100927180842,-14.2507228814152,17696,305,17391,3
89978,19to24,19,24,0.001370675966549,-10.3393188189234,17829,4,17825,3
89994,24to19,24,19,0.817636652211703,-4.89549669273523,32,32,0,2
90009,19to18,19,18,0.009680317751153,-8.40046150197668,10774,237,10537,3
90026,18to13,18,13,0.99482338198104,-3.74424906738557,94,94,0,4
90042,13to12,13,12,0.043739474176833,-10.3623120789223,3736,1555,2181,4
90059,12to17,12,17,0.003131328965174,-11.5135208059069,17859,270,17589,4
90077,17to16,17,16,0.004612685655161,-10.5334360691902,23501,536,22965,4
90093,16to11,16,11,0.492048090570153,-4.63005166580821,10810,1424,9386,4
90108,11to10,11,10,0.026477036934404,-8.67938911275122,10809,1522,9287,4
90124,10to5,10,5,0.097999067586244,-11.3487299004618,10808,1521,9287,3
90142,5to6,5,6,0.434663367070488,-7.51594327220401,10778,1489,9289,3
90159,6to1,6,1,0.070029998103071,-7.33776307259099,10811,1523,9288,4
90175,1to2,1,2,0.813908919317649,-6.55158320144331,1174,1174,0,3
90192,2to3,2,3,0.995300351194049,-3.70441168844569,357,357,0,3
90208,3to4,3,4,0.976251597692276,-3.99285301446634,324,324,0,3
90225,4to9,4,9,0.92036585147042,-9.30662764773337,326,326,0,2
90240,9to4,9,4,0.982329336361777,-6.99428170474855,32,32,0,3
90256,4to9,4,9,0.92036585147042,-9.30662764773337,31,31,0,2
90271,9to4,9,4,0.982329336361777,-6.99428170474855,31,31,0,3
90287,4to9,4,9,0.92036585147042,-9.30662764773337,31,31,0,2
90303,9to4,9,4,0.982329336361777,-6.99428170474855,32,32,0,3
90320,4to9,4,9,0.92036585147042,-9.30662764773337,33,33,0,2
90336,9to4,9,4,0.982329336361777,-6.99428170474855,33,33,0,3
90352,4to9,4,9,0.92036585147042,-9.30662764773337,32,32,0,2
90368,9to4,9,4,0.982329336361777,-6.99428170474855,32,32,0,3
90384,4to9,4,9,0.92036585147042,-9.30662764773337,32,32,0,2
90401,9to4,9,4,0.982329336361777,-6.99428170474855,33,33,0,3
90418,4to3,4,3,0.07963414852958,-11.7539559008873,226,226,0,2
90433,3to4,3,4,0.976251597692276,-3.99285301446634,32,32,0,3
90450,4to9,4,9,0.92036585147042,-9.30662764773337,66,66,0,2
90466,9to4,9,4,0.982329336361777,-6.99428170474855,33,33,0,3
90483,4to9,4,9,0.92036585147042,-9.30662764773337,33,33,0,2
90500,9to4,9,4,0.982329336361777,-6.99428170474855,34,34,0,3
90515,4to9,4,9,0.92036585147042,-9.30662764773337,32,32,0,2
90531,9to4,9,4,0.982329336361777,-6.99428170474855,31,31,0,3
90546,4to9,4,9,0.92036585147042,-9.30662764773337,31,31,0,2
90562,9to4,9,4,0.982329336361777,-6.99428170474855,31,31,0,3
90577,4to9,4,9,0.92036585147042,-9.30662764773337,31,31,0,2
90593,9to4,9,4,0.982329336361777,-6.99428170474855,31,31,0,3
90609,4to9,4,9,0.92036585147042,-9.30662764773337,32,32,0,2
90625,9to4,9,4,0.982329336361777,-6.99428170474855,32,32,0,3
90641,4to3,4,3,0.07963414852958,-11.7539559008873,223,223,0,2
90657,3to8,3,8,0.021767780958129,-7.79614241331218,742,742,0,3
90671,8to3,8,3,0.225519798251787,-4.11464622477799,30,30,0,4
90687,3to4,3,4,0.976251597692276,-3.99285301446634,62,62,0,3
90702,4to3,4,3,0.07963414852958,-11.7539559008873,31,31,0,2
90719,3to4,3,4,0.976251597692276,-3.99285301446634,32,32,0,3
90734,4to9,4,9,0.92036585147042,-9.30662764773337,125,125,0,2
90750,9to4,9,4,0.982329336361777,-6.99428170474855,31,31,0,3
90764,4to9,4,9,0.92036585147042,-9.30662764773337,30,30,0,2
90780,9to4,9,4,0.982329336361777,-6.99428170474855,30,30,0,3
90795,4to9,4,9,0.92036585147042,-9.30662764773337,31,31,0,2
90811,9to4,9,4,0.982329336361777,-6.99428170474855,31,31,0,3
90828,4to9,4,9,0.92036585147042,-9.30662764773337,33,33,0,2
90843,9to4,9,4,0.982329336361777,-6.99428170474855,32,32,0,3
90858,4to9,4,9,0.92036585147042,-9.30662764773337,30,30,0,2
90874,9to4,9,4,0.982329336361777,-6.99428170474855,31,31,0,3
90890,4to9,4,9,0.92036585147042,-9.30662764773337,32,32,0,2
90905,9to4,9,4,0.982329336361777,-6.99428170474855,31,31,0,3
90922,4to3,4,3,0.07963414852958,-11.7539559008873,220,220,0,2
90937,3to4,3,4,0.976251597692276,-3.99285301446634,32,32,0,3
90954,4to9,4,9,0.92036585147042,-9.30662764773337,64,64,0,2
90970,9to8,9,8,0.016894713146247,-11.0572075885512,313,313,0,3
90986,8to9,8,9,0.763990115179857,-2.89449932615566,32,32,0,4
91001,9to4,9,4,0.982329336361777,-6.99428170474855,64,64,0,3
91018,4to9,4,9,0.92036585147042,-9.30662764773337,32,32,0,2
91033,9to4,9,4,0.982329336361777,-6.99428170474855,32,32,0,3
91048,4to9,4,9,0.92036585147042,-9.30662764773337,30,30,0,2
91064,9to4,9,4,0.982329336361777,-6.99428170474855,31,31,0,3
91079,4to9,4,9,0.92036585147042,-9.30662764773337,31,31,0,2
91095,9to4,9,4,0.982329336361777,-6.99428170474855,31,31,0,3
91110,4to9,4,9,0.92036585147042,-9.30662764773337,31,31,0,2
91124,9to4,9,4,0.982329336361777,-6.99428170474855,29,29,0,3
91140,4to3,4,3,0.07963414852958,-11.7539559008873,218,218,0,2
91155,3to4,3,4,0.976251597692276,-3.99285301446634,31,31,0,3
91170,4to9,4,9,0.92036585147042,-9.30662764773337,60,60,0,2
91186,9to4,9,4,0.982329336361777,-6.99428170474855,31,31,0,3
91201,4to9,4,9,0.92036585147042,-9.30662764773337,31,31,0,2
91218,9to4,9,4,0.982329336361777,-6.99428170474855,32,32,0,3
91233,4to9,4,9,0.92036585147042,-9.30662764773337,32,32,0,2
91249,9to8,9,8,0.016894713146247,-11.0572075885512,279,279,0,3
91264,8to3,8,3,0.225519798251787,-4.11464622477799,124,124,0,4
91281,3to4,3,4,0.976251597692276,-3.99285301446634,63,63,0,3
91296,4to9,4,9,0.92036585147042,-9.30662764773337,63,63,0,2
91313,9to4,9,4,0.982329336361777,-6.99428170474855,32,32,0,3
91330,4to9,4,9,0.92036585147042,-9.30662764773337,34,34,0,2
91346,9to4,9,4,0.982329336361777,-6.99428170474855,33,33,0,3
91362,4to9,4,9,0.92036585147042,-9.30662764773337,32,32,0,2
91378,9to4,9,4,0.982329336361777,-6.99428170474855,32,32,0,3
91394,4to9,4,9,0.92036585147042,-9.30662764773337,32,32,0,2
91410,9to8,9,8,0.016894713146247,-11.0572075885512,161,161,0,3
91427,8to3,8,3,0.225519798251787,-4.11464622477799,163,163,0,4
91444,3to4,3,4,0.976251597692276,-3.99285301446634,66,66,0,3
91459,4to9,4,9,0.92036585147042,-9.30662764773337,65,65,0,2
91475,9to4,9,4,0.982329336361777,-6.99428170474855,31,31,0,3
91492,4to9,4,9,0.92036585147042,-9.30662764773337,33,33,0,2
91507,9to4,9,4,0.982329336361777,-6.99428170474855,32,32,0,3
91523,4to9,4,9,0.92036585147042,-9.30662764773337,31,31,0,2
91538,9to4,9,4,0.982329336361777,-6.99428170474855,31,31,0,3
91553,4to9,4,9,0.92036585147042,-9.30662764773337,30,30,0,2
91568,9to4,9,4,0.982329336361777,-6.99428170474855,30,30,0,3
91583,4to9,4,9,0.92036585147042,-9.30662764773337,30,30,0,2
91598,9to4,9,4,0.982329336361777,-6.99428170474855,30,30,0,3
91613,4to9,4,9,0.92036585147042,-9.30662764773337,30,30,0,2
91629,9to4,9,4,0.982329336361777,-6.99428170474855,31,31,0,3
91645,4to3,4,3,0.07963414852958,-11.7539559008873,218,218,0,2
91661,3to4,3,4,0.976251597692276,-3.99285301446634,32,32,0,3
91679,4to9,4,9,0.92036585147042,-9.30662764773337,66,66,0,2
91695,9to4,9,4,0.982329336361777,-6.99428170474855,34,34,0,3
91711,4to9,4,9,0.92036585147042,-9.30662764773337,32,32,0,2
91728,9to4,9,4,0.982329336361777,-6.99428170474855,33,33,0,3
91744,4to3,4,3,0.07963414852958,-11.7539559008873,99,99,0,2
91760,3to4,3,4,0.976251597692276,-3.99285301446634,32,32,0,3
91778,4to9,4,9,0.92036585147042,-9.30662764773337,67,67,0,2
91794,9to4,9,4,0.982329336361777,-6.99428170474855,34,34,0,3
91810,4to9,4,9,0.92036585147042,-9.30662764773337,32,32,0,2
91826,9to4,9,4,0.982329336361777,-6.99428170474855,32,32,0,3
91842,4to9,4,9,0.92036585147042,-9.30662764773337,32,32,0,2
91857,9to4,9,4,0.982329336361777,-6.99428170474855,31,31,0,3
91872,4to9,4,9,0.92036585147042,-9.30662764773337,30,30,0,2
91887,9to4,9,4,0.982329336361777,-6.99428170474855,30,30,0,3
91904,4to9,4,9,0.92036585147042,-9.30662764773337,32,32,0,2
91919,9to4,9,4,0.982329336361777,-6.99428170474855,32,32,0,3
91934,4to3,4,3,0.07963414852958,-11.7539559008873,190,190,0,2
91950,3to4,3,4,0.976251597692276,-3.99285301446634,31,31,0,3
91966,4to9,4,9,0.92036585147042,-9.30662764773337,62,62,0,2
91980,9to4,9,4,0.982329336361777,-6.99428170474855,30,30,0,3
91997,4to9,4,9,0.92036585147042,-9.30662764773337,31,31,0,2
92012,9to4,9,4,0.982329336361777,-6.99428170474855,32,32,0,3
92027,4to9,4,9,0.92036585147042,-9.30662764773337,30,30,0,2
92042,9to4,9,4,0.982329336361777,-6.99428170474855,30,30,0,3
92057,4to9,4,9,0.92036585147042,-9.30662764773337,30,30,0,2
92072,9to4,9,4,0.982329336361777,-6.99428170474855,30,30,0,3
92087,4to9,4,9,0.92036585147042,-9.30662764773337,30,30,0,2
92104,9to4,9,4,0.982329336361777,-6.99428170474855,32,32,0,3
92121,4to9,4,9,0.92036585147042,-9.30662764773337,34,34,0,2
92138,9to4,9,4,0.982329336361777,-6.99428170474855,34,34,0,3
92154,4to3,4,3,0.07963414852958,-11.7539559008873,220,220,0,2
92171,3to8,3,8,0.021767780958129,-7.79614241331218,761,761,0,3
92186,8to9,8,9,0.763990115179857,-2.89449932615566,65,65,0,4
92203,9to4,9,4,0.982329336361777,-6.99428170474855,65,65,0,3
92218,4to9,4,9,0.92036585147042,-9.30662764773337,32,32,0,2
92234,9to4,9,4,0.982329336361777,-6.99428170474855,31,31,0,3
92250,4to9,4,9,0.92036585147042,-9.30662764773337,32,32,0,2
92266,9to8,9,8,0.016894713146247,-11.0572075885512,95,95,0,3
92282,8to3,8,3,0.225519798251787,-4.11464622477799,128,128,0,4
92298,3to4,3,4,0.976251597692276,-3.99285301446634,64,64,0,3
92314,4to9,4,9,0.92036585147042,-9.30662764773337,64,64,0,2
92329,9to4,9,4,0.982329336361777,-6.99428170474855,31,31,0,3
92345,4to9,4,9,0.92036585147042,-9.30662764773337,31,31,0,2
92362,9to4,9,4,0.982329336361777,-6.99428170474855,33,33,0,3
92377,4to9,4,9,0.92036585147042,-9.30662764773337,32,32,0,2
92392,9to4,9,4,0.982329336361777,-6.99428170474855,30,30,0,3
92406,4to9,4,9,0.92036585147042,-9.30662764773337,29,29,0,2
92421,9to4,9,4,0.982329336361777,-6.99428170474855,29,29,0,3
92438,4to9,4,9,0.92036585147042,-9.30662764773337,32,32,0,2
92455,9to14,9,14,0.000775950491976,-14.1378748897887,2508,2508,0,3
92471,14to13,14,13,0.077846062188709,-7.60263356251491,2445,2445,0,3
92487,13to8,13,8,0.867843585825836,-7.37455157477482,221,221,0,4
92502,8to3,8,3,0.225519798251787,-4.11464622477799,220,220,0,4
92518,3to4,3,4,0.976251597692276,-3.99285301446634,97,97,0,3
92534,4to9,4,9,0.92036585147042,-9.30662764773337,96,96,0,2
92551,9to4,9,4,0.982329336361777,-6.99428170474855,33,33,0,3
92565,4to9,4,9,0.92036585147042,-9.30662764773337,31,31,0,2
92582,9to4,9,4,0.982329336361777,-6.99428170474855,31,31,0,3
92597,4to9,4,9,0.92036585147042,-9.30662764773337,32,32,0,2
92613,9to4,9,4,0.982329336361777,-6.99428170474855,31,31,0,3
92628,4to9,4,9,0.92036585147042,-9.30662764773337,31,31,0,2
92643,9to4,9,4,0.982329336361777,-6.99428170474855,30,30,0,3
92658,4to9,4,9,0.92036585147042,-9.30662764773337,30,30,0,2
92675,9to4,9,4,0.982329336361777,-6.99428170474855,32,32,0,3
92691,4to9,4,9,0.92036585147042,-9.30662764773337,33,33,0,2
92707,9to4,9,4,0.982329336361777,-6.99428170474855,32,32,0,3
92722,4to3,4,3,0.07963414852958,-11.7539559008873,220,220,0,2
92737,3to4,3,4,0.976251597692276,-3.99285301446634,30,30,0,3
92753,4to9,4,9,0.92036585147042,-9.30662764773337,62,62,0,2
92769,9to4,9,4,0.982329336361777,-6.99428170474855,32,32,0,3
92785,4to9,4,9,0.92036585147042,-9.30662764773337,32,32,0,2
92800,9to4,9,4,0.982329336361777,-6.99428170474855,31,31,0,3
92817,4to9,4,9,0.92036585147042,-9.30662764773337,32,32,0,2
92834,9to4,9,4,0.982329336361777,-6.99428170474855,34,34,0,3
92851,4to9,4,9,0.92036585147042,-9.30662764773337,34,34,0,2
92867,9to4,9,4,0.982329336361777,-6.99428170474855,33,33,0,3
92884,4to9,4,9,0.92036585147042,-9.30662764773337,33,33,0,2
92898,9to4,9,4,0.982329336361777,-6.99428170474855,31,31,0,3
92914,4to3,4,3,0.07963414852958,-11.7539559008873,192,192,0,2
92930,3to4,3,4,0.976251597692276,-3.99285301446634,32,32,0,3
92947,4to9,4,9,0.92036585147042,-9.30662764773337,63,63,0,2
92962,9to4,9,4,0.982329336361777,-6.99428170474855,32,32,0,3
92977,4to9,4,9,0.92036585147042,-9.30662764773337,30,30,0,2
92992,9to4,9,4,0.982329336361777,-6.99428170474855,30,30,0,3
93008,4to9,4,9,0.92036585147042,-9.30662764773337,31,31,0,2
93023,9to4,9,4,0.982329336361777,-6.99428170474855,31,31,0,3
93039,4to9,4,9,0.92036585147042,-9.30662764773337,31,31,0,2
93055,9to4,9,4,0.982329336361777,-6.99428170474855,32,32,0,3
93071,4to9,4,9,0.92036585147042,-9.30662764773337,32,32,0,2
93087,9to4,9,4,0.982329336361777,-6.99428170474855,32,32,0,3
93103,4to9,4,9,0.92036585147042,-9.30662764773337,32,32,0,2
93119,9to4,9,4,0.982329336361777,-6.99428170474855,32,32,0,3
93136,4to3,4,3,0.07963414852958,-11.7539559008873,222,222,0,2
93150,3to4,3,4,0.976251597692276,-3.99285301446634,31,31,0,3
93167,4to9,4,9,0.92036585147042,-9.30662764773337,64,64,0,2
93182,9to4,9,4,0.982329336361777,-6.99428170474855,32,32,0,3
93199,4to9,4,9,0.92036585147042,-9.30662764773337,32,32,0,2
93215,9to4,9,4,0.982329336361777,-6.99428170474855,33,33,0,3
93230,4to9,4,9,0.92036585147042,-9.30662764773337,31,31,0,2
93244,9to4,9,4,0.982329336361777,-6.99428170474855,29,29,0,3
93259,4to9,4,9,0.92036585147042,-9.30662764773337,29,29,0,2
93274,9to4,9,4,0.982329336361777,-6.99428170474855,30,30,0,3
93290,4to9,4,9,0.92036585147042,-9.30662764773337,31,31,0,2
93307,9to4,9,4,0.982329336361777,-6.99428170474855,33,33,0,3
93324,4to9,4,9,0.92036585147042,-9.30662764773337,34,34,0,2
93339,9to4,9,4,0.982329336361777,-6.99428170474855,32,32,0,3
93354,4to3,4,3,0.07963414852958,-11.7539559008873,218,218,0,2
93369,3to2,3,2,0.001980621349595,-10.193162743775,3194,3194,0,3
93384,2to7,2,7,0.003665816475469,-9.30840515363262,4366,4366,0,3
93399,7to8,7,8,0.855108372325079,-2.39620659892225,912,912,0,4
93414,8to9,8,9,0.763990115179857,-2.89449932615566,90,90,0,4
93430,9to4,9,4,0.982329336361777,-6.99428170474855,91,91,0,3
93445,4to9,4,9,0.92036585147042,-9.30662764773337,31,31,0,2
93460,9to4,9,4,0.982329336361777,-6.99428170474855,30,30,0,3
93476,4to9,4,9,0.92036585147042,-9.30662764773337,31,31,0,2
93491,9to4,9,4,0.982329336361777,-6.99428170474855,31,31,0,3
93508,4to9,4,9,0.92036585147042,-9.30662764773337,32,32,0,2
93522,9to4,9,4,0.982329336361777,-6.99428170474855,31,31,0,3
93538,4to3,4,3,0.07963414852958,-11.7539559008873,184,184,0,2
93554,3to4,3,4,0.976251597692276,-3.99285301446634,32,32,0,3
93570,4to9,4,9,0.92036585147042,-9.30662764773337,62,62,0,2
93585,9to4,9,4,0.982329336361777,-6.99428170474855,31,31,0,3
93601,4to9,4,9,0.92036585147042,-9.30662764773337,31,31,0,2
93618,9to4,9,4,0.982329336361777,-6.99428170474855,33,33,0,3
93634,4to9,4,9,0.92036585147042,-9.30662764773337,33,33,0,2
93649,9to4,9,4,0.982329336361777,-6.99428170474855,31,31,0,3
93666,4to9,4,9,0.92036585147042,-9.30662764773337,32,32,0,2
93683,9to4,9,4,0.982329336361777,-6.99428170474855,34,34,0,3
93698,4to3,4,3,0.07963414852958,-11.7539559008873,160,160,0,2
93713,3to4,3,4,0.976251597692276,-3.99285301446634,30,30,0,3
93729,4to9,4,9,0.92036585147042,-9.30662764773337,63,63,0,2
93745,9to4,9,4,0.982329336361777,-6.99428170474855,32,32,0,3
93762,4to9,4,9,0.92036585147042,-9.30662764773337,33,33,0,2
93779,9to4,9,4,0.982329336361777,-6.99428170474855,34,34,0,3
93795,4to9,4,9,0.92036585147042,-9.30662764773337,33,33,0,2
93809,9to4,9,4,0.982329336361777,-6.99428170474855,30,30,0,3
93824,4to9,4,9,0.92036585147042,-9.30662764773337,29,29,0,2
93839,9to4,9,4,0.982329336361777,-6.99428170474855,30,30,0,3
93853,4to9,4,9,0.92036585147042,-9.30662764773337,29,29,0,2
93869,9to4,9,4,0.982329336361777,-6.99428170474855,30,30,0,3
93887,4to9,4,9,0.92036585147042,-9.30662764773337,34,34,0,2
93902,9to4,9,4,0.982329336361777,-6.99428170474855,33,33,0,3
93917,4to3,4,3,0.07963414852958,-11.7539559008873,219,219,0,2
93933,3to4,3,4,0.976251597692276,-3.99285301446634,31,31,0,3
93949,4to9,4,9,0.92036585147042,-9.30662764773337,62,62,0,2
93965,9to4,9,4,0.982329336361777,-6.99428170474855,32,32,0,3
93980,4to9,4,9,0.92036585147042,-9.30662764773337,31,31,0,2
93996,9to4,9,4,0.982329336361777,-6.99428170474855,31,31,0,3
94011,4to9,4,9,0.92036585147042,-9.30662764773337,31,31,0,2
94026,9to4,9,4,0.982329336361777,-6.99428170474855,30,30,0,3
94041,4to9,4,9,0.92036585147042,-9.30662764773337,30,30,0,2
94057,9to4,9,4,0.982329336361777,-6.99428170474855,31,31,0,3
94074,4to9,4,9,0.92036585147042,-9.30662764773337,33,33,0,2
94090,9to14,9,14,0.000775950491976,-14.1378748897887,1635,1635,0,3
94105,14to13,14,13,0.077846062188709,-7.60263356251491,1634,1634,0,3
94122,13to8,13,8,0.867843585825836,-7.37455157477482,723,723,0,4
94138,8to3,8,3,0.225519798251787,-4.11464622477799,221,221,0,4
94155,3to8,3,8,0.021767780958129,-7.79614241331218,33,33,0,3
94172,8to9,8,9,0.763990115179857,-2.89449932615566,98,98,0,4
94187,9to4,9,4,0.982329336361777,-6.99428170474855,130,130,0,3
94204,4to9,4,9,0.92036585147042,-9.30662764773337,32,32,0,2
94220,9to4,9,4,0.982329336361777,-6.99428170474855,33,33,0,3
94236,4to9,4,9,0.92036585147042,-9.30662764773337,32,32,0,2
94252,9to4,9,4,0.982329336361777,-6.99428170474855,32,32,0,3
94267,4to9,4,9,0.92036585147042,-9.30662764773337,31,31,0,2
94282,9to4,9,4,0.982329336361777,-6.99428170474855,30,30,0,3
94298,4to9,4,9,0.92036585147042,-9.30662764773337,31,31,0,2
94314,9to4,9,4,0.982329336361777,-6.99428170474855,32,32,0,3
94329,4to9,4,9,0.92036585147042,-9.30662764773337,31,31,0,2
94346,9to4,9,4,0.982329336361777,-6.99428170474855,32,32,0,3
94360,4to3,4,3,0.07963414852958,-11.7539559008873,222,222,0,2
94375,3to4,3,4,0.976251597692276,-3.99285301446634,29,29,0,3
94391,4to9,4,9,0.92036585147042,-9.30662764773337,62,62,0,2
94406,9to4,9,4,0.982329336361777,-6.99428170474855,31,31,0,3
94422,4to9,4,9,0.92036585147042,-9.30662764773337,31,31,0,2
94437,9to4,9,4,0.982329336361777,-6.99428170474855,31,31,0,3
94452,4to3,4,3,0.07963414852958,-11.7539559008873,92,92,0,2
94469,3to4,3,4,0.976251597692276,-3.99285301446634,32,32,0,3
94487,4to9,4,9,0.92036585147042,-9.30662764773337,65,65,0,2
94502,9to4,9,4,0.982329336361777,-6.99428170474855,33,33,0,3
94517,4to9,4,9,0.92036585147042,-9.30662764773337,30,30,0,2
94531,9to4,9,4,0.982329336361777,-6.99428170474855,29,29,0,3
94546,4to9,4,9,0.92036585147042,-9.30662764773337,29,29,0,2
94562,9to4,9,4,0.982329336361777,-6.99428170474855,31,31,0,3
94580,4to9,4,9,0.92036585147042,-9.30662764773337,34,34,0,2
94595,9to4,9,4,0.982329336361777,-6.99428170474855,33,33,0,3
94611,4to9,4,9,0.92036585147042,-9.30662764773337,31,31,0,2
94626,9to4,9,4,0.982329336361777,-6.99428170474855,31,31,0,3
94643,4to3,4,3,0.07963414852958,-11.7539559008873,191,191,0,2
94658,3to4,3,4,0.976251597692276,-3.99285301446634,32,32,0,3
94674,4to9,4,9,0.92036585147042,-9.30662764773337,63,63,0,2
94689,9to4,9,4,0.982329336361777,-6.99428170474855,31,31,0,3
94706,4to9,4,9,0.92036585147042,-9.30662764773337,32,32,0,2
94721,9to4,9,4,0.982329336361777,-6.99428170474855,32,32,0,3
94737,4to9,4,9,0.92036585147042,-9.30662764773337,31,31,0,2
94753,9to4,9,4,0.982329336361777,-6.99428170474855,32,32,0,3
94770,4to9,4,9,0.92036585147042,-9.30662764773337,33,33,0,2
94786,9to4,9,4,0.982329336361777,-6.99428170474855,33,33,0,3
94802,4to9,4,9,0.92036585147042,-9.30662764773337,32,32,0,2
94818,9to4,9,4,0.982329336361777,-6.99428170474855,32,32,0,3
94833,4to9,4,9,0.92036585147042,-9.30662764773337,31,31,0,2
94850,9to4,9,4,0.982329336361777,-6.99428170474855,32,32,0,3
94866,4to3,4,3,0.07963414852958,-11.7539559008873,223,223,0,2
94882,3to4,3,4,0.976251597692276,-3.99285301446634,32,32,0,3
94898,4to9,4,9,0.92036585147042,-9.30662764773337,65,65,0,2
94914,9to4,9,4,0.982329336361777,-6.99428170474855,32,32,0,3
94930,4to9,4,9,0.92036585147042,-9.30662764773337,32,32,0,2
94945,9to4,9,4,0.982329336361777,-6.99428170474855,31,31,0,3
94961,4to9,4,9,0.92036585147042,-9.30662764773337,31,31,0,2
94978,9to4,9,4,0.982329336361777,-6.99428170474855,33,33,0,3
94993,4to9,4,9,0.92036585147042,-9.30662764773337,32,32,0,2
95009,9to14,9,14,0.000775950491976,-14.1378748897887,919,919,0,3
95026,14to13,14,13,0.077846062188709,-7.60263356251491,921,921,0,3
95042,13to8,13,8,0.867843585825836,-7.37455157477482,887,887,0,4
95060,8to3,8,3,0.225519798251787,-4.11464622477799,194,194,0,4
95077,3to4,3,4,0.976251597692276,-3.99285301446634,99,99,0,3
95094,4to9,4,9,0.92036585147042,-9.30662764773337,101,101,0,2
95109,9to4,9,4,0.982329336361777,-6.99428170474855,32,32,0,3
95125,4to9,4,9,0.92036585147042,-9.30662764773337,31,31,0,2
95141,9to4,9,4,0.982329336361777,-6.99428170474855,32,32,0,3
95156,4to9,4,9,0.92036585147042,-9.30662764773337,31,31,0,2
95170,9to4,9,4,0.982329336361777,-6.99428170474855,29,29,0,3
95185,4to9,4,9,0.92036585147042,-9.30662764773337,29,29,0,2
95201,9to4,9,4,0.982329336361777,-6.99428170474855,31,31,0,3
95215,4to9,4,9,0.92036585147042,-9.30662764773337,30,30,0,2
95231,9to4,9,4,0.982329336361777,-6.99428170474855,30,30,0,3
95247,4to9,4,9,0.92036585147042,-9.30662764773337,32,32,0,2
95265,9to4,9,4,0.982329336361777,-6.99428170474855,34,34,0,3
95280,4to9,4,9,0.92036585147042,-9.30662764773337,33,33,0,2
95296,9to4,9,4,0.982329336361777,-6.99428170474855,31,31,0,3
95311,4to3,4,3,0.07963414852958,-11.7539559008873,251,251,0,2
95326,3to4,3,4,0.976251597692276,-3.99285301446634,30,30,0,3
95342,4to9,4,9,0.92036585147042,-9.30662764773337,62,62,0,2
95357,9to4,9,4,0.982329336361777,-6.99428170474855,31,31,0,3
95374,4to9,4,9,0.92036585147042,-9.30662764773337,32,32,0,2
95389,9to4,9,4,0.982329336361777,-6.99428170474855,32,32,0,3
95405,4to9,4,9,0.92036585147042,-9.30662764773337,31,31,0,2
95423,9to4,9,4,0.982329336361777,-6.99428170474855,34,34,0,3
95437,4to9,4,9,0.92036585147042,-9.30662764773337,32,32,0,2
95452,9to4,9,4,0.982329336361777,-6.99428170474855,29,29,0,3
95468,4to9,4,9,0.92036585147042,-9.30662764773337,31,31,0,2
95484,9to4,9,4,0.982329336361777,-6.99428170474855,32,32,0,3
95501,4to9,4,9,0.92036585147042,-9.30662764773337,33,33,0,2
95516,9to4,9,4,0.982329336361777,-6.99428170474855,32,32,0,3
95532,4to3,4,3,0.07963414852958,-11.7539559008873,221,221,0,2
95547,3to4,3,4,0.976251597692276,-3.99285301446634,31,31,0,3
95563,4to9,4,9,0.92036585147042,-9.30662764773337,62,62,0,2
95578,9to4,9,4,0.982329336361777,-6.99428170474855,31,31,0,3
95594,4to9,4,9,0.92036585147042,-9.30662764773337,31,31,0,2
95609,9to4,9,4,0.982329336361777,-6.99428170474855,31,31,0,3
95625,4to9,4,9,0.92036585147042,-9.30662764773337,31,31,0,2
95639,9to4,9,4,0.982329336361777,-6.99428170474855,30,30,0,3
95655,4to9,4,9,0.92036585147042,-9.30662764773337,30,30,0,2
95670,9to4,9,4,0.982329336361777,-6.99428170474855,31,31,0,3
95686,4to9,4,9,0.92036585147042,-9.30662764773337,31,31,0,2
95701,9to4,9,4,0.982329336361777,-6.99428170474855,31,31,0,3
95716,4to9,4,9,0.92036585147042,-9.30662764773337,30,30,0,2
95733,9to4,9,4,0.982329336361777,-6.99428170474855,32,32,0,3
95747,4to3,4,3,0.07963414852958,-11.7539559008873,215,215,0,2
95762,3to8,3,8,0.021767780958129,-7.79614241331218,720,720,0,3
95779,8to7,8,7,0.002351460128865,-8.67801771035069,2395,2395,0,4
95794,7to12,7,12,0.068525656203016,-4.92022659283001,5752,5752,0,4
95808,12to13,12,13,0.97582840866556,-5.77169154969565,782,782,0,4
95823,13to8,13,8,0.867843585825836,-7.37455157477482,61,61,0,4
95839,8to9,8,9,0.763990115179857,-2.89449932615566,123,123,0,4
95857,9to4,9,4,0.982329336361777,-6.99428170474855,124,124,0,3
95873,4to9,4,9,0.92036585147042,-9.30662764773337,34,34,0,2
95889,9to4,9,4,0.982329336361777,-6.99428170474855,32,32,0,3
95905,4to9,4,9,0.92036585147042,-9.30662764773337,32,32,0,2
95920,9to4,9,4,0.982329336361777,-6.99428170474855,31,31,0,3
95934,4to9,4,9,0.92036585147042,-9.30662764773337,29,29,0,2
95949,9to4,9,4,0.982329336361777,-6.99428170474855,29,29,0,3
95965,4to3,4,3,0.07963414852958,-11.7539559008873,218,218,0,2
95980,3to4,3,4,0.976251597692276,-3.99285301446634,31,31,0,3
95995,4to9,4,9,0.92036585147042,-9.30662764773337,61,61,0,2
96011,9to4,9,4,0.982329336361777,-6.99428170474855,31,31,0,3
96028,4to9,4,9,0.92036585147042,-9.30662764773337,33,33,0,2
96043,9to4,9,4,0.982329336361777,-6.99428170474855,32,32,0,3
96058,4to9,4,9,0.92036585147042,-9.30662764773337,30,30,0,2
96073,9to4,9,4,0.982329336361777,-6.99428170474855,30,30,0,3
96089,4to3,4,3,0.07963414852958,-11.7539559008873,124,124,0,2
96104,3to4,3,4,0.976251597692276,-3.99285301446634,31,31,0,3
96119,4to9,4,9,0.92036585147042,-9.30662764773337,61,61,0,2
96135,9to4,9,4,0.982329336361777,-6.99428170474855,31,31,0,3
96151,4to3,4,3,0.07963414852958,-11.7539559008873,62,62,0,2
96167,3to4,3,4,0.976251597692276,-3.99285301446634,32,32,0,3
96183,4to9,4,9,0.92036585147042,-9.30662764773337,64,64,0,2
96200,9to4,9,4,0.982329336361777,-6.99428170474855,33,33,0,3
96216,4to9,4,9,0.92036585147042,-9.30662764773337,33,33,0,2
96231,9to4,9,4,0.982329336361777,-6.99428170474855,31,31,0,3
96247,4to9,4,9,0.92036585147042,-9.30662764773337,31,31,0,2
96261,9to4,9,4,0.982329336361777,-6.99428170474855,30,30,0,3
96278,4to9,4,9,0.92036585147042,-9.30662764773337,31,31,0,2
96293,9to4,9,4,0.982329336361777,-6.99428170474855,32,32,0,3
96307,4to9,4,9,0.92036585147042,-9.30662764773337,29,29,0,2
96322,9to4,9,4,0.982329336361777,-6.99428170474855,29,29,0,3
96338,4to3,4,3,0.07963414852958,-11.7539559008873,187,187,0,2
96353,3to4,3,4,0.976251597692276,-3.99285301446634,31,31,0,3
96368,4to9,4,9,0.92036585147042,-9.30662764773337,61,61,0,2
96385,9to4,9,4,0.982329336361777,-6.99428170474855,32,32,0,3
96402,4to9,4,9,0.92036585147042,-9.30662764773337,34,34,0,2
96419,9to4,9,4,0.982329336361777,-6.99428170474855,34,34,0,3
96435,4to9,4,9,0.92036585147042,-9.30662764773337,33,33,0,2
96451,9to4,9,4,0.982329336361777,-6.99428170474855,32,32,0,3
96467,4to9,4,9,0.92036585147042,-9.30662764773337,32,32,0,2
96482,9to4,9,4,0.982329336361777,-6.99428170474855,31,31,0,3
96496,4to9,4,9,0.92036585147042,-9.30662764773337,29,29,0,2
96511,9to4,9,4,0.982329336361777,-6.99428170474855,29,29,0,3
96525,4to9,4,9,0.92036585147042,-9.30662764773337,29,29,0,2
96541,9to4,9,4,0.982329336361777,-6.99428170474855,30,30,0,3
96558,4to3,4,3,0.07963414852958,-11.7539559008873,220,220,0,2
96573,3to4,3,4,0.976251597692276,-3.99285301446634,32,32,0,3
96589,4to9,4,9,0.92036585147042,-9.30662764773337,64,64,0,2
96604,9to4,9,4,0.982329336361777,-6.99428170474855,31,31,0,3
96620,4to9,4,9,0.92036585147042,-9.30662764773337,31,31,0,2
96636,9to4,9,4,0.982329336361777,-6.99428170474855,32,32,0,3
96651,4to9,4,9,0.92036585147042,-9.30662764773337,31,31,0,2
96667,9to4,9,4,0.982329336361777,-6.99428170474855,31,31,0,3
96683,4to9,4,9,0.92036585147042,-9.30662764773337,32,32,0,2
96699,9to4,9,4,0.982329336361777,-6.99428170474855,32,32,0,3
96715,4to9,4,9,0.92036585147042,-9.30662764773337,32,32,0,2
96730,9to4,9,4,0.982329336361777,-6.99428170474855,31,31,0,3
96746,4to9,4,9,0.92036585147042,-9.30662764773337,31,31,0,2
96761,9to4,9,4,0.982329336361777,-6.99428170474855,31,31,0,3
96776,4to3,4,3,0.07963414852958,-11.7539559008873,218,218,0,2
96792,3to8,3,8,0.021767780958129,-7.79614241331218,969,969,0,3
96808,8to9,8,9,0.763990115179857,-2.89449932615566,62,62,0,4
96823,9to4,9,4,0.982329336361777,-6.99428170474855,62,62,0,3
96839,4to9,4,9,0.92036585147042,-9.30662764773337,31,31,0,2
96854,9to4,9,4,0.982329336361777,-6.99428170474855,31,31,0,3
96870,4to9,4,9,0.92036585147042,-9.30662764773337,31,31,0,2
96886,9to4,9,4,0.982329336361777,-6.99428170474855,32,32,0,3
96902,4to9,4,9,0.92036585147042,-9.30662764773337,32,32,0,2
96919,9to4,9,4,0.982329336361777,-6.99428170474855,33,33,0,3
96934,4to9,4,9,0.92036585147042,-9.30662764773337,32,32,0,2
96950,9to4,9,4,0.982329336361777,-6.99428170474855,31,31,0,3
96966,4to9,4,9,0.92036585147042,-9.30662764773337,32,32,0,2
96982,9to4,9,4,0.982329336361777,-6.99428170474855,32,32,0,3
96998,4to3,4,3,0.07963414852958,-11.7539559008873,222,222,0,2
97015,3to4,3,4,0.976251597692276,-3.99285301446634,33,33,0,3
97031,4to9,4,9,0.92036585147042,-9.30662764773337,65,65,0,2
97047,9to4,9,4,0.982329336361777,-6.99428170474855,32,32,0,3
97064,4to9,4,9,0.92036585147042,-9.30662764773337,33,33,0,2
97080,9to4,9,4,0.982329336361777,-6.99428170474855,33,33,0,3
97095,4to9,4,9,0.92036585147042,-9.30662764773337,31,31,0,2
97111,9to4,9,4,0.982329336361777,-6.99428170474855,31,31,0,3
97128,4to9,4,9,0.92036585147042,-9.30662764773337,33,33,0,2
97145,9to4,9,4,0.982329336361777,-6.99428170474855,34,34,0,3
97162,4to9,4,9,0.92036585147042,-9.30662764773337,34,34,0,2
97177,9to4,9,4,0.982329336361777,-6.99428170474855,32,32,0,3
97193,4to9,4,9,0.92036585147042,-9.30662764773337,31,31,0,2
97209,9to4,9,4,0.982329336361777,-6.99428170474855,32,32,0,3
97227,4to3,4,3,0.07963414852958,-11.7539559008873,229,229,0,2
97243,3to4,3,4,0.976251597692276,-3.99285301446634,34,34,0,3
97259,4to9,4,9,0.92036585147042,-9.30662764773337,66,66,0,2
97274,9to4,9,4,0.982329336361777,-6.99428170474855,31,31,0,3
97290,4to9,4,9,0.92036585147042,-9.30662764773337,31,31,0,2
97306,9to4,9,4,0.982329336361777,-6.99428170474855,32,32,0,3
97323,4to9,4,9,0.92036585147042,-9.30662764773337,33,33,0,2
97337,9to4,9,4,0.982329336361777,-6.99428170474855,31,31,0,3
97354,4to9,4,9,0.92036585147042,-9.30662764773337,31,31,0,2
97370,9to4,9,4,0.982329336361777,-6.99428170474855,33,33,0,3
97386,4to9,4,9,0.92036585147042,-9.30662764773337,32,32,0,2
97403,9to4,9,4,0.982329336361777,-6.99428170474855,33,33,0,3
97418,4to9,4,9,0.92036585147042,-9.30662764773337,32,32,0,2
97433,9to4,9,4,0.982329336361777,-6.99428170474855,30,30,0,3
97447,4to3,4,3,0.07963414852958,-11.7539559008873,220,220,0,2
97463,3to8,3,8,0.021767780958129,-7.79614241331218,671,671,0,3
97479,8to9,8,9,0.763990115179857,-2.89449932615566,61,61,0,4
97495,9to4,9,4,0.982329336361777,-6.99428170474855,62,62,0,3
97510,4to9,4,9,0.92036585147042,-9.30662764773337,31,31,0,2
97526,9to4,9,4,0.982329336361777,-6.99428170474855,31,31,0,3
97542,4to9,4,9,0.92036585147042,-9.30662764773337,32,32,0,2
97558,9to4,9,4,0.982329336361777,-6.99428170474855,32,32,0,3
97574,4to9,4,9,0.92036585147042,-9.30662764773337,32,32,0,2
97590,9to4,9,4,0.982329336361777,-6.99428170474855,32,32,0,3
97605,4to9,4,9,0.92036585147042,-9.30662764773337,31,31,0,2
97620,9to4,9,4,0.982329336361777,-6.99428170474855,30,30,0,3
97636,4to9,4,9,0.92036585147042,-9.30662764773337,31,31,0,2
97653,9to14,9,14,0.000775950491976,-14.1378748897887,2644,2644,0,3
97669,14to13,14,13,0.036089982389885,-8.4156373239335,1861,348,1513,3
97685,13to8,13,8,0.867843585825836,-7.37455157477482,222,222,0,4
97702,8to7,8,7,0.002351460128865,-8.67801771035069,1923,1923,0,4
97718,7to2,7,2,0.068354324718024,-4.92272997679187,4349,4349,0,4
97733,2to3,2,3,0.995300351194049,-3.70441168844569,286,286,0,3
97749,3to4,3,4,0.976251597692276,-3.99285301446634,129,129,0,3
97765,4to9,4,9,0.92036585147042,-9.30662764773337,129,129,0,2
97782,9to4,9,4,0.982329336361777,-6.99428170474855,33,33,0,3
97799,4to9,4,9,0.92036585147042,-9.30662764773337,34,34,0,2
97814,9to4,9,4,0.982329336361777,-6.99428170474855,32,32,0,3
97830,4to9,4,9,0.92036585147042,-9.30662764773337,31,31,0,2
97847,9to4,9,4,0.982329336361777,-6.99428170474855,33,33,0,3
97862,4to9,4,9,0.92036585147042,-9.30662764773337,32,32,0,2
97878,9to4,9,4,0.982329336361777,-6.99428170474855,31,31,0,3
97895,4to9,4,9,0.92036585147042,-9.30662764773337,33,33,0,2
97911,9to4,9,4,0.982329336361777,-6.99428170474855,33,33,0,3
97926,4to9,4,9,0.92036585147042,-9.30662764773337,31,31,0,2
97940,9to4,9,4,0.982329336361777,-6.99428170474855,29,29,0,3
97955,4to3,4,3,0.07963414852958,-11.7539559008873,222,222,0,2
97970,3to4,3,4,0.976251597692276,-3.99285301446634,30,30,0,3
97986,4to9,4,9,0.92036585147042,-9.30662764773337,60,60,0,2
98002,9to4,9,4,0.982329336361777,-6.99428170474855,32,32,0,3
98017,4to9,4,9,0.92036585147042,-9.30662764773337,31,31,0,2
98033,9to4,9,4,0.982329336361777,-6.99428170474855,31,31,0,3
98049,4to9,4,9,0.92036585147042,-9.30662764773337,32,32,0,2
98064,9to4,9,4,0.982329336361777,-6.99428170474855,31,31,0,3
98081,4to9,4,9,0.92036585147042,-9.30662764773337,32,32,0,2
98097,9to4,9,4,0.982329336361777,-6.99428170474855,33,33,0,3
98113,4to9,4,9,0.92036585147042,-9.30662764773337,32,32,0,2
98128,9to4,9,4,0.982329336361777,-6.99428170474855,31,31,0,3
98144,4to9,4,9,0.92036585147042,-9.30662764773337,31,31,0,2
98160,9to4,9,4,0.982329336361777,-6.99428170474855,32,32,0,3
98177,4to3,4,3,0.07963414852958,-11.7539559008873,222,222,0,2
98193,3to4,3,4,0.976251597692276,-3.99285301446634,33,33,0,3
98208,4to3,4,3,0.07963414852958,-11.7539559008873,31,31,0,2
98223,3to4,3,4,0.976251597692276,-3.99285301446634,30,30,0,3
98239,4to9,4,9,0.92036585147042,-9.30662764773337,95,95,0,2
98254,9to4,9,4,0.982329336361777,-6.99428170474855,31,31,0,3
98268,4to9,4,9,0.92036585147042,-9.30662764773337,29,29,0,2
98283,9to4,9,4,0.982329336361777,-6.99428170474855,29,29,0,3
98298,4to9,4,9,0.92036585147042,-9.30662764773337,30,30,0,2
98314,9to4,9,4,0.982329336361777,-6.99428170474855,31,31,0,3
98329,4to9,4,9,0.92036585147042,-9.30662764773337,31,31,0,2
98344,9to4,9,4,0.982329336361777,-6.99428170474855,30,30,0,3
98359,4to9,4,9,0.92036585147042,-9.30662764773337,30,30,0,2
98374,9to4,9,4,0.982329336361777,-6.99428170474855,30,30,0,3
98390,4to9,4,9,0.92036585147042,-9.30662764773337,31,31,0,2
98407,9to4,9,4,0.982329336361777,-6.99428170474855,33,33,0,3
98423,4to3,4,3,0.07963414852958,-11.7539559008873,215,215,0,2
98440,3to8,3,8,0.021767780958129,-7.79614241331218,755,755,0,3
98454,8to9,8,9,0.763990115179857,-2.89449932615566,64,64,0,4
98471,9to4,9,4,0.982329336361777,-6.99428170474855,64,64,0,3
98486,4to9,4,9,0.92036585147042,-9.30662764773337,32,32,0,2
98501,9to4,9,4,0.982329336361777,-6.99428170474855,30,30,0,3
98518,4to9,4,9,0.92036585147042,-9.30662764773337,32,32,0,2
98535,9to4,9,4,0.982329336361777,-6.99428170474855,34,34,0,3
98551,4to9,4,9,0.92036585147042,-9.30662764773337,33,33,0,2
98567,9to4,9,4,0.982329336361777,-6.99428170474855,32,32,0,3
98582,4to3,4,3,0.07963414852958,-11.7539559008873,159,159,0,2
98597,3to4,3,4,0.976251597692276,-3.99285301446634,30,30,0,3
98614,4to9,4,9,0.92036585147042,-9.30662764773337,63,63,0,2
98630,9to4,9,4,0.982329336361777,-6.99428170474855,33,33,0,3
98646,4to9,4,9,0.92036585147042,-9.30662764773337,32,32,0,2
98662,9to4,9,4,0.982329336361777,-6.99428170474855,32,32,0,3
98678,4to9,4,9,0.92036585147042,-9.30662764773337,32,32,0,2
98694,9to4,9,4,0.982329336361777,-6.99428170474855,32,32,0,3
98710,4to3,4,3,0.07963414852958,-11.7539559008873,128,128,0,2
98727,3to4,3,4,0.976251597692276,-3.99285301446634,33,33,0,3
98742,4to9,4,9,0.92036585147042,-9.30662764773337,64,64,0,2
98759,9to4,9,4,0.982329336361777,-6.99428170474855,32,32,0,3
98776,4to9,4,9,0.92036585147042,-9.30662764773337,34,34,0,2
98792,9to4,9,4,0.982329336361777,-6.99428170474855,33,33,0,3
98807,4to9,4,9,0.92036585147042,-9.30662764773337,31,31,0,2
98822,9to4,9,4,0.982329336361777,-6.99428170474855,30,30,0,3
98836,4to9,4,9,0.92036585147042,-9.30662764773337,29,29,0,2
98854,9to4,9,4,0.982329336361777,-6.99428170474855,32,32,0,3
98870,4to9,4,9,0.92036585147042,-9.30662764773337,34,34,0,2
98886,9to4,9,4,0.982329336361777,-6.99428170474855,32,32,0,3
98902,4to9,4,9,0.92036585147042,-9.30662764773337,32,32,0,2
98917,9to4,9,4,0.982329336361777,-6.99428170474855,31,31,0,3
98932,4to3,4,3,0.07963414852958,-11.7539559008873,222,222,0,2
98947,3to4,3,4,0.976251597692276,-3.99285301446634,30,30,0,3
98962,4to9,4,9,0.92036585147042,-9.30662764773337,60,60,0,2
98977,9to4,9,4,0.982329336361777,-6.99428170474855,30,30,0,3
98992,4to9,4,9,0.92036585147042,-9.30662764773337,30,30,0,2
99009,9to4,9,4,0.982329336361777,-6.99428170474855,32,32,0,3
99024,4to9,4,9,0.92036585147042,-9.30662764773337,32,32,0,2
99040,9to4,9,4,0.982329336361777,-6.99428170474855,31,31,0,3
99056,4to9,4,9,0.92036585147042,-9.30662764773337,32,32,0,2
99070,9to4,9,4,0.982329336361777,-6.99428170474855,30,30,0,3
99086,4to9,4,9,0.92036585147042,-9.30662764773337,30,30,0,2
99101,9to4,9,4,0.982329336361777,-6.99428170474855,31,31,0,3
99117,4to9,4,9,0.92036585147042,-9.30662764773337,31,31,0,2
99132,9to4,9,4,0.982329336361777,-6.99428170474855,31,31,0,3
99147,4to3,4,3,0.07963414852958,-11.7539559008873,215,215,0,2
99163,3to8,3,8,0.021767780958129,-7.79614241331218,723,723,0,3
99179,8to9,8,9,0.763990115179857,-2.89449932615566,62,62,0,4
99196,9to4,9,4,0.982329336361777,-6.99428170474855,64,64,0,3
99211,4to9,4,9,0.92036585147042,-9.30662764773337,32,32,0,2
99227,9to8,9,8,0.016894713146247,-11.0572075885512,64,64,0,3
99243,8to3,8,3,0.225519798251787,-4.11464622477799,96,96,0,4
99260,3to4,3,4,0.976251597692276,-3.99285301446634,64,64,0,3
99276,4to9,4,9,0.92036585147042,-9.30662764773337,65,65,0,2
99292,9to4,9,4,0.982329336361777,-6.99428170474855,32,32,0,3
99308,4to9,4,9,0.92036585147042,-9.30662764773337,32,32,0,2
99323,9to4,9,4,0.982329336361777,-6.99428170474855,31,31,0,3
99337,4to9,4,9,0.92036585147042,-9.30662764773337,29,29,0,2
99353,9to4,9,4,0.982329336361777,-6.99428170474855,30,30,0,3
99367,4to9,4,9,0.92036585147042,-9.30662764773337,30,30,0,2
99383,9to8,9,8,0.016894713146247,-11.0572075885512,156,156,0,3
99400,8to3,8,3,0.225519798251787,-4.11464622477799,157,157,0,4
99418,3to4,3,4,0.976251597692276,-3.99285301446634,65,65,0,3
99434,4to9,4,9,0.92036585147042,-9.30662764773337,67,67,0,2
99450,9to4,9,4,0.982329336361777,-6.99428170474855,32,32,0,3
99466,4to9,4,9,0.92036585147042,-9.30662764773337,32,32,0,2
99482,9to8,9,8,0.016894713146247,-11.0572075885512,99,99,0,3
99499,8to3,8,3,0.225519798251787,-4.11464622477799,99,99,0,4
99517,3to4,3,4,0.976251597692276,-3.99285301446634,67,67,0,3
99533,4to9,4,9,0.92036585147042,-9.30662764773337,67,67,0,2
99548,9to4,9,4,0.982329336361777,-6.99428170474855,31,31,0,3
99563,4to9,4,9,0.92036585147042,-9.30662764773337,30,30,0,2
99578,9to4,9,4,0.982329336361777,-6.99428170474855,30,30,0,3
99593,4to9,4,9,0.92036585147042,-9.30662764773337,30,30,0,2
99610,9to14,9,14,0.000775950491976,-14.1378748897887,1957,1957,0,3
99627,14to13,14,13,0.036089982389885,-8.4156373239335,1958,1958,0,3
99643,13to12,13,12,0.029730427180238,-10.7629356175037,3849,2307,1542,4
99659,12to7,12,7,0.019200381985876,-9.70004813592522,1957,1957,0,4
99674,7to8,7,8,0.855108372325079,-2.39620659892225,192,192,0,4
99690,8to9,8,9,0.763990115179857,-2.89449932615566,97,97,0,4
99707,9to4,9,4,0.982329336361777,-6.99428170474855,129,129,0,3
99723,4to3,4,3,0.07963414852958,-11.7539559008873,224,224,0,2
99737,3to4,3,4,0.976251597692276,-3.99285301446634,30,30,0,3
99753,4to9,4,9,0.92036585147042,-9.30662764773337,63,63,0,2
99770,9to4,9,4,0.982329336361777,-6.99428170474855,33,33,0,3
99786,4to9,4,9,0.92036585147042,-9.30662764773337,33,33,0,2
99802,9to4,9,4,0.982329336361777,-6.99428170474855,32,32,0,3
99817,4to9,4,9,0.92036585147042,-9.30662764773337,31,31,0,2
99834,9to4,9,4,0.982329336361777,-6.99428170474855,32,32,0,3
99851,4to9,4,9,0.92036585147042,-9.30662764773337,34,34,0,2
99865,9to4,9,4,0.982329336361777,-6.99428170474855,31,31,0,3
99882,4to9,4,9,0.92036585147042,-9.30662764773337,31,31,0,2
99897,9to4,9,4,0.982329336361777,-6.99428170474855,32,32,0,3
99913,4to3,4,3,0.07963414852958,-11.7539559008873,190,190,0,2
99929,3to4,3,4,0.976251597692276,-3.99285301446634,32,32,0,3
99944,4to9,4,9,0.92036585147042,-9.30662764773337,62,62,0,2
99959,9to4,9,4,0.982329336361777,-6.99428170474855,30,30,0,3
99974,4to9,4,9,0.92036585147042,-9.30662764773337,30,30,0,2
99991,9to4,9,4,0.982329336361777,-6.99428170474855,32,32,0,3
100007,4to9,4,9,0.92036585147042,-9.30662764773337,33,33,0,2
100022,9to4,9,4,0.982329336361777,-6.99428170474855,31,31,0,3
100037,4to9,4,9,0.92036585147042,-9.30662764773337,30,30,0,2
100051,9to4,9,4,0.982329336361777,-6.99428170474855,29,29,0,3
100068,4to9,4,9,0.92036585147042,-9.30662764773337,31,31,0,2
100084,9to4,9,4,0.982329336361777,-6.99428170474855,33,33,0,3
100100,4to9,4,9,0.92036585147042,-9.30662764773337,32,32,0,2
100116,9to4,9,4,0.982329336361777,-6.99428170474855,32,32,0,3
100131,4to3,4,3,0.07963414852958,-11.7539559008873,218,218,0,2
100146,3to4,3,4,0.976251597692276,-3.99285301446634,30,30,0,3
100161,4to9,4,9,0.92036585147042,-9.30662764773337,61,61,0,2
100178,9to4,9,4,0.982329336361777,-6.99428170474855,32,32,0,3
100193,4to9,4,9,0.92036585147042,-9.30662764773337,32,32,0,2
100209,9to4,9,4,0.982329336361777,-6.99428170474855,31,31,0,3
100225,4to9,4,9,0.92036585147042,-9.30662764773337,32,32,0,2
100240,9to4,9,4,0.982329336361777,-6.99428170474855,31,31,0,3
100256,4to9,4,9,0.92036585147042,-9.30662764773337,31,31,0,2
100271,9to4,9,4,0.982329336361777,-6.99428170474855,31,31,0,3
100287,4to9,4,9,0.92036585147042,-9.30662764773337,31,31,0,2
100302,9to4,9,4,0.982329336361777,-6.99428170474855,31,31,0,3
100317,4to3,4,3,0.07963414852958,-11.7539559008873,186,186,0,2
100331,3to4,3,4,0.976251597692276,-3.99285301446634,29,29,0,3
100348,4to9,4,9,0.92036585147042,-9.30662764773337,61,61,0,2
100363,9to4,9,4,0.982329336361777,-6.99428170474855,32,32,0,3
100378,4to9,4,9,0.92036585147042,-9.30662764773337,30,30,0,2
100392,9to4,9,4,0.982329336361777,-6.99428170474855,29,29,0,3
100409,4to9,4,9,0.92036585147042,-9.30662764773337,31,31,0,2
100424,9to4,9,4,0.982329336361777,-6.99428170474855,32,32,0,3
100440,4to9,4,9,0.92036585147042,-9.30662764773337,31,31,0,2
100458,9to4,9,4,0.982329336361777,-6.99428170474855,34,34,0,3
100474,4to9,4,9,0.92036585147042,-9.30662764773337,34,34,0,2
100490,9to8,9,8,0.016894713146247,-11.0572075885512,816,816,0,3
100505,8to3,8,3,0.225519798251787,-4.11464622477799,188,188,0,4
100521,3to4,3,4,0.976251597692276,-3.99285301446634,63,63,0,3
100537,4to9,4,9,0.92036585147042,-9.30662764773337,63,63,0,2
100554,9to14,9,14,0.000775950491976,-14.1378748897887,944,944,0,3
100571,14to13,14,13,0.036089982389885,-8.4156373239335,944,944,0,3
100586,13to18,13,18,9.47413868935043E-05,-16.5118558919643,10577,760,9817,4
100603,18to23,18,23,0.000589264202562,-11.1767060275596,28437,16,28421,4
100619,23to22,23,22,0.025691585672415,-7.99176435006161,28436,48,28388,3
100635,22to23,22,23,0.17714079066729,-6.97331760217983,32,32,0,3
100652,23to24,23,24,0.019879198495716,-8.281743812643,10674,20,10654,3
100668,24to23,24,23,0.127342887638322,-6.82015605114322,33,19,14,2
100685,23to18,23,18,0.953554239808896,-4.41122138755967,99,99,0,3
100702,18to13,18,13,0.995829766189947,-3.74424906738557,131,131,0,4
100718,13to8,13,8,0.880684965458987,-7.37455157477482,228,228,0,4
100734,8to9,8,9,0.763990115179857,-2.89449932615566,197,197,0,4
100750,9to14,9,14,0.000775950491976,-14.1378748897887,196,196,0,3
100765,14to9,14,9,0.963804520342605,-5.13076416031772,31,31,0,3
100781,9to4,9,4,0.982329336361777,-6.99428170474855,260,260,0,3
100796,4to3,4,3,0.07963414852958,-11.7539559008873,291,291,0,2
100813,3to4,3,4,0.976251597692276,-3.99285301446634,32,32,0,3
100830,4to9,4,9,0.92036585147042,-9.30662764773337,65,65,0,2
100845,9to4,9,4,0.982329336361777,-6.99428170474855,32,32,0,3
100859,4to9,4,9,0.92036585147042,-9.30662764773337,29,29,0,2
100875,9to4,9,4,0.982329336361777,-6.99428170474855,30,30,0,3
100892,4to9,4,9,0.92036585147042,-9.30662764773337,33,33,0,2
100907,9to4,9,4,0.982329336361777,-6.99428170474855,32,32,0,3
100923,4to9,4,9,0.92036585147042,-9.30662764773337,31,31,0,2
100939,9to4,9,4,0.982329336361777,-6.99428170474855,32,32,0,3
100955,4to9,4,9,0.92036585147042,-9.30662764773337,32,32,0,2
100971,9to8,9,8,0.016894713146247,-11.0572075885512,253,253,0,3
100987,8to3,8,3,0.225519798251787,-4.11464622477799,191,191,0,4
101003,3to4,3,4,0.976251597692276,-3.99285301446634,64,64,0,3
101021,4to9,4,9,0.92036585147042,-9.30662764773337,66,66,0,2
101036,9to4,9,4,0.982329336361777,-6.99428170474855,33,33,0,3
101051,4to9,4,9,0.92036585147042,-9.30662764773337,30,30,0,2
101067,9to4,9,4,0.982329336361777,-6.99428170474855,31,31,0,3
101082,4to9,4,9,0.92036585147042,-9.30662764773337,31,31,0,2
101097,9to8,9,8,0.016894713146247,-11.0572075885512,126,126,0,3
101112,8to3,8,3,0.225519798251787,-4.11464622477799,125,125,0,4
101129,3to4,3,4,0.976251597692276,-3.99285301446634,62,62,0,3
101144,4to9,4,9,0.92036585147042,-9.30662764773337,62,62,0,2
101159,9to4,9,4,0.982329336361777,-6.99428170474855,30,30,0,3
101175,4to9,4,9,0.92036585147042,-9.30662764773337,31,31,0,2
101189,9to4,9,4,0.982329336361777,-6.99428170474855,30,30,0,3
101205,4to9,4,9,0.92036585147042,-9.30662764773337,30,30,0,2
101220,9to4,9,4,0.982329336361777,-6.99428170474855,31,31,0,3
101237,4to9,4,9,0.92036585147042,-9.30662764773337,32,32,0,2
101253,9to4,9,4,0.982329336361777,-6.99428170474855,33,33,0,3
101270,4to9,4,9,0.92036585147042,-9.30662764773337,33,33,0,2
101285,9to4,9,4,0.982329336361777,-6.99428170474855,32,32,0,3
101301,4to9,4,9,0.92036585147042,-9.30662764773337,31,31,0,2
101317,9to4,9,4,0.982329336361777,-6.99428170474855,32,32,0,3
101332,4to3,4,3,0.07963414852958,-11.7539559008873,220,220,0,2
101348,3to4,3,4,0.976251597692276,-3.99285301446634,31,31,0,3
101365,4to9,4,9,0.92036585147042,-9.30662764773337,64,64,0,2
101381,9to4,9,4,0.982329336361777,-6.99428170474855,33,33,0,3
101396,4to9,4,9,0.92036585147042,-9.30662764773337,31,31,0,2
101412,9to4,9,4,0.982329336361777,-6.99428170474855,31,31,0,3
101428,4to9,4,9,0.92036585147042,-9.30662764773337,32,32,0,2
101444,9to4,9,4,0.982329336361777,-6.99428170474855,32,32,0,3
101460,4to9,4,9,0.92036585147042,-9.30662764773337,32,32,0,2
101475,9to14,9,14,0.000775950491976,-14.1378748897887,725,725,0,3
101491,14to13,14,13,0.036089982389885,-8.4156373239335,789,789,0,3
101508,13to8,13,8,0.880684965458987,-7.37455157477482,411,411,0,4
101524,8to3,8,3,0.225519798251787,-4.11464622477799,192,192,0,4
101540,3to4,3,4,0.976251597692276,-3.99285301446634,96,96,0,3
101557,4to9,4,9,0.92036585147042,-9.30662764773337,97,97,0,2
101572,9to4,9,4,0.982329336361777,-6.99428170474855,32,32,0,3
101588,4to9,4,9,0.92036585147042,-9.30662764773337,31,31,0,2
101603,9to4,9,4,0.982329336361777,-6.99428170474855,31,31,0,3
101618,4to9,4,9,0.92036585147042,-9.30662764773337,30,30,0,2
101633,9to4,9,4,0.982329336361777,-6.99428170474855,30,30,0,3
101648,4to9,4,9,0.92036585147042,-9.30662764773337,30,30,0,2
101664,9to4,9,4,0.982329336361777,-6.99428170474855,31,31,0,3
101679,4to9,4,9,0.92036585147042,-9.30662764773337,31,31,0,2
101695,9to4,9,4,0.982329336361777,-6.99428170474855,31,31,0,3
101710,4to9,4,9,0.92036585147042,-9.30662764773337,31,31,0,2
101725,9to4,9,4,0.982329336361777,-6.99428170474855,30,30,0,3
101741,4to3,4,3,0.07963414852958,-11.7539559008873,217,217,0,2
101756,3to4,3,4,0.976251597692276,-3.99285301446634,31,31,0,3
101772,4to9,4,9,0.92036585147042,-9.30662764773337,62,62,0,2
101788,9to4,9,4,0.968454506978648,-7.58803170474855,32,13,19,3
101805,4to9,4,9,0.863098560843595,-9.91268825379397,33,13,20,2
101820,9to4,9,4,0.968454506978648,-7.58803170474855,32,32,0,3
101835,4to9,4,9,0.863098560843595,-9.91268825379397,30,30,0,2
101850,9to4,9,4,0.968454506978648,-7.58803170474855,30,30,0,3
101866,4to3,4,3,0.120758422858362,-11.8979559008873,125,107,18,2
101881,3to4,3,4,0.976251597692276,-3.99285301446634,31,31,0,3
101899,4to9,4,9,0.879241577141637,-9.91268825379397,64,64,0,2
101915,9to4,9,4,0.968454506978648,-7.58803170474855,34,34,0,3
101930,4to9,4,9,0.879241577141637,-9.91268825379397,31,31,0,2
101946,9to4,9,4,0.968454506978648,-7.58803170474855,31,31,0,3
101963,4to9,4,9,0.879241577141637,-9.91268825379397,33,33,0,2
101979,9to4,9,4,0.968454506978648,-7.58803170474855,33,33,0,3
101995,4to3,4,3,0.120758422858362,-11.8979559008873,129,129,0,2
102013,3to2,3,2,0.000782827594907,-11.1226155959287,4295,303,3992,3
102028,2to3,2,3,0.995300351194049,-3.70441168844569,33,33,0,3
102044,3to4,3,4,0.977423266391036,-3.99285301446634,65,65,0,3
102059,4to9,4,9,0.879241577141637,-9.91268825379397,96,96,0,2
102075,9to8,9,8,0.020132789023116,-11.47166966968,567,332,235,3
102090,8to9,8,9,0.763990115179857,-2.89449932615566,31,31,0,4
102106,9to4,9,4,0.978467669648271,-7.58803170474855,62,62,0,3
102122,4to9,4,9,0.879241577141637,-9.91268825379397,32,32,0,2
102137,9to4,9,4,0.978467669648271,-7.58803170474855,31,31,0,3
102153,4to9,4,9,0.879241577141637,-9.91268825379397,31,31,0,2
102168,9to4,9,4,0.978467669648271,-7.58803170474855,31,31,0,3
102183,4to3,4,3,0.120758422858362,-11.8979559008873,155,155,0,2
102198,3to4,3,4,0.977423266391036,-3.99285301446634,30,30,0,3
102214,4to9,4,9,0.879241577141637,-9.91268825379397,61,61,0,2
102230,9to4,9,4,0.978467669648271,-7.58803170474855,32,32,0,3
102247,4to9,4,9,0.879241577141637,-9.91268825379397,33,33,0,2
102262,9to4,9,4,0.978467669648271,-7.58803170474855,32,32,0,3
102277,4to9,4,9,0.879241577141637,-9.91268825379397,30,30,0,2
102294,9to4,9,4,0.978467669648271,-7.58803170474855,32,32,0,3
102311,4to3,4,3,0.120758422858362,-11.8979559008873,128,128,0,2
102328,3to4,3,4,0.977423266391036,-3.99285301446634,34,34,0,3
102343,4to9,4,9,0.879241577141637,-9.91268825379397,66,66,0,2
102358,9to4,9,4,0.978467669648271,-7.58803170474855,30,30,0,3
102373,4to9,4,9,0.879241577141637,-9.91268825379397,30,30,0,2
102388,9to4,9,4,0.978467669648271,-7.58803170474855,30,30,0,3
102402,4to9,4,9,0.879241577141637,-9.91268825379397,29,29,0,2
102417,9to4,9,4,0.978467669648271,-7.58803170474855,29,29,0,3
102433,4to9,4,9,0.879241577141637,-9.91268825379397,31,31,0,2
102448,9to4,9,4,0.978467669648271,-7.58803170474855,31,31,0,3
102464,4to3,4,3,0.120758422858362,-11.8979559008873,153,153,0,2
102479,3to4,3,4,0.977423266391036,-3.99285301446634,31,31,0,3
102495,4to9,4,9,0.879241577141637,-9.91268825379397,62,62,0,2
102511,9to4,9,4,0.978467669648271,-7.58803170474855,32,32,0,3
102525,4to9,4,9,0.879241577141637,-9.91268825379397,30,30,0,2
102541,9to4,9,4,0.978467669648271,-7.58803170474855,30,30,0,3
102557,4to9,4,9,0.879241577141637,-9.91268825379397,32,32,0,2
102573,9to4,9,4,0.978467669648271,-7.58803170474855,32,32,0,3
102588,4to9,4,9,0.879241577141637,-9.91268825379397,31,31,0,2
102603,9to4,9,4,0.978467669648271,-7.58803170474855,30,30,0,3
102619,4to9,4,9,0.879241577141637,-9.91268825379397,31,31,0,2
102634,9to4,9,4,0.978467669648271,-7.58803170474855,31,31,0,3
102650,4to3,4,3,0.120758422858362,-11.8979559008873,186,186,0,2
102666,3to4,3,4,0.977423266391036,-3.99285301446634,32,32,0,3
102681,4to9,4,9,0.879241577141637,-9.91268825379397,62,62,0,2
102698,9to4,9,4,0.978467669648271,-7.58803170474855,32,32,0,3
102714,4to9,4,9,0.879241577141637,-9.91268825379397,33,33,0,2
102730,9to4,9,4,0.978467669648271,-7.58803170474855,32,32,0,3
102746,4to3,4,3,0.120758422858362,-11.8979559008873,96,96,0,2
102762,3to4,3,4,0.977423266391036,-3.99285301446634,32,32,0,3
102779,4to9,4,9,0.879241577141637,-9.91268825379397,65,65,0,2
102795,9to4,9,4,0.978467669648271,-7.58803170474855,33,33,0,3
102811,4to9,4,9,0.879241577141637,-9.91268825379397,32,32,0,2
102826,9to4,9,4,0.978467669648271,-7.58803170474855,31,31,0,3
102841,4to9,4,9,0.879241577141637,-9.91268825379397,30,30,0,2
102856,9to8,9,8,0.020132789023116,-11.47166966968,781,781,0,3
102871,8to3,8,3,0.225519798251787,-4.11464622477799,125,125,0,4
102888,3to4,3,4,0.977423266391036,-3.99285301446634,62,62,0,3
102904,4to9,4,9,0.879241577141637,-9.91268825379397,63,63,0,2
102920,9to4,9,4,0.978467669648271,-7.58803170474855,32,32,0,3
102937,4to3,4,3,0.120758422858362,-11.8979559008873,66,66,0,2
102954,3to4,3,4,0.977423266391036,-3.99285301446634,34,34,0,3
102971,4to9,4,9,0.879241577141637,-9.91268825379397,67,67,0,2
102986,9to4,9,4,0.978467669648271,-7.58803170474855,32,32,0,3
103003,4to3,4,3,0.120758422858362,-11.8979559008873,66,66,0,2
103018,3to4,3,4,0.977423266391036,-3.99285301446634,32,32,0,3
103036,4to9,4,9,0.879241577141637,-9.91268825379397,65,65,0,2
103052,9to4,9,4,0.978467669648271,-7.58803170474855,34,34,0,3
103069,4to9,4,9,0.879241577141637,-9.91268825379397,33,33,0,2
103084,9to4,9,4,0.978467669648271,-7.58803170474855,32,32,0,3
103099,4to9,4,9,0.879241577141637,-9.91268825379397,30,30,0,2
103114,9to4,9,4,0.978467669648271,-7.58803170474855,30,30,0,3
103130,4to3,4,3,0.120758422858362,-11.8979559008873,127,127,0,2
103146,3to4,3,4,0.977423266391036,-3.99285301446634,32,32,0,3
103163,4to9,4,9,0.879241577141637,-9.91268825379397,64,64,0,2
103179,9to4,9,4,0.978467669648271,-7.58803170474855,33,33,0,3
103195,4to9,4,9,0.879241577141637,-9.91268825379397,32,32,0,2
103211,9to4,9,4,0.978467669648271,-7.58803170474855,32,32,0,3
103227,4to9,4,9,0.879241577141637,-9.91268825379397,32,32,0,2
103242,9to4,9,4,0.978467669648271,-7.58803170474855,31,31,0,3
103260,4to3,4,3,0.120758422858362,-11.8979559008873,130,130,0,2
103275,3to4,3,4,0.977423266391036,-3.99285301446634,33,33,0,3
103290,4to9,4,9,0.879241577141637,-9.91268825379397,63,63,0,2
103307,9to4,9,4,0.978467669648271,-7.58803170474855,32,32,0,3
103322,4to3,4,3,0.120758422858362,-11.8979559008873,62,62,0,2
103339,3to4,3,4,0.977423266391036,-3.99285301446634,32,32,0,3
103355,4to9,4,9,0.879241577141637,-9.91268825379397,65,65,0,2
103371,9to4,9,4,0.978467669648271,-7.58803170474855,32,32,0,3
103387,4to9,4,9,0.879241577141637,-9.91268825379397,32,32,0,2
103403,9to4,9,4,0.978467669648271,-7.58803170474855,32,32,0,3
103418,4to9,4,9,0.879241577141637,-9.91268825379397,31,31,0,2
103432,9to4,9,4,0.978467669648271,-7.58803170474855,29,29,0,3
103447,4to9,4,9,0.879241577141637,-9.91268825379397,29,29,0,2
103464,9to14,9,14,0.001166344252255,-14.3203786605278,1989,1626,363,3
103480,14to13,14,13,0.036089982389885,-8.4156373239335,1989,1989,0,3
103496,13to8,13,8,0.880684965458987,-7.37455157477482,640,640,0,4
103512,8to3,8,3,0.225519798251787,-4.11464622477799,190,190,0,4
103528,3to4,3,4,0.977423266391036,-3.99285301446634,96,96,0,3
103545,4to9,4,9,0.879241577141637,-9.91268825379397,98,98,0,2
103559,9to4,9,4,0.978696165237164,-7.58803170474855,31,31,0,3
103575,4to9,4,9,0.879241577141637,-9.91268825379397,30,30,0,2
103591,9to4,9,4,0.978696165237164,-7.58803170474855,32,32,0,3
103607,4to9,4,9,0.879241577141637,-9.91268825379397,32,32,0,2
103622,9to4,9,4,0.978696165237164,-7.58803170474855,31,31,0,3
103638,4to3,4,3,0.120758422858362,-11.8979559008873,126,126,0,2
103652,3to4,3,4,0.977423266391036,-3.99285301446634,30,30,0,3
103669,4to9,4,9,0.879241577141637,-9.91268825379397,62,62,0,2
103684,9to4,9,4,0.978696165237164,-7.58803170474855,32,32,0,3
103701,4to9,4,9,0.879241577141637,-9.91268825379397,32,32,0,2
103717,9to4,9,4,0.978696165237164,-7.58803170474855,33,33,0,3
103734,4to9,4,9,0.879241577141637,-9.91268825379397,33,33,0,2
103749,9to4,9,4,0.978696165237164,-7.58803170474855,32,32,0,3
103765,4to3,4,3,0.120758422858362,-11.8979559008873,127,127,0,2
103780,3to4,3,4,0.977423266391036,-3.99285301446634,31,31,0,3
103797,4to9,4,9,0.879241577141637,-9.91268825379397,63,63,0,2
103812,9to4,9,4,0.978696165237164,-7.58803170474855,32,32,0,3
103828,4to9,4,9,0.879241577141637,-9.91268825379397,31,31,0,2
103844,9to4,9,4,0.978696165237164,-7.58803170474855,32,32,0,3
103860,4to9,4,9,0.879241577141637,-9.91268825379397,32,32,0,2
103875,9to4,9,4,0.978696165237164,-7.58803170474855,31,31,0,3
103889,4to3,4,3,0.120758422858362,-11.8979559008873,124,124,0,2
103904,3to4,3,4,0.977423266391036,-3.99285301446634,29,29,0,3
103919,4to9,4,9,0.879241577141637,-9.91268825379397,59,59,0,2
103935,9to4,9,4,0.978696165237164,-7.58803170474855,31,31,0,3
103951,4to9,4,9,0.879241577141637,-9.91268825379397,32,32,0,2
103966,9to4,9,4,0.978696165237164,-7.58803170474855,31,31,0,3
103982,4to9,4,9,0.879241577141637,-9.91268825379397,31,31,0,2
103997,9to4,9,4,0.978696165237164,-7.58803170474855,31,31,0,3
104014,4to9,4,9,0.879241577141637,-9.91268825379397,32,32,0,2
104029,9to4,9,4,0.978696165237164,-7.58803170474855,32,32,0,3
104044,4to3,4,3,0.120758422858362,-11.8979559008873,155,155,0,2
104058,3to4,3,4,0.977423266391036,-3.99285301446634,29,29,0,3
104075,4to9,4,9,0.879241577141637,-9.91268825379397,61,61,0,2
104090,9to4,9,4,0.978696165237164,-7.58803170474855,32,32,0,3
104105,4to9,4,9,0.879241577141637,-9.91268825379397,30,30,0,2
104120,9to8,9,8,0.020137490510581,-11.47166966968,624,624,0,3
104137,8to3,8,3,0.225519798251787,-4.11464622477799,93,93,0,4
104153,3to4,3,4,0.977423266391036,-3.99285301446634,63,63,0,3
104170,4to9,4,9,0.879241577141637,-9.91268825379397,65,65,0,2
104186,9to4,9,4,0.978696165237164,-7.58803170474855,33,33,0,3
104204,4to3,4,3,0.120758422858362,-11.8979559008873,67,67,0,2
104221,3to4,3,4,0.977423266391036,-3.99285301446634,35,35,0,3
104237,4to9,4,9,0.879241577141637,-9.91268825379397,67,67,0,2
104252,9to4,9,4,0.978696165237164,-7.58803170474855,31,31,0,3
104267,4to9,4,9,0.879241577141637,-9.91268825379397,30,30,0,2
104283,9to4,9,4,0.978696165237164,-7.58803170474855,31,31,0,3
104299,4to9,4,9,0.879241577141637,-9.91268825379397,32,32,0,2
104315,9to4,9,4,0.978696165237164,-7.58803170474855,32,32,0,3
104331,4to9,4,9,0.879241577141637,-9.91268825379397,32,32,0,2
104347,9to4,9,4,0.978696165237164,-7.58803170474855,32,32,0,3
104363,4to3,4,3,0.120758422858362,-11.8979559008873,159,159,0,2
104378,3to4,3,4,0.977423266391036,-3.99285301446634,31,31,0,3
104395,4to9,4,9,0.879241577141637,-9.91268825379397,64,64,0,2
104412,9to4,9,4,0.978696165237164,-7.58803170474855,34,34,0,3
104429,4to9,4,9,0.879241577141637,-9.91268825379397,34,34,0,2
104447,9to4,9,4,0.978696165237164,-7.58803170474855,35,35,0,3
104464,4to9,4,9,0.879241577141637,-9.91268825379397,35,35,0,2
104480,9to4,9,4,0.978696165237164,-7.58803170474855,33,33,0,3
104495,4to3,4,3,0.120758422858362,-11.8979559008873,132,132,0,2
104511,3to4,3,4,0.977423266391036,-3.99285301446634,31,31,0,3
104528,4to9,4,9,0.879241577141637,-9.91268825379397,64,64,0,2
104542,9to4,9,4,0.978696165237164,-7.58803170474855,31,31,0,3
104559,4to9,4,9,0.879241577141637,-9.91268825379397,31,31,0,2
104575,9to4,9,4,0.978696165237164,-7.58803170474855,33,33,0,3
104590,4to9,4,9,0.879241577141637,-9.91268825379397,31,31,0,2
104606,9to4,9,4,0.978696165237164,-7.58803170474855,31,31,0,3
104621,4to9,4,9,0.879241577141637,-9.91268825379397,31,31,0,2
104637,9to4,9,4,0.978696165237164,-7.58803170474855,31,31,0,3
104653,4to3,4,3,0.120758422858362,-11.8979559008873,158,158,0,2
104669,3to4,3,4,0.977423266391036,-3.99285301446634,32,32,0,3
104685,4to9,4,9,0.879241577141637,-9.91268825379397,64,64,0,2
104700,9to4,9,4,0.978696165237164,-7.58803170474855,31,31,0,3
104716,4to9,4,9,0.879241577141637,-9.91268825379397,31,31,0,2
104732,9to4,9,4,0.978696165237164,-7.58803170474855,32,32,0,3
104746,4to9,4,9,0.879241577141637,-9.91268825379397,30,30,0,2
104762,9to8,9,8,0.020137490510581,-11.47166966968,642,642,0,3
104779,8to7,8,7,0.001571313504232,-9.08192396035069,5120,3052,2068,4
104795,7to12,7,12,0.068525656203016,-4.92022659283001,5152,5152,0,4
104809,12to13,12,13,0.97582840866556,-5.77169154969565,1329,1329,0,4
104826,13to14,13,14,0.089485556942486,-9.66117431199995,1362,1362,0,4
104843,14to9,14,9,0.963804520342605,-5.13076416031772,97,97,0,3
104861,9to4,9,4,0.978696165237164,-7.58803170474855,129,129,0,3
104877,4to3,4,3,0.120758422858362,-11.8979559008873,224,224,0,2
104893,3to4,3,4,0.977423266391036,-3.99285301446634,32,32,0,3
104908,4to9,4,9,0.879241577141637,-9.91268825379397,65,65,0,2
104923,9to4,9,4,0.978696165237164,-7.58803170474855,30,30,0,3
104938,4to9,4,9,0.879241577141637,-9.91268825379397,30,30,0,2
104954,9to4,9,4,0.978696165237164,-7.58803170474855,31,31,0,3
104971,4to9,4,9,0.879241577141637,-9.91268825379397,33,33,0,2
104986,9to14,9,14,0.001166344252255,-14.3203786605278,160,160,0,3
105000,14to9,14,9,0.963804520342605,-5.13076416031772,29,29,0,3
105018,9to4,9,4,0.978696165237164,-7.58803170474855,64,64,0,3
105035,4to3,4,3,0.120758422858362,-11.8979559008873,158,158,0,2
105050,3to4,3,4,0.977423266391036,-3.99285301446634,32,32,0,3
105066,4to9,4,9,0.879241577141637,-9.91268825379397,66,66,0,2
105082,9to14,9,14,0.001166344252255,-14.3203786605278,96,96,0,3
105096,14to9,14,9,0.963804520342605,-5.13076416031772,30,30,0,3
105113,9to4,9,4,0.978696165237164,-7.58803170474855,63,63,0,3
105130,4to9,4,9,0.879241577141637,-9.91268825379397,34,34,0,2
105145,9to4,9,4,0.978696165237164,-7.58803170474855,32,32,0,3
105160,4to3,4,3,0.120758422858362,-11.8979559008873,125,125,0,2
105176,3to4,3,4,0.977423266391036,-3.99285301446634,31,31,0,3
105193,4to9,4,9,0.879241577141637,-9.91268825379397,63,63,0,2
105210,9to14,9,14,0.001166344252255,-14.3203786605278,128,128,0,3
105227,14to9,14,9,0.963804520342605,-5.13076416031772,34,34,0,3
105243,9to4,9,4,0.978696165237164,-7.58803170474855,67,67,0,3
105258,4to9,4,9,0.879241577141637,-9.91268825379397,31,31,0,2
105272,9to4,9,4,0.978696165237164,-7.58803170474855,29,29,0,3
105289,4to3,4,3,0.120758422858362,-11.8979559008873,129,129,0,2
105305,3to4,3,4,0.977423266391036,-3.99285301446634,33,33,0,3
105321,4to9,4,9,0.879241577141637,-9.91268825379397,63,63,0,2
105337,9to4,9,4,0.978696165237164,-7.58803170474855,32,32,0,3
105352,4to9,4,9,0.879241577141637,-9.91268825379397,31,31,0,2
105368,9to4,9,4,0.978696165237164,-7.58803170474855,31,31,0,3
105383,4to9,4,9,0.879241577141637,-9.91268825379397,31,31,0,2
105398,9to4,9,4,0.978696165237164,-7.58803170474855,30,30,0,3
105415,4to9,4,9,0.879241577141637,-9.91268825379397,32,32,0,2
105432,9to4,9,4,0.978696165237164,-7.58803170474855,34,34,0,3
105448,4to3,4,3,0.120758422858362,-11.8979559008873,159,159,0,2
105463,3to4,3,4,0.977423266391036,-3.99285301446634,31,31,0,3
105481,4to9,4,9,0.879241577141637,-9.91268825379397,66,66,0,2
105497,9to4,9,4,0.978696165237164,-7.58803170474855,34,34,0,3
105513,4to9,4,9,0.879241577141637,-9.91268825379397,32,32,0,2
105529,9to4,9,4,0.978696165237164,-7.58803170474855,32,32,0,3
105546,4to9,4,9,0.879241577141637,-9.91268825379397,33,33,0,2
105563,9to4,9,4,0.978696165237164,-7.58803170474855,34,34,0,3
105579,4to9,4,9,0.879241577141637,-9.91268825379397,33,33,0,2
105594,9to8,9,8,0.020137490510581,-11.47166966968,832,832,0,3
105610,8to3,8,3,0.225696151448692,-4.11464622477799,162,162,0,4
105625,3to4,3,4,0.977423266391036,-3.99285301446634,62,62,0,3
105642,4to9,4,9,0.879241577141637,-9.91268825379397,63,63,0,2
105658,9to4,9,4,0.978696165237164,-7.58803170474855,33,33,0,3
105674,4to9,4,9,0.879241577141637,-9.91268825379397,32,32,0,2
105688,9to4,9,4,0.978696165237164,-7.58803170474855,30,30,0,3
105704,4to9,4,9,0.879241577141637,-9.91268825379397,30,30,0,2
105719,9to4,9,4,0.978696165237164,-7.58803170474855,31,31,0,3
105735,4to9,4,9,0.879241577141637,-9.91268825379397,31,31,0,2
105751,9to4,9,4,0.978696165237164,-7.58803170474855,32,32,0,3
105766,4to3,4,3,0.120758422858362,-11.8979559008873,156,156,0,2
105781,3to4,3,4,0.977423266391036,-3.99285301446634,30,30,0,3
105797,4to9,4,9,0.879241577141637,-9.91268825379397,62,62,0,2
105812,9to4,9,4,0.978696165237164,-7.58803170474855,31,31,0,3
105827,4to9,4,9,0.879241577141637,-9.91268825379397,30,30,0,2
105842,9to4,9,4,0.978696165237164,-7.58803170474855,30,30,0,3
105857,4to9,4,9,0.879241577141637,-9.91268825379397,30,30,0,2
105873,9to4,9,4,0.978696165237164,-7.58803170474855,31,31,0,3
105888,4to3,4,3,0.120758422858362,-11.8979559008873,122,122,0,2
105903,3to4,3,4,0.977423266391036,-3.99285301446634,30,30,0,3
105918,4to9,4,9,0.879241577141637,-9.91268825379397,61,61,0,2
105934,9to4,9,4,0.978696165237164,-7.58803170474855,31,31,0,3
105950,4to3,4,3,0.120758422858362,-11.8979559008873,62,62,0,2
105966,3to4,3,4,0.977423266391036,-3.99285301446634,32,32,0,3
105983,4to9,4,9,0.879241577141637,-9.91268825379397,65,65,0,2
106000,9to14,9,14,0.001166344252255,-14.3203786605278,790,790,0,3
106015,14to13,14,13,0.036089982389885,-8.4156373239335,1206,1206,0,3
106030,13to8,13,8,0.880684965458987,-7.37455157477482,436,436,0,4
106046,8to9,8,9,0.764587544320271,-2.89449932615566,63,63,0,4
106062,9to8,9,8,0.020137490510581,-11.47166966968,32,32,0,3
106078,8to3,8,3,0.225696151448692,-4.11464622477799,128,128,0,4
106094,3to4,3,4,0.977423266391036,-3.99285301446634,128,128,0,3
106109,4to9,4,9,0.879241577141637,-9.91268825379397,63,63,0,2
106125,9to4,9,4,0.978696165237164,-7.58803170474855,31,31,0,3
106142,4to9,4,9,0.879241577141637,-9.91268825379397,33,33,0,2
106158,9to4,9,4,0.978696165237164,-7.58803170474855,33,33,0,3
106173,4to9,4,9,0.879241577141637,-9.91268825379397,31,31,0,2
106188,9to8,9,8,0.020137490510581,-11.47166966968,126,126,0,3
106205,8to3,8,3,0.225696151448692,-4.11464622477799,127,127,0,4
106221,3to4,3,4,0.977423266391036,-3.99285301446634,63,63,0,3
106239,4to9,4,9,0.879241577141637,-9.91268825379397,66,66,0,2
106256,9to4,9,4,0.978696165237164,-7.58803170474855,35,35,0,3
106273,4to9,4,9,0.879241577141637,-9.91268825379397,34,34,0,2
106288,9to4,9,4,0.978696165237164,-7.58803170474855,32,32,0,3
106305,4to9,4,9,0.879241577141637,-9.91268825379397,32,32,0,2
106320,9to4,9,4,0.978696165237164,-7.58803170474855,32,32,0,3
106337,4to9,4,9,0.879241577141637,-9.91268825379397,32,32,0,2
106352,9to4,9,4,0.978696165237164,-7.58803170474855,32,32,0,3
106368,4to3,4,3,0.120758422858362,-11.8979559008873,163,163,0,2
106383,3to4,3,4,0.977423266391036,-3.99285301446634,31,31,0,3
106400,4to9,4,9,0.879241577141637,-9.91268825379397,63,63,0,2
106416,9to4,9,4,0.978696165237164,-7.58803170474855,33,33,0,3
106432,4to9,4,9,0.879241577141637,-9.91268825379397,32,32,0,2
106448,9to4,9,4,0.978696165237164,-7.58803170474855,32,32,0,3
106463,4to9,4,9,0.879241577141637,-9.91268825379397,31,31,0,2
106479,9to4,9,4,0.978696165237164,-7.58803170474855,31,31,0,3
106494,4to9,4,9,0.879241577141637,-9.91268825379397,31,31,0,2
106509,9to4,9,4,0.978696165237164,-7.58803170474855,30,30,0,3
106526,4to3,4,3,0.120758422858362,-11.8979559008873,158,158,0,2
106541,3to4,3,4,0.977423266391036,-3.99285301446634,32,32,0,3
106558,4to9,4,9,0.879241577141637,-9.91268825379397,64,64,0,2
106575,9to4,9,4,0.978696165237164,-7.58803170474855,34,34,0,3
106590,4to9,4,9,0.879241577141637,-9.91268825379397,32,32,0,2
106605,9to4,9,4,0.978696165237164,-7.58803170474855,30,30,0,3
106621,4to9,4,9,0.879241577141637,-9.91268825379397,31,31,0,2
106638,9to4,9,4,0.978696165237164,-7.58803170474855,33,33,0,3
106654,4to9,4,9,0.879241577141637,-9.91268825379397,33,33,0,2
106671,9to4,9,4,0.978696165237164,-7.58803170474855,33,33,0,3
106686,4to3,4,3,0.120758422858362,-11.8979559008873,160,160,0,2
106702,3to4,3,4,0.977423266391036,-3.99285301446634,31,31,0,3
106718,4to9,4,9,0.879241577141637,-9.91268825379397,64,64,0,2
106734,9to4,9,4,0.978696165237164,-7.58803170474855,32,32,0,3
106749,4to9,4,9,0.879241577141637,-9.91268825379397,31,31,0,2
106767,9to4,9,4,0.978696165237164,-7.58803170474855,33,33,0,3
106783,4to9,4,9,0.879241577141637,-9.91268825379397,34,34,0,2
106798,9to4,9,4,0.978696165237164,-7.58803170474855,31,31,0,3
106813,4to9,4,9,0.879241577141637,-9.91268825379397,30,30,0,2
106828,9to4,9,4,0.978696165237164,-7.58803170474855,30,30,0,3
106845,4to3,4,3,0.120758422858362,-11.8979559008873,159,159,0,2
106861,3to4,3,4,0.977423266391036,-3.99285301446634,33,33,0,3
106877,4to9,4,9,0.879241577141637,-9.91268825379397,64,64,0,2
106893,9to4,9,4,0.978696165237164,-7.58803170474855,32,32,0,3
106908,4to9,4,9,0.879241577141637,-9.91268825379397,31,31,0,2
106924,9to4,9,4,0.978696165237164,-7.58803170474855,31,31,0,3
106941,4to9,4,9,0.879241577141637,-9.91268825379397,33,33,0,2
106957,9to4,9,4,0.978696165237164,-7.58803170474855,33,33,0,3
106972,4to9,4,9,0.879241577141637,-9.91268825379397,31,31,0,2
106988,9to8,9,8,0.020137490510581,-11.47166966968,800,800,0,3
107005,8to3,8,3,0.225696151448692,-4.11464622477799,160,160,0,4
107022,3to4,3,4,0.977423266391036,-3.99285301446634,65,65,0,3
107037,4to9,4,9,0.879241577141637,-9.91268825379397,65,65,0,2
107054,9to4,9,4,0.978696165237164,-7.58803170474855,32,32,0,3
107068,4to3,4,3,0.120758422858362,-11.8979559008873,63,63,0,2
107085,3to2,3,2,0.000782827594907,-11.1226155959287,5072,5072,0,3
107100,2to1,2,1,0.000386822987352,-11.5578917974459,16941,276,16665,3
107116,1to6,1,6,0.061805513969198,-9.22791660351528,16974,276,16698,3
107132,6to11,6,11,0.096936699134594,-7.16308200415547,17039,274,16765,4
107149,11to12,11,12,0.731582146005281,-6.02382308801248,2354,407,1947,4
107164,12to13,12,13,0.957187126935387,-6.36264020069652,1149,470,679,4
107180,13to8,13,8,0.880684965458987,-7.37455157477482,192,192,0,4
107197,8to9,8,9,0.764587544320271,-2.89449932615566,160,160,0,4
107213,9to4,9,4,0.978696165237164,-7.58803170474855,159,159,0,3
107228,4to3,4,3,0.120758422858362,-11.8979559008873,160,160,0,2
107243,3to4,3,4,0.977423266391036,-3.99285301446634,30,30,0,3
107260,4to3,4,3,0.120758422858362,-11.8979559008873,32,32,0,2
107276,3to4,3,4,0.977423266391036,-3.99285301446634,33,33,0,3
107292,4to9,4,9,0.879241577141637,-9.91268825379397,95,95,0,2
107308,9to4,9,4,0.978696165237164,-7.58803170474855,32,32,0,3
107326,4to9,4,9,0.879241577141637,-9.91268825379397,34,34,0,2
107342,9to4,9,4,0.978696165237164,-7.58803170474855,34,34,0,3
107359,4to9,4,9,0.879241577141637,-9.91268825379397,33,33,0,2
107374,9to4,9,4,0.978696165237164,-7.58803170474855,32,32,0,3
107390,4to3,4,3,0.120758422858362,-11.8979559008873,130,130,0,2
107406,3to4,3,4,0.977423266391036,-3.99285301446634,32,32,0,3
107420,4to3,4,3,0.120758422858362,-11.8979559008873,30,30,0,2
107436,3to4,3,4,0.977423266391036,-3.99285301446634,30,30,0,3
107452,4to9,4,9,0.879241577141637,-9.91268825379397,93,93,0,2
107466,9to4,9,4,0.978696165237164,-7.58803170474855,30,30,0,3
107481,4to9,4,9,0.879241577141637,-9.91268825379397,29,29,0,2
107496,9to4,9,4,0.978696165237164,-7.58803170474855,30,30,0,3
107511,4to9,4,9,0.879241577141637,-9.91268825379397,30,30,0,2
107526,9to4,9,4,0.978696165237164,-7.58803170474855,30,30,0,3
107541,4to3,4,3,0.120758422858362,-11.8979559008873,121,121,0,2
107556,3to4,3,4,0.977423266391036,-3.99285301446634,30,30,0,3
107573,4to9,4,9,0.879241577141637,-9.91268825379397,62,62,0,2
107588,9to4,9,4,0.978696165237164,-7.58803170474855,32,32,0,3
107603,4to9,4,9,0.879241577141637,-9.91268825379397,30,30,0,2
107618,9to4,9,4,0.978696165237164,-7.58803170474855,30,30,0,3
107633,4to9,4,9,0.879241577141637,-9.91268825379397,30,30,0,2
107649,9to4,9,4,0.978696165237164,-7.58803170474855,31,31,0,3
107665,4to9,4,9,0.879241577141637,-9.91268825379397,32,32,0,2
107681,9to4,9,4,0.978696165237164,-7.58803170474855,32,32,0,3
107695,4to3,4,3,0.120758422858362,-11.8979559008873,154,154,0,2
107710,3to4,3,4,0.977423266391036,-3.99285301446634,29,29,0,3
107725,4to3,4,3,0.120758422858362,-11.8979559008873,30,30,0,2
107739,3to4,3,4,0.977423266391036,-3.99285301446634,29,29,0,3
107754,4to9,4,9,0.879241577141637,-9.91268825379397,89,89,0,2
107769,9to4,9,4,0.978696165237164,-7.58803170474855,30,30,0,3
107785,4to9,4,9,0.879241577141637,-9.91268825379397,31,31,0,2
107799,9to4,9,4,0.978696165237164,-7.58803170474855,30,30,0,3
107815,4to9,4,9,0.879241577141637,-9.91268825379397,30,30,0,2
107830,9to4,9,4,0.978696165237164,-7.58803170474855,31,31,0,3
107844,4to9,4,9,0.879241577141637,-9.91268825379397,29,29,0,2
107859,9to4,9,4,0.978696165237164,-7.58803170474855,29,29,0,3
107874,4to3,4,3,0.120758422858362,-11.8979559008873,149,149,0,2
107891,3to8,3,8,0.021793906014057,-7.79614241331218,711,711,0,3
107905,8to9,8,9,0.764587544320271,-2.89449932615566,61,61,0,4
107921,9to4,9,4,0.978696165237164,-7.58803170474855,62,62,0,3
107937,4to9,4,9,0.879241577141637,-9.91268825379397,32,32,0,2
107953,9to4,9,4,0.978696165237164,-7.58803170474855,32,32,0,3
107970,4to9,4,9,0.879241577141637,-9.91268825379397,33,33,0,2
107986,9to4,9,4,0.978696165237164,-7.58803170474855,33,33,0,3
108002,4to9,4,9,0.879241577141637,-9.91268825379397,32,32,0,2
108018,9to4,9,4,0.978696165237164,-7.58803170474855,32,32,0,3
108034,4to3,4,3,0.120758422858362,-11.8979559008873,160,160,0,2
108050,3to4,3,4,0.977423266391036,-3.99285301446634,32,32,0,3
108068,4to9,4,9,0.879241577141637,-9.91268825379397,66,66,0,2
108083,9to14,9,14,0.000855606861356,-14.6305082812671,2083,1437,646,3
108099,14to13,14,13,0.036089982389885,-8.4156373239335,935,935,0,3
108116,13to12,13,12,0.029734736211633,-10.7629356175037,967,967,0,4
108131,12to7,12,7,0.019128597910577,-10.2907402600302,3352,1372,1980,4
108147,7to8,7,8,0.855108372325079,-2.39620659892225,256,256,0,4
108164,8to9,8,9,0.764587544320271,-2.89449932615566,96,96,0,4
108179,9to4,9,4,0.979000637849915,-7.58803170474855,129,129,0,3
108195,4to3,4,3,0.120758422858362,-11.8979559008873,161,161,0,2
108212,3to4,3,4,0.977423266391036,-3.99285301446634,33,33,0,3
108228,4to9,4,9,0.879241577141637,-9.91268825379397,64,64,0,2
108243,9to4,9,4,0.979000637849915,-7.58803170474855,31,31,0,3
108259,4to9,4,9,0.879241577141637,-9.91268825379397,31,31,0,2
108276,9to4,9,4,0.979000637849915,-7.58803170474855,33,33,0,3
108293,4to9,4,9,0.879241577141637,-9.91268825379397,34,34,0,2
108310,9to4,9,4,0.979000637849915,-7.58803170474855,34,34,0,3
108325,4to9,4,9,0.879241577141637,-9.91268825379397,32,32,0,2
108340,9to4,9,4,0.979000637849915,-7.58803170474855,30,30,0,3
108356,4to3,4,3,0.120758422858362,-11.8979559008873,161,161,0,2
108370,3to4,3,4,0.977423266391036,-3.99285301446634,30,30,0,3
108387,4to9,4,9,0.879241577141637,-9.91268825379397,62,62,0,2
108402,9to4,9,4,0.979000637849915,-7.58803170474855,32,32,0,3
108417,4to9,4,9,0.879241577141637,-9.91268825379397,30,30,0,2
108435,9to8,9,8,0.020143755288729,-11.47166966968,288,288,0,3
108450,8to3,8,3,0.225696151448692,-4.11464622477799,94,94,0,4
108466,3to4,3,4,0.977423266391036,-3.99285301446634,64,64,0,3
108482,4to9,4,9,0.879241577141637,-9.91268825379397,65,65,0,2
108498,9to4,9,4,0.979000637849915,-7.58803170474855,32,32,0,3
108514,4to9,4,9,0.879241577141637,-9.91268825379397,32,32,0,2
108529,9to4,9,4,0.979000637849915,-7.58803170474855,31,31,0,3
108543,4to9,4,9,0.879241577141637,-9.91268825379397,29,29,0,2
108559,9to4,9,4,0.979000637849915,-7.58803170474855,30,30,0,3
108574,4to9,4,9,0.879241577141637,-9.91268825379397,31,31,0,2
108589,9to4,9,4,0.979000637849915,-7.58803170474855,30,30,0,3
108606,4to3,4,3,0.120758422858362,-11.8979559008873,156,156,0,2
108620,3to4,3,4,0.977423266391036,-3.99285301446634,31,31,0,3
108637,4to9,4,9,0.879241577141637,-9.91268825379397,63,63,0,2
108652,9to4,9,4,0.979000637849915,-7.58803170474855,32,32,0,3
108667,4to9,4,9,0.879241577141637,-9.91268825379397,30,30,0,2
108681,9to4,9,4,0.979000637849915,-7.58803170474855,29,29,0,3
108696,4to9,4,9,0.879241577141637,-9.91268825379397,29,29,0,2
108711,9to4,9,4,0.979000637849915,-7.58803170474855,30,30,0,3
108726,4to9,4,9,0.879241577141637,-9.91268825379397,30,30,0,2
108740,9to4,9,4,0.979000637849915,-7.58803170474855,29,29,0,3
108758,4to3,4,3,0.120758422858362,-11.8979559008873,152,152,0,2
108772,3to4,3,4,0.977423266391036,-3.99285301446634,32,32,0,3
108787,4to9,4,9,0.879241577141637,-9.91268825379397,61,61,0,2
108804,9to4,9,4,0.979000637849915,-7.58803170474855,32,32,0,3
108819,4to3,4,3,0.120758422858362,-11.8979559008873,61,61,0,2
108834,3to4,3,4,0.977423266391036,-3.99285301446634,30,30,0,3
108849,4to9,4,9,0.879241577141637,-9.91268825379397,62,62,0,2
108864,9to4,9,4,0.979000637849915,-7.58803170474855,30,30,0,3
108878,4to9,4,9,0.879241577141637,-9.91268825379397,29,29,0,2
108895,9to4,9,4,0.979000637849915,-7.58803170474855,31,31,0,3
108910,4to9,4,9,0.879241577141637,-9.91268825379397,32,32,0,2
108925,9to4,9,4,0.979000637849915,-7.58803170474855,30,30,0,3
108939,4to9,4,9,0.879241577141637,-9.91268825379397,29,29,0,2
108956,9to4,9,4,0.979000637849915,-7.58803170474855,31,31,0,3
108972,4to3,4,3,0.120758422858362,-11.8979559008873,153,153,0,2
108987,3to4,3,4,0.977423266391036,-3.99285301446634,31,31,0,3
109004,4to9,4,9,0.879241577141637,-9.91268825379397,65,65,0,2
109020,9to4,9,4,0.979000637849915,-7.58803170474855,33,33,0,3
109037,4to9,4,9,0.879241577141637,-9.91268825379397,33,33,0,2
109052,9to4,9,4,0.979000637849915,-7.58803170474855,32,32,0,3
109069,4to9,4,9,0.879241577141637,-9.91268825379397,32,32,0,2
109085,9to4,9,4,0.979000637849915,-7.58803170474855,33,33,0,3
109102,4to9,4,9,0.879241577141637,-9.91268825379397,33,33,0,2
109118,9to4,9,4,0.979000637849915,-7.58803170474855,33,33,0,3
109134,4to3,4,3,0.120758422858362,-11.8979559008873,162,162,0,2
109150,3to4,3,4,0.977423266391036,-3.99285301446634,32,32,0,3
109167,4to9,4,9,0.879241577141637,-9.91268825379397,65,65,0,2
109183,9to4,9,4,0.979000637849915,-7.58803170474855,33,33,0,3
109200,4to9,4,9,0.879241577141637,-9.91268825379397,33,33,0,2
109216,9to4,9,4,0.979000637849915,-7.58803170474855,33,33,0,3
109233,4to9,4,9,0.879241577141637,-9.91268825379397,33,33,0,2
109248,9to4,9,4,0.979000637849915,-7.58803170474855,32,32,0,3
109263,4to3,4,3,0.120758422858362,-11.8979559008873,129,129,0,2
109278,3to8,3,8,0.021793906014057,-7.79614241331218,843,843,0,3
109294,8to9,8,9,0.764587544320271,-2.89449932615566,61,61,0,4
109311,9to4,9,4,0.979000637849915,-7.58803170474855,63,63,0,3
109327,4to9,4,9,0.879241577141637,-9.91268825379397,33,33,0,2
109344,9to4,9,4,0.979000637849915,-7.58803170474855,33,33,0,3
109359,4to9,4,9,0.879241577141637,-9.91268825379397,32,32,0,2
109374,9to4,9,4,0.979000637849915,-7.58803170474855,30,30,0,3
109388,4to3,4,3,0.120758422858362,-11.8979559008873,125,125,0,2
109403,3to4,3,4,0.977423266391036,-3.99285301446634,29,29,0,3
109420,4to9,4,9,0.879241577141637,-9.91268825379397,61,61,0,2
109436,9to4,9,4,0.979000637849915,-7.58803170474855,33,33,0,3
109453,4to9,4,9,0.879241577141637,-9.91268825379397,33,33,0,2
109468,9to4,9,4,0.979000637849915,-7.58803170474855,32,32,0,3
109484,4to9,4,9,0.879241577141637,-9.91268825379397,31,31,0,2
109498,9to4,9,4,0.979000637849915,-7.58803170474855,30,30,0,3
109513,4to3,4,3,0.120758422858362,-11.8979559008873,125,125,0,2
109528,3to4,3,4,0.977423266391036,-3.99285301446634,30,30,0,3
109545,4to9,4,9,0.879241577141637,-9.91268825379397,61,61,0,2
109561,9to4,9,4,0.979000637849915,-7.58803170474855,33,33,0,3
109577,4to9,4,9,0.879241577141637,-9.91268825379397,32,32,0,2
109593,9to4,9,4,0.979000637849915,-7.58803170474855,32,32,0,3
109608,4to9,4,9,0.879241577141637,-9.91268825379397,31,31,0,2
109623,9to4,9,4,0.979000637849915,-7.58803170474855,30,30,0,3
109639,4to3,4,3,0.120758422858362,-11.8979559008873,126,126,0,2
109655,3to4,3,4,0.977423266391036,-3.99285301446634,32,32,0,3
109671,4to9,4,9,0.879241577141637,-9.91268825379397,63,63,0,2
109688,9to4,9,4,0.979000637849915,-7.58803170474855,33,33,0,3
109704,4to9,4,9,0.879241577141637,-9.91268825379397,33,33,0,2
109718,9to4,9,4,0.979000637849915,-7.58803170474855,30,30,0,3
109733,4to9,4,9,0.879241577141637,-9.91268825379397,29,29,0,2
109748,9to4,9,4,0.979000637849915,-7.58803170474855,30,30,0,3
109765,4to3,4,3,0.120758422858362,-11.8979559008873,126,126,0,2
109780,3to4,3,4,0.977423266391036,-3.99285301446634,32,32,0,3
109796,4to3,4,3,0.120758422858362,-11.8979559008873,31,31,0,2
109813,3to4,3,4,0.977423266391036,-3.99285301446634,33,33,0,3
109829,4to9,4,9,0.879241577141637,-9.91268825379397,96,96,0,2
109845,9to4,9,4,0.979000637849915,-7.58803170474855,32,32,0,3
109862,4to9,4,9,0.879241577141637,-9.91268825379397,33,33,0,2
109878,9to4,9,4,0.979000637849915,-7.58803170474855,33,33,0,3
109893,4to9,4,9,0.879241577141637,-9.91268825379397,31,31,0,2
109908,9to4,9,4,0.979000637849915,-7.58803170474855,30,30,0,3
109923,4to3,4,3,0.120758422858362,-11.8979559008873,127,127,0,2
109938,3to4,3,4,0.977423266391036,-3.99285301446634,30,30,0,3
109955,4to9,4,9,0.879241577141637,-9.91268825379397,62,62,0,2
109970,9to4,9,4,0.979000637849915,-7.58803170474855,32,32,0,3
109985,4to9,4,9,0.879241577141637,-9.91268825379397,30,30,0,2
110000,9to4,9,4,0.979000637849915,-7.58803170474855,30,30,0,3
110014,4to9,4,9,0.879241577141637,-9.91268825379397,29,29,0,2
110030,9to8,9,8,0.020143755288729,-11.47166966968,752,752,0,3
110047,8to3,8,3,0.225696151448692,-4.11464622477799,124,124,0,4
110064,3to4,3,4,0.977423266391036,-3.99285301446634,64,64,0,3
110080,4to3,4,3,0.120758422858362,-11.8979559008873,33,33,0,2
110096,3to4,3,4,0.977423266391036,-3.99285301446634,32,32,0,3
110113,4to9,4,9,0.879241577141637,-9.91268825379397,99,99,0,2
110128,9to4,9,4,0.979000637849915,-7.58803170474855,32,32,0,3
110145,4to9,4,9,0.879241577141637,-9.91268825379397,32,32,0,2
110160,9to4,9,4,0.979000637849915,-7.58803170474855,32,32,0,3
110176,4to9,4,9,0.879241577141637,-9.91268825379397,31,31,0,2
110191,9to4,9,4,0.979000637849915,-7.58803170474855,31,31,0,3
110206,4to3,4,3,0.120758422858362,-11.8979559008873,126,126,0,2
110221,3to4,3,4,0.977423266391036,-3.99285301446634,30,30,0,3
110236,4to9,4,9,0.879241577141637,-9.91268825379397,60,60,0,2
110251,9to4,9,4,0.979000637849915,-7.58803170474855,30,30,0,3
110268,4to9,4,9,0.879241577141637,-9.91268825379397,32,32,0,2
110283,9to14,9,14,0.000855606861356,-14.6305082812671,2200,2200,0,3
110300,14to13,14,13,0.036089982389885,-8.4156373239335,2201,2201,0,3
110315,13to8,13,8,0.880684965458987,-7.37455157477482,285,285,0,4
110330,8to9,8,9,0.764587544320271,-2.89449932615566,62,62,0,4
110346,9to4,9,4,0.979000637849915,-7.58803170474855,95,95,0,3
110361,4to3,4,3,0.120758422858362,-11.8979559008873,155,155,0,2
110376,3to4,3,4,0.977423266391036,-3.99285301446634,30,30,0,3
110392,4to9,4,9,0.879241577141637,-9.91268825379397,62,62,0,2
110407,9to4,9,4,0.979000637849915,-7.58803170474855,31,31,0,3
110423,4to9,4,9,0.879241577141637,-9.91268825379397,31,31,0,2
110439,9to4,9,4,0.979000637849915,-7.58803170474855,32,32,0,3
110456,4to9,4,9,0.879241577141637,-9.91268825379397,33,33,0,2
110472,9to4,9,4,0.979000637849915,-7.58803170474855,33,33,0,3
110488,4to9,4,9,0.879241577141637,-9.91268825379397,32,32,0,2
110503,9to4,9,4,0.979000637849915,-7.58803170474855,31,31,0,3
110519,4to3,4,3,0.120758422858362,-11.8979559008873,158,158,0,2
110535,3to4,3,4,0.977423266391036,-3.99285301446634,32,32,0,3
110552,4to9,4,9,0.879241577141637,-9.91268825379397,64,64,0,2
110569,9to4,9,4,0.979000637849915,-7.58803170474855,34,34,0,3
110586,4to9,4,9,0.879241577141637,-9.91268825379397,34,34,0,2
110602,9to4,9,4,0.979000637849915,-7.58803170474855,33,33,0,3
110617,4to3,4,3,0.120758422858362,-11.8979559008873,98,98,0,2
110633,3to4,3,4,0.977423266391036,-3.99285301446634,31,31,0,3
110650,4to9,4,9,0.879241577141637,-9.91268825379397,64,64,0,2
110665,9to4,9,4,0.979000637849915,-7.58803170474855,32,32,0,3
110681,4to9,4,9,0.879241577141637,-9.91268825379397,31,31,0,2
110696,9to4,9,4,0.979000637849915,-7.58803170474855,31,31,0,3
110712,4to9,4,9,0.879241577141637,-9.91268825379397,31,31,0,2
110729,9to4,9,4,0.979000637849915,-7.58803170474855,33,33,0,3
110745,4to9,4,9,0.879241577141637,-9.91268825379397,33,33,0,2
110760,9to4,9,4,0.979000637849915,-7.58803170474855,31,31,0,3
110774,4to3,4,3,0.120758422858362,-11.8979559008873,157,157,0,2
110790,3to4,3,4,0.977423266391036,-3.99285301446634,30,30,0,3
110806,4to9,4,9,0.879241577141637,-9.91268825379397,61,61,0,2
110821,9to4,9,4,0.979000637849915,-7.58803170474855,31,31,0,3
110836,4to9,4,9,0.879241577141637,-9.91268825379397,30,30,0,2
110852,9to8,9,8,0.020143755288729,-11.47166966968,537,537,0,3
110869,8to3,8,3,0.225696151448692,-4.11464622477799,95,95,0,4
110886,3to4,3,4,0.977423266391036,-3.99285301446634,65,65,0,3
110903,4to9,4,9,0.879241577141637,-9.91268825379397,67,67,0,2
110918,9to4,9,4,0.979000637849915,-7.58803170474855,32,32,0,3
110933,4to9,4,9,0.879241577141637,-9.91268825379397,30,30,0,2
110949,9to4,9,4,0.979000637849915,-7.58803170474855,31,31,0,3
110965,4to9,4,9,0.879241577141637,-9.91268825379397,32,32,0,2
110980,9to14,9,14,0.000855606861356,-14.6305082812671,697,697,0,3
110996,14to13,14,13,0.036089982389885,-8.4156373239335,696,696,0,3
111013,13to8,13,8,0.880684965458987,-7.37455157477482,161,161,0,4
111030,8to7,8,7,0.001571313504232,-9.08192396035069,2899,2899,0,4
111046,7to2,7,2,0.068354324718024,-4.92272997679187,3961,3961,0,4
111062,2to3,2,3,0.995944986265071,-3.70441168844569,193,193,0,3
111078,3to4,3,4,0.977423266391036,-3.99285301446634,129,129,0,3
111095,4to9,4,9,0.879241577141637,-9.91268825379397,130,130,0,2
111111,9to4,9,4,0.979000637849915,-7.58803170474855,33,33,0,3
111125,4to9,4,9,0.879241577141637,-9.91268825379397,30,30,0,2
111140,9to4,9,4,0.979000637849915,-7.58803170474855,29,29,0,3
111154,4to9,4,9,0.879241577141637,-9.91268825379397,29,29,0,2
111171,9to4,9,4,0.979000637849915,-7.58803170474855,31,31,0,3
111185,4to9,4,9,0.879241577141637,-9.91268825379397,31,31,0,2
111201,9to4,9,4,0.979000637849915,-7.58803170474855,30,30,0,3
111218,4to3,4,3,0.120758422858362,-11.8979559008873,156,156,0,2
111232,3to4,3,4,0.977423266391036,-3.99285301446634,31,31,0,3
111247,4to9,4,9,0.879241577141637,-9.91268825379397,62,62,0,2
111263,9to14,9,14,0.000855606861356,-14.6305082812671,283,283,0,3
111279,14to9,14,9,0.963804520342605,-5.13076416031772,32,32,0,3
111296,9to4,9,4,0.979000637849915,-7.58803170474855,64,64,0,3
111311,4to9,4,9,0.879241577141637,-9.91268825379397,32,32,0,2
111327,9to4,9,4,0.979000637849915,-7.58803170474855,31,31,0,3
111342,4to9,4,9,0.879241577141637,-9.91268825379397,31,31,0,2
111357,9to4,9,4,0.979000637849915,-7.58803170474855,30,30,0,3
111373,4to9,4,9,0.879241577141637,-9.91268825379397,31,31,0,2
111388,9to4,9,4,0.979000637849915,-7.58803170474855,31,31,0,3
111403,4to3,4,3,0.120758422858362,-11.8979559008873,185,185,0,2
111418,3to4,3,4,0.977423266391036,-3.99285301446634,30,30,0,3
111433,4to9,4,9,0.879241577141637,-9.91268825379397,60,60,0,2
111447,9to4,9,4,0.979000637849915,-7.58803170474855,29,29,0,3
111464,4to9,4,9,0.879241577141637,-9.91268825379397,31,31,0,2
111480,9to4,9,4,0.979000637849915,-7.58803170474855,33,33,0,3
111496,4to9,4,9,0.879241577141637,-9.91268825379397,32,32,0,2
111511,9to4,9,4,0.979000637849915,-7.58803170474855,31,31,0,3
111527,4to9,4,9,0.879241577141637,-9.91268825379397,31,31,0,2
111542,9to4,9,4,0.979000637849915,-7.58803170474855,31,31,0,3
111558,4to3,4,3,0.120758422858362,-11.8979559008873,155,155,0,2
111573,3to4,3,4,0.977423266391036,-3.99285301446634,31,31,0,3
111588,4to9,4,9,0.879241577141637,-9.91268825379397,61,61,0,2
111604,9to4,9,4,0.979000637849915,-7.58803170474855,31,31,0,3
111619,4to9,4,9,0.879241577141637,-9.91268825379397,31,31,0,2
111635,9to4,9,4,0.979000637849915,-7.58803170474855,31,31,0,3
111651,4to9,4,9,0.879241577141637,-9.91268825379397,32,32,0,2
111666,9to4,9,4,0.979000637849915,-7.58803170474855,31,31,0,3
111682,4to9,4,9,0.879241577141637,-9.91268825379397,31,31,0,2
111698,9to4,9,4,0.979000637849915,-7.58803170474855,32,32,0,3
111715,4to3,4,3,0.120758422858362,-11.8979559008873,157,157,0,2
111731,3to4,3,4,0.977423266391036,-3.99285301446634,33,33,0,3
111746,4to9,4,9,0.879241577141637,-9.91268825379397,64,64,0,2
111762,9to8,9,8,0.020143755288729,-11.47166966968,749,749,0,3
111778,8to9,8,9,0.764587544320271,-2.89449932615566,32,32,0,4
111794,9to4,9,4,0.979000637849915,-7.58803170474855,63,63,0,3
111810,4to9,4,9,0.879241577141637,-9.91268825379397,32,32,0,2
111825,9to4,9,4,0.979000637849915,-7.58803170474855,31,31,0,3
111842,4to3,4,3,0.120758422858362,-11.8979559008873,127,127,0,2
111858,3to4,3,4,0.977423266391036,-3.99285301446634,33,33,0,3
111873,4to9,4,9,0.879241577141637,-9.91268825379397,63,63,0,2
111889,9to4,9,4,0.979000637849915,-7.58803170474855,31,31,0,3
111905,4to9,4,9,0.879241577141637,-9.91268825379397,32,32,0,2
111921,9to4,9,4,0.979000637849915,-7.58803170474855,32,32,0,3
111937,4to3,4,3,0.120758422858362,-11.8979559008873,95,95,0,2
111954,3to4,3,4,0.977423266391036,-3.99285301446634,33,33,0,3
111970,4to9,4,9,0.879241577141637,-9.91268825379397,65,65,0,2
111985,9to4,9,4,0.979000637849915,-7.58803170474855,31,31,0,3
112001,4to3,4,3,0.120758422858362,-11.8979559008873,64,64,0,2
112016,3to4,3,4,0.977423266391036,-3.99285301446634,31,31,0,3
112031,4to9,4,9,0.879241577141637,-9.91268825379397,61,61,0,2
112046,9to14,9,14,0.00070654669403,-14.8220791624932,783,633,150,3
112061,14to13,14,13,0.036089982389885,-8.4156373239335,1065,1065,0,3
112078,13to8,13,8,0.880684965458987,-7.37455157477482,316,316,0,4
112095,8to9,8,9,0.764587544320271,-2.89449932615566,64,64,0,4
112111,9to4,9,4,0.979146692814435,-7.58803170474855,95,95,0,3
112127,4to9,4,9,0.879241577141637,-9.91268825379397,32,32,0,2
112142,9to4,9,4,0.979146692814435,-7.58803170474855,31,31,0,3
112157,4to3,4,3,0.120758422858362,-11.8979559008873,156,156,0,2
112171,3to4,3,4,0.977423266391036,-3.99285301446634,29,29,0,3
112186,4to9,4,9,0.879241577141637,-9.91268825379397,59,59,0,2
112203,9to4,9,4,0.979146692814435,-7.58803170474855,32,32,0,3
112218,4to9,4,9,0.879241577141637,-9.91268825379397,32,32,0,2
112233,9to4,9,4,0.979146692814435,-7.58803170474855,30,30,0,3
112248,4to9,4,9,0.879241577141637,-9.91268825379397,30,30,0,2
112265,9to4,9,4,0.979146692814435,-7.58803170474855,32,32,0,3
112281,4to9,4,9,0.879241577141637,-9.91268825379397,33,33,0,2
112296,9to4,9,4,0.979146692814435,-7.58803170474855,31,31,0,3
112311,4to3,4,3,0.120758422858362,-11.8979559008873,154,154,0,2
112327,3to4,3,4,0.977423266391036,-3.99285301446634,31,31,0,3
112343,4to9,4,9,0.879241577141637,-9.91268825379397,62,62,0,2
112359,9to4,9,4,0.979146692814435,-7.58803170474855,32,32,0,3
112374,4to9,4,9,0.879241577141637,-9.91268825379397,31,31,0,2
112390,9to4,9,4,0.979146692814435,-7.58803170474855,31,31,0,3
112406,4to3,4,3,0.120758422858362,-11.8979559008873,95,95,0,2
112422,3to4,3,4,0.977423266391036,-3.99285301446634,32,32,0,3
112437,4to9,4,9,0.879241577141637,-9.91268825379397,63,63,0,2
112453,9to4,9,4,0.979146692814435,-7.58803170474855,31,31,0,3
112468,4to9,4,9,0.879241577141637,-9.91268825379397,31,31,0,2
112484,9to4,9,4,0.979146692814435,-7.58803170474855,31,31,0,3
112499,4to9,4,9,0.879241577141637,-9.91268825379397,31,31,0,2
112513,9to4,9,4,0.979146692814435,-7.58803170474855,29,29,0,3
112529,4to3,4,3,0.120758422858362,-11.8979559008873,123,123,0,2
112546,3to4,3,4,0.977423266391036,-3.99285301446634,33,33,0,3
112561,4to9,4,9,0.879241577141637,-9.91268825379397,62,62,0,2
112577,9to4,9,4,0.979146692814435,-7.58803170474855,31,31,0,3
112592,4to9,4,9,0.879241577141637,-9.91268825379397,31,31,0,2
112608,9to14,9,14,0.00070654669403,-14.8220791624932,562,562,0,3
112624,14to13,14,13,0.036089982389885,-8.4156373239335,563,563,0,3
112641,13to8,13,8,0.880684965458987,-7.37455157477482,563,563,0,4
112657,8to9,8,9,0.764587544320271,-2.89449932615566,65,65,0,4
112673,9to4,9,4,0.979146692814435,-7.58803170474855,96,96,0,3
112689,4to3,4,3,0.120758422858362,-11.8979559008873,160,160,0,2
112704,3to4,3,4,0.977423266391036,-3.99285301446634,31,31,0,3
112720,4to9,4,9,0.879241577141637,-9.91268825379397,63,63,0,2
112734,9to4,9,4,0.979146692814435,-7.58803170474855,30,30,0,3
112750,4to9,4,9,0.879241577141637,-9.91268825379397,30,30,0,2
112767,9to4,9,4,0.979146692814435,-7.58803170474855,33,33,0,3
112782,4to3,4,3,0.120758422858362,-11.8979559008873,93,93,0,2
112797,3to4,3,4,0.977423266391036,-3.99285301446634,30,30,0,3
112813,4to9,4,9,0.879241577141637,-9.91268825379397,63,63,0,2
112829,9to4,9,4,0.979146692814435,-7.58803170474855,32,32,0,3
112844,4to9,4,9,0.879241577141637,-9.91268825379397,31,31,0,2
112859,9to4,9,4,0.979146692814435,-7.58803170474855,30,30,0,3
112875,4to9,4,9,0.879241577141637,-9.91268825379397,31,31,0,2
112891,9to4,9,4,0.979146692814435,-7.58803170474855,32,32,0,3
112906,4to9,4,9,0.879241577141637,-9.91268825379397,31,31,0,2
112921,9to4,9,4,0.979146692814435,-7.58803170474855,30,30,0,3
112937,4to3,4,3,0.120758422858362,-11.8979559008873,155,155,0,2
112953,3to4,3,4,0.977423266391036,-3.99285301446634,32,32,0,3
112969,4to9,4,9,0.879241577141637,-9.91268825379397,63,63,0,2
112983,9to4,9,4,0.979146692814435,-7.58803170474855,30,30,0,3
112998,4to9,4,9,0.879241577141637,-9.91268825379397,29,29,0,2
113015,9to4,9,4,0.979146692814435,-7.58803170474855,32,32,0,3
113031,4to9,4,9,0.879241577141637,-9.91268825379397,33,33,0,2
113046,9to4,9,4,0.979146692814435,-7.58803170474855,31,31,0,3
113060,4to9,4,9,0.879241577141637,-9.91268825379397,29,29,0,2
113076,9to4,9,4,0.979146692814435,-7.58803170474855,30,30,0,3
113091,4to3,4,3,0.120758422858362,-11.8979559008873,154,154,0,2
113107,3to4,3,4,0.977423266391036,-3.99285301446634,31,31,0,3
113123,4to9,4,9,0.879241577141637,-9.91268825379397,63,63,0,2
113140,9to4,9,4,0.979146692814435,-7.58803170474855,33,33,0,3
113155,4to9,4,9,0.879241577141637,-9.91268825379397,32,32,0,2
113170,9to4,9,4,0.979146692814435,-7.58803170474855,30,30,0,3
113187,4to9,4,9,0.879241577141637,-9.91268825379397,32,32,0,2
113203,9to4,9,4,0.979146692814435,-7.58803170474855,33,33,0,3
113219,4to9,4,9,0.879241577141637,-9.91268825379397,32,32,0,2
113235,9to4,9,4,0.979146692814435,-7.58803170474855,32,32,0,3
113250,4to3,4,3,0.120758422858362,-11.8979559008873,159,159,0,2
113265,3to4,3,4,0.977423266391036,-3.99285301446634,30,30,0,3
113282,4to9,4,9,0.879241577141637,-9.91268825379397,63,63,0,2
113296,9to4,9,4,0.979146692814435,-7.58803170474855,31,31,0,3
113313,4to9,4,9,0.879241577141637,-9.91268825379397,31,31,0,2
113329,9to14,9,14,0.00070654669403,-14.8220791624932,721,721,0,3
113346,14to13,14,13,0.036089982389885,-8.4156373239335,722,722,0,3
113362,13to14,13,14,0.089485556942486,-9.66117431199995,33,33,0,4
113379,14to19,14,19,3.90592739918084E-05,-15.2443940381396,23385,148,23237,3
113395,19to18,19,18,0.003643733892597,-9.38362436586338,12710,214,12496,3
113412,18to13,18,13,0.995829766189947,-3.74424906738557,66,66,0,4
113429,13to8,13,8,0.880684965458987,-7.37455157477482,788,788,0,4
113445,8to9,8,9,0.764587544320271,-2.89449932615566,132,132,0,4
113460,9to4,9,4,0.979146692814435,-7.58803170474855,164,164,0,3
113477,4to3,4,3,0.120758422858362,-11.8979559008873,227,227,0,2
113492,3to4,3,4,0.977423266391036,-3.99285301446634,32,32,0,3
113507,4to9,4,9,0.879241577141637,-9.91268825379397,62,62,0,2
113523,9to4,9,4,0.979146692814435,-7.58803170474855,31,31,0,3
113539,4to9,4,9,0.879241577141637,-9.91268825379397,32,32,0,2
113554,9to4,9,4,0.979146692814435,-7.58803170474855,31,31,0,3
113569,4to9,4,9,0.879241577141637,-9.91268825379397,30,30,0,2
113583,9to4,9,4,0.979146692814435,-7.58803170474855,29,29,0,3
113598,4to3,4,3,0.120758422858362,-11.8979559008873,121,121,0,2
113613,3to4,3,4,0.977423266391036,-3.99285301446634,30,30,0,3
113630,4to9,4,9,0.879241577141637,-9.91268825379397,61,61,0,2
113646,9to4,9,4,0.979146692814435,-7.58803170474855,33,33,0,3
113661,4to9,4,9,0.879241577141637,-9.91268825379397,31,31,0,2
113677,9to4,9,4,0.979146692814435,-7.58803170474855,31,31,0,3
113693,4to9,4,9,0.879241577141637,-9.91268825379397,32,32,0,2
113709,9to4,9,4,0.979146692814435,-7.58803170474855,32,32,0,3
113725,4to9,4,9,0.879241577141637,-9.91268825379397,32,32,0,2
113740,9to4,9,4,0.979146692814435,-7.58803170474855,31,31,0,3
113755,4to3,4,3,0.120758422858362,-11.8979559008873,157,157,0,2
113769,3to4,3,4,0.977423266391036,-3.99285301446634,29,29,0,3
113785,4to9,4,9,0.879241577141637,-9.91268825379397,60,60,0,2
113799,9to4,9,4,0.979146692814435,-7.58803170474855,30,30,0,3
113814,4to9,4,9,0.879241577141637,-9.91268825379397,29,29,0,2
113828,9to4,9,4,0.979146692814435,-7.58803170474855,29,29,0,3
113844,4to9,4,9,0.879241577141637,-9.91268825379397,30,30,0,2
113859,9to4,9,4,0.979146692814435,-7.58803170474855,31,31,0,3
113874,4to9,4,9,0.879241577141637,-9.91268825379397,30,30,0,2
113890,9to4,9,4,0.979146692814435,-7.58803170474855,31,31,0,3
113904,4to9,4,9,0.879241577141637,-9.91268825379397,30,30,0,2
113919,9to4,9,4,0.979146692814435,-7.58803170474855,29,29,0,3
113935,4to3,4,3,0.120758422858362,-11.8979559008873,180,180,0,2
113951,3to4,3,4,0.977423266391036,-3.99285301446634,32,32,0,3
113967,4to9,4,9,0.879241577141637,-9.91268825379397,63,63,0,2
113982,9to4,9,4,0.979146692814435,-7.58803170474855,31,31,0,3
113996,4to9,4,9,0.879241577141637,-9.91268825379397,29,29,0,2
114010,9to4,9,4,0.979146692814435,-7.58803170474855,28,28,0,3
114026,4to9,4,9,0.879241577141637,-9.91268825379397,30,30,0,2
114043,9to8,9,8,0.020146760491535,-11.47166966968,614,614,0,3
114060,8to3,8,3,0.225696151448692,-4.11464622477799,125,125,0,4
114076,3to4,3,4,0.977423266391036,-3.99285301446634,66,66,0,3
114093,4to9,4,9,0.879241577141637,-9.91268825379397,67,67,0,2
114108,9to4,9,4,0.979146692814435,-7.58803170474855,32,32,0,3
114125,4to9,4,9,0.879241577141637,-9.91268825379397,32,32,0,2
114141,9to8,9,8,0.020146760491535,-11.47166966968,98,98,0,3
114158,8to3,8,3,0.225696151448692,-4.11464622477799,98,98,0,4
114174,3to4,3,4,0.977423266391036,-3.99285301446634,66,66,0,3
114190,4to9,4,9,0.879241577141637,-9.91268825379397,65,65,0,2
114206,9to4,9,4,0.979146692814435,-7.58803170474855,32,32,0,3
114220,4to9,4,9,0.879241577141637,-9.91268825379397,30,30,0,2
114235,9to4,9,4,0.979146692814435,-7.58803170474855,29,29,0,3
114251,4to9,4,9,0.879241577141637,-9.91268825379397,31,31,0,2
114266,9to4,9,4,0.979146692814435,-7.58803170474855,31,31,0,3
114282,4to9,4,9,0.879241577141637,-9.91268825379397,31,31,0,2
114299,9to4,9,4,0.979146692814435,-7.58803170474855,33,33,0,3
114315,4to3,4,3,0.120758422858362,-11.8979559008873,157,157,0,2
114330,3to4,3,4,0.977423266391036,-3.99285301446634,31,31,0,3
114345,4to9,4,9,0.879241577141637,-9.91268825379397,63,63,0,2
114360,9to4,9,4,0.979146692814435,-7.58803170474855,30,30,0,3
114376,4to9,4,9,0.879241577141637,-9.91268825379397,31,31,0,2
114392,9to4,9,4,0.979146692814435,-7.58803170474855,32,32,0,3
114408,4to9,4,9,0.879241577141637,-9.91268825379397,32,32,0,2
114422,9to4,9,4,0.979146692814435,-7.58803170474855,30,30,0,3
114436,4to3,4,3,0.120758422858362,-11.8979559008873,121,121,0,2
114452,3to4,3,4,0.977423266391036,-3.99285301446634,30,30,0,3
114469,4to9,4,9,0.879241577141637,-9.91268825379397,61,61,0,2
114485,9to4,9,4,0.979146692814435,-7.58803170474855,33,33,0,3
114502,4to9,4,9,0.879241577141637,-9.91268825379397,33,33,0,2
114519,9to4,9,4,0.979146692814435,-7.58803170474855,34,34,0,3
114536,4to9,4,9,0.879241577141637,-9.91268825379397,34,34,0,2
114551,9to4,9,4,0.979146692814435,-7.58803170474855,32,32,0,3
114567,4to3,4,3,0.120758422858362,-11.8979559008873,131,131,0,2
114583,3to4,3,4,0.977423266391036,-3.99285301446634,32,32,0,3
114600,4to9,4,9,0.879241577141637,-9.91268825379397,64,64,0,2
114616,9to4,9,4,0.979146692814435,-7.58803170474855,33,33,0,3
114631,4to9,4,9,0.879241577141637,-9.91268825379397,31,31,0,2
114647,9to4,9,4,0.979146692814435,-7.58803170474855,31,31,0,3
114664,4to9,4,9,0.879241577141637,-9.91268825379397,33,33,0,2
114679,9to4,9,4,0.979146692814435,-7.58803170474855,32,32,0,3
114694,4to3,4,3,0.120758422858362,-11.8979559008873,127,127,0,2
114711,3to2,3,2,0.000782827594907,-11.1226155959287,3665,3665,0,3
114727,2to3,2,3,0.995944986265071,-3.70441168844569,33,33,0,3
114744,3to4,3,4,0.977423266391036,-3.99285301446634,65,65,0,3
114759,4to9,4,9,0.879241577141637,-9.91268825379397,95,95,0,2
114775,9to4,9,4,0.979146692814435,-7.58803170474855,31,31,0,3
114790,4to9,4,9,0.879241577141637,-9.91268825379397,31,31,0,2
114805,9to4,9,4,0.979146692814435,-7.58803170474855,30,30,0,3
114821,4to9,4,9,0.879241577141637,-9.91268825379397,31,31,0,2
114836,9to4,9,4,0.979146692814435,-7.58803170474855,31,31,0,3
114852,4to9,4,9,0.879241577141637,-9.91268825379397,31,31,0,2
114869,9to4,9,4,0.979146692814435,-7.58803170474855,33,33,0,3
114884,4to3,4,3,0.120758422858362,-11.8979559008873,157,157,0,2
114902,3to8,3,8,0.021793906014057,-7.79614241331218,761,761,0,3
114919,8to9,8,9,0.764587544320271,-2.89449932615566,67,67,0,4
114934,9to8,9,8,0.020146760491535,-11.47166966968,32,32,0,3
114951,8to13,8,13,0.008144990726805,-7.43643275329358,1539,1539,0,4
114968,13to12,13,12,0.029734736211633,-10.7629356175037,6852,6852,0,4
114983,12to17,12,17,0.002178797083144,-12.466618222052,24924,1169,23755,4
114998,17to22,17,22,0.003483691836678,-10.8199370864462,14379,285,14094,4
115015,22to21,22,21,0.101630350311606,-7.68863364578041,53971,285,53686,3
115031,21to20,21,20,0.092875576820854,-7.3053612034769,76831,284,76547,3
115047,20to15,20,15,0.730084995864726,-5.70723130816389,54036,284,53752,2
115064,15to10,15,10,0.600864222549444,-5.63191025056611,24956,252,24704,3
115080,10to11,10,11,0.669504162666101,-10.1625401714475,7948,285,7663,3
115096,11to6,11,6,0.070742348193899,-8.47007339724403,7980,218,7762,4
115111,6to5,6,5,0.057662174934699,-7.7754160351831,24987,281,24706,4
115128,5to0,5,0,0.055018535281832,-9.67210398276148,35796,282,35514,3
115146,0to1,0,1,0.141624129526044,-7.21774576207428,8046,285,7761,2
115162,1to2,1,2,0.850112695929632,-6.99282488658743,451,252,199,3
115177,2to3,2,3,0.994785989089857,-3.95697141540815,293,219,74,3
115193,3to4,3,4,0.968956774714015,-4.3200135082935,324,218,106,3
115210,4to3,4,3,0.120758422858362,-11.8979559008873,33,33,0,2
115225,3to4,3,4,0.968956774714015,-4.3200135082935,32,32,0,3
115240,4to9,4,9,0.853330926714749,-10.1369873192145,321,249,72,2
115256,9to4,9,4,0.979146692814435,-7.58803170474855,31,31,0,3
115272,4to9,4,9,0.853330926714749,-10.1369873192145,32,32,0,2
115288,9to4,9,4,0.979146692814435,-7.58803170474855,32,32,0,3
115304,4to9,4,9,0.853330926714749,-10.1369873192145,32,32,0,2
115320,9to14,9,14,0.000305102545922,-15.6622221655575,1958,313,1645,3
115335,14to9,14,9,0.963868560337125,-5.13076416031772,31,31,0,3
115352,9to4,9,4,0.979540043444992,-7.58803170474855,64,64,0,3
115368,4to3,4,3,0.146669073285251,-11.8979559008873,158,158,0,2
115383,3to4,3,4,0.968956774714015,-4.3200135082935,31,31,0,3
115398,4to9,4,9,0.853330926714749,-10.1369873192145,63,63,0,2
115413,9to4,9,4,0.979540043444992,-7.58803170474855,30,30,0,3
115429,4to9,4,9,0.853330926714749,-10.1369873192145,31,31,0,2
115447,9to4,9,4,0.979540043444992,-7.58803170474855,34,34,0,3
115464,4to9,4,9,0.853330926714749,-10.1369873192145,35,35,0,2
115479,9to4,9,4,0.979540043444992,-7.58803170474855,32,32,0,3
115494,4to3,4,3,0.146669073285251,-11.8979559008873,126,126,0,2
115510,3to8,3,8,0.029515950092424,-7.81176741331218,576,567,9,3
115524,8to3,8,3,0.225696151448692,-4.11464622477799,30,30,0,4
115541,3to4,3,4,0.969407154137243,-4.3200135082935,62,62,0,3
115557,4to9,4,9,0.853330926714749,-10.1369873192145,93,93,0,2
115573,9to4,9,4,0.979540043444992,-7.58803170474855,32,32,0,3
115588,4to9,4,9,0.853330926714749,-10.1369873192145,31,31,0,2
115604,9to4,9,4,0.979540043444992,-7.58803170474855,31,31,0,3
115619,4to9,4,9,0.853330926714749,-10.1369873192145,31,31,0,2
115636,9to4,9,4,0.979540043444992,-7.58803170474855,32,32,0,3
115652,4to3,4,3,0.146669073285251,-11.8979559008873,128,128,0,2
115669,3to8,3,8,0.029515950092424,-7.81176741331218,159,159,0,3
115684,8to9,8,9,0.764587544320271,-2.89449932615566,65,65,0,4
115702,9to4,9,4,0.979540043444992,-7.58803170474855,66,66,0,3
115718,4to9,4,9,0.853330926714749,-10.1369873192145,34,34,0,2
115732,9to4,9,4,0.979540043444992,-7.58803170474855,30,30,0,3
115747,4to9,4,9,0.853330926714749,-10.1369873192145,29,29,0,2
115762,9to4,9,4,0.979540043444992,-7.58803170474855,30,30,0,3
115777,4to3,4,3,0.146669073285251,-11.8979559008873,125,125,0,2
115793,3to4,3,4,0.969407154137243,-4.3200135082935,31,31,0,3
115809,4to9,4,9,0.853330926714749,-10.1369873192145,62,62,0,2
115825,9to4,9,4,0.979540043444992,-7.58803170474855,32,32,0,3
115842,4to9,4,9,0.853330926714749,-10.1369873192145,33,33,0,2
115857,9to4,9,4,0.979540043444992,-7.58803170474855,32,32,0,3
115872,4to9,4,9,0.853330926714749,-10.1369873192145,30,30,0,2
115887,9to4,9,4,0.979540043444992,-7.58803170474855,30,30,0,3
115904,4to9,4,9,0.853330926714749,-10.1369873192145,32,32,0,2
115919,9to4,9,4,0.979540043444992,-7.58803170474855,32,32,0,3
115934,4to3,4,3,0.146669073285251,-11.8979559008873,157,157,0,2
115950,3to4,3,4,0.969407154137243,-4.3200135082935,31,31,0,3
115966,4to9,4,9,0.853330926714749,-10.1369873192145,62,62,0,2
115982,9to4,9,4,0.979540043444992,-7.58803170474855,32,32,0,3
115998,4to9,4,9,0.853330926714749,-10.1369873192145,32,32,0,2
116013,9to4,9,4,0.979540043444992,-7.58803170474855,31,31,0,3
116029,4to9,4,9,0.853330926714749,-10.1369873192145,31,31,0,2
116044,9to4,9,4,0.979540043444992,-7.58803170474855,31,31,0,3
116060,4to3,4,3,0.146669073285251,-11.8979559008873,126,126,0,2
116075,3to4,3,4,0.969407154137243,-4.3200135082935,31,31,0,3
116090,4to9,4,9,0.853330926714749,-10.1369873192145,61,61,0,2
116105,9to4,9,4,0.979540043444992,-7.58803170474855,30,30,0,3
116120,4to9,4,9,0.853330926714749,-10.1369873192145,30,30,0,2
116135,9to4,9,4,0.979540043444992,-7.58803170474855,30,30,0,3
116150,4to9,4,9,0.853330926714749,-10.1369873192145,30,30,0,2
116165,9to4,9,4,0.979540043444992,-7.58803170474855,30,30,0,3
116180,4to3,4,3,0.146669073285251,-11.8979559008873,120,120,0,2
116196,3to8,3,8,0.029515950092424,-7.81176741331218,527,527,0,3
116211,8to9,8,9,0.764587544320271,-2.89449932615566,61,61,0,4
116227,9to4,9,4,0.979540043444992,-7.58803170474855,62,62,0,3
116241,4to3,4,3,0.146669073285251,-11.8979559008873,61,61,0,2
116256,3to4,3,4,0.969407154137243,-4.3200135082935,29,29,0,3
116272,4to9,4,9,0.853330926714749,-10.1369873192145,61,61,0,2
116288,9to4,9,4,0.979540043444992,-7.58803170474855,32,32,0,3
116305,4to9,4,9,0.853330926714749,-10.1369873192145,33,33,0,2
116320,9to4,9,4,0.979540043444992,-7.58803170474855,32,32,0,3
116335,4to9,4,9,0.853330926714749,-10.1369873192145,30,30,0,2
116350,9to4,9,4,0.979540043444992,-7.58803170474855,30,30,0,3
116365,4to3,4,3,0.146669073285251,-11.8979559008873,124,124,0,2
116380,3to4,3,4,0.969407154137243,-4.3200135082935,30,30,0,3
116395,4to9,4,9,0.853330926714749,-10.1369873192145,60,60,0,2
116410,9to4,9,4,0.979540043444992,-7.58803170474855,30,30,0,3
116424,4to9,4,9,0.853330926714749,-10.1369873192145,29,29,0,2
116440,9to4,9,4,0.979540043444992,-7.58803170474855,30,30,0,3
116456,4to9,4,9,0.853330926714749,-10.1369873192145,32,32,0,2
116471,9to4,9,4,0.979540043444992,-7.58803170474855,31,31,0,3
116487,4to3,4,3,0.146669073285251,-11.8979559008873,122,122,0,2
116502,3to4,3,4,0.969407154137243,-4.3200135082935,31,31,0,3
116518,4to9,4,9,0.853330926714749,-10.1369873192145,62,62,0,2
116533,9to4,9,4,0.979540043444992,-7.58803170474855,31,31,0,3
116548,4to9,4,9,0.853330926714749,-10.1369873192145,30,30,0,2
116563,9to4,9,4,0.979540043444992,-7.58803170474855,30,30,0,3
116579,4to9,4,9,0.853330926714749,-10.1369873192145,31,31,0,2
116595,9to4,9,4,0.979540043444992,-7.58803170474855,32,32,0,3
116611,4to3,4,3,0.146669073285251,-11.8979559008873,124,124,0,2
116627,3to2,3,2,0.001076895770333,-11.1226155959287,1465,1465,0,3
116644,2to7,2,7,0.002374973900563,-9.99686258149154,5614,1749,3865,3
116659,7to8,7,8,0.855108372325079,-2.39620659892225,463,463,0,4
116676,8to9,8,9,0.764587544320271,-2.89449932615566,97,97,0,4
116692,9to4,9,4,0.979540043444992,-7.58803170474855,97,97,0,3
116708,4to9,4,9,0.853330926714749,-10.1369873192145,32,32,0,2
116724,9to4,9,4,0.979540043444992,-7.58803170474855,32,32,0,3
116739,4to3,4,3,0.146669073285251,-11.8979559008873,128,128,0,2
116756,3to4,3,4,0.969407154137243,-4.3200135082935,32,32,0,3
116771,4to9,4,9,0.853330926714749,-10.1369873192145,63,63,0,2
116788,9to4,9,4,0.979540043444992,-7.58803170474855,32,32,0,3
116804,4to9,4,9,0.853330926714749,-10.1369873192145,33,33,0,2
116819,9to4,9,4,0.979540043444992,-7.58803170474855,31,31,0,3
116836,4to9,4,9,0.853330926714749,-10.1369873192145,32,32,0,2
116851,9to4,9,4,0.979540043444992,-7.58803170474855,32,32,0,3
116867,4to3,4,3,0.146669073285251,-11.8979559008873,128,128,0,2
116884,3to4,3,4,0.969407154137243,-4.3200135082935,33,33,0,3
116900,4to9,4,9,0.853330926714749,-10.1369873192145,64,64,0,2
116916,9to4,9,4,0.979540043444992,-7.58803170474855,32,32,0,3
116931,4to9,4,9,0.853330926714749,-10.1369873192145,31,31,0,2
116947,9to4,9,4,0.979540043444992,-7.58803170474855,31,31,0,3
116963,4to9,4,9,0.853330926714749,-10.1369873192145,32,32,0,2
116978,9to4,9,4,0.979540043444992,-7.58803170474855,31,31,0,3
116994,4to3,4,3,0.146669073285251,-11.8979559008873,127,127,0,2
117011,3to4,3,4,0.969407154137243,-4.3200135082935,33,33,0,3
117030,4to9,4,9,0.853330926714749,-10.1369873192145,67,67,0,2
117046,9to4,9,4,0.979540043444992,-7.58803170474855,35,35,0,3
117062,4to3,4,3,0.146669073285251,-11.8979559008873,68,68,0,2
117077,3to4,3,4,0.969407154137243,-4.3200135082935,31,31,0,3
117093,4to9,4,9,0.853330926714749,-10.1369873192145,63,63,0,2
117108,9to4,9,4,0.979540043444992,-7.58803170474855,31,31,0,3
117123,4to9,4,9,0.853330926714749,-10.1369873192145,30,30,0,2
117138,9to4,9,4,0.979540043444992,-7.58803170474855,30,30,0,3
117154,4to9,4,9,0.853330926714749,-10.1369873192145,31,31,0,2
117169,9to14,9,14,0.000305102545922,-15.6622221655575,1849,1849,0,3
117185,14to13,14,13,0.036092380388884,-8.4156373239335,2234,2234,0,3
117202,13to8,13,8,0.880684965458987,-7.37455157477482,543,543,0,4
117218,8to9,8,9,0.764587544320271,-2.89449932615566,64,64,0,4
117234,9to4,9,4,0.979540043444992,-7.58803170474855,96,96,0,3
117250,4to3,4,3,0.146669073285251,-11.8979559008873,188,188,0,2
117267,3to4,3,4,0.969407154137243,-4.3200135082935,33,33,0,3
117283,4to9,4,9,0.853330926714749,-10.1369873192145,65,65,0,2
117298,9to4,9,4,0.979540043444992,-7.58803170474855,31,31,0,3
117313,4to9,4,9,0.853330926714749,-10.1369873192145,30,30,0,2
117329,9to4,9,4,0.979540043444992,-7.58803170474855,31,31,0,3
117344,4to9,4,9,0.853330926714749,-10.1369873192145,31,31,0,2
117358,9to4,9,4,0.979540043444992,-7.58803170474855,29,29,0,3
117374,4to3,4,3,0.146669073285251,-11.8979559008873,124,124,0,2
117391,3to4,3,4,0.969407154137243,-4.3200135082935,33,33,0,3
117406,4to3,4,3,0.146669073285251,-11.8979559008873,32,32,0,2
117421,3to4,3,4,0.969407154137243,-4.3200135082935,30,30,0,3
117438,4to9,4,9,0.853330926714749,-10.1369873192145,94,94,0,2
117454,9to4,9,4,0.979540043444992,-7.58803170474855,33,33,0,3
117471,4to3,4,3,0.146669073285251,-11.8979559008873,65,65,0,2
117487,3to4,3,4,0.969407154137243,-4.3200135082935,33,33,0,3
117504,4to9,4,9,0.853330926714749,-10.1369873192145,66,66,0,2
117520,9to4,9,4,0.979540043444992,-7.58803170474855,33,33,0,3
117536,4to9,4,9,0.853330926714749,-10.1369873192145,32,32,0,2
117552,9to4,9,4,0.979540043444992,-7.58803170474855,32,32,0,3
117569,4to9,4,9,0.853330926714749,-10.1369873192145,33,33,0,2
117585,9to4,9,4,0.979540043444992,-7.58803170474855,33,33,0,3
117599,4to3,4,3,0.146669073285251,-11.8979559008873,128,128,0,2
117615,3to4,3,4,0.969407154137243,-4.3200135082935,30,30,0,3
117632,4to9,4,9,0.853330926714749,-10.1369873192145,63,63,0,2
117647,9to4,9,4,0.979540043444992,-7.58803170474855,32,32,0,3
117664,4to9,4,9,0.853330926714749,-10.1369873192145,32,32,0,2
117680,9to4,9,4,0.979540043444992,-7.58803170474855,33,33,0,3
117696,4to9,4,9,0.853330926714749,-10.1369873192145,32,32,0,2
117713,9to4,9,4,0.979540043444992,-7.58803170474855,33,33,0,3
117729,4to3,4,3,0.146669073285251,-11.8979559008873,130,130,0,2
117745,3to8,3,8,0.029515950092424,-7.81176741331218,543,543,0,3
117760,8to9,8,9,0.764587544320271,-2.89449932615566,64,64,0,4
117775,9to4,9,4,0.979540043444992,-7.58803170474855,62,62,0,3
117792,4to9,4,9,0.853330926714749,-10.1369873192145,32,32,0,2
117808,9to4,9,4,0.979540043444992,-7.58803170474855,33,33,0,3
117823,4to9,4,9,0.853330926714749,-10.1369873192145,31,31,0,2
117838,9to4,9,4,0.979540043444992,-7.58803170474855,30,30,0,3
117853,4to3,4,3,0.146669073285251,-11.8979559008873,124,124,0,2
117868,3to4,3,4,0.969407154137243,-4.3200135082935,30,30,0,3
117886,4to9,4,9,0.853330926714749,-10.1369873192145,63,63,0,2
117902,9to4,9,4,0.979540043444992,-7.58803170474855,34,34,0,3
117917,4to9,4,9,0.853330926714749,-10.1369873192145,31,31,0,2
117932,9to4,9,4,0.979540043444992,-7.58803170474855,30,30,0,3
117949,4to9,4,9,0.853330926714749,-10.1369873192145,32,32,0,2
117966,9to4,9,4,0.979540043444992,-7.58803170474855,34,34,0,3
117981,4to3,4,3,0.146669073285251,-11.8979559008873,128,128,0,2
117996,3to4,3,4,0.969407154137243,-4.3200135082935,30,30,0,3
118012,4to9,4,9,0.853330926714749,-10.1369873192145,63,63,0,2
118027,9to4,9,4,0.979540043444992,-7.58803170474855,31,31,0,3
118042,4to9,4,9,0.853330926714749,-10.1369873192145,30,30,0,2
118058,9to4,9,4,0.979540043444992,-7.58803170474855,31,31,0,3
118075,4to9,4,9,0.853330926714749,-10.1369873192145,33,33,0,2
118091,9to4,9,4,0.979540043444992,-7.58803170474855,33,33,0,3
118108,4to3,4,3,0.146669073285251,-11.8979559008873,127,127,0,2
118123,3to4,3,4,0.969407154137243,-4.3200135082935,32,32,0,3
118140,4to9,4,9,0.853330926714749,-10.1369873192145,65,65,0,2
118158,9to4,9,4,0.979540043444992,-7.58803170474855,35,35,0,3
118173,4to9,4,9,0.853330926714749,-10.1369873192145,33,33,0,2
118188,9to4,9,4,0.979540043444992,-7.58803170474855,30,30,0,3
118204,4to9,4,9,0.853330926714749,-10.1369873192145,31,31,0,2
118220,9to4,9,4,0.979540043444992,-7.58803170474855,32,32,0,3
118236,4to3,4,3,0.146669073285251,-11.8979559008873,128,128,0,2
118252,3to4,3,4,0.969407154137243,-4.3200135082935,32,32,0,3
118269,4to9,4,9,0.853330926714749,-10.1369873192145,65,65,0,2
118284,9to4,9,4,0.979540043444992,-7.58803170474855,32,32,0,3
118300,4to9,4,9,0.853330926714749,-10.1369873192145,31,31,0,2
118316,9to4,9,4,0.979540043444992,-7.58803170474855,32,32,0,3
118331,4to9,4,9,0.853330926714749,-10.1369873192145,31,31,0,2
118347,9to4,9,4,0.979540043444992,-7.58803170474855,31,31,0,3
118363,4to3,4,3,0.146669073285251,-11.8979559008873,127,127,0,2
118378,3to8,3,8,0.029515950092424,-7.81176741331218,633,633,0,3
118392,8to9,8,9,0.764587544320271,-2.89449932615566,61,61,0,4
118408,9to4,9,4,0.979540043444992,-7.58803170474855,61,61,0,3
118425,4to9,4,9,0.853330926714749,-10.1369873192145,33,33,0,2
118441,9to4,9,4,0.979540043444992,-7.58803170474855,33,33,0,3
118456,4to9,4,9,0.853330926714749,-10.1369873192145,31,31,0,2
118473,9to4,9,4,0.979540043444992,-7.58803170474855,32,32,0,3
118490,4to3,4,3,0.146669073285251,-11.8979559008873,127,127,0,2
118505,3to4,3,4,0.969407154137243,-4.3200135082935,32,32,0,3
118521,4to9,4,9,0.853330926714749,-10.1369873192145,65,65,0,2
118537,9to4,9,4,0.979540043444992,-7.58803170474855,32,32,0,3
118554,4to3,4,3,0.146669073285251,-11.8979559008873,64,64,0,2
118570,3to4,3,4,0.969407154137243,-4.3200135082935,33,33,0,3
118587,4to9,4,9,0.853330926714749,-10.1369873192145,66,66,0,2
118602,9to4,9,4,0.979540043444992,-7.58803170474855,32,32,0,3
118619,4to9,4,9,0.853330926714749,-10.1369873192145,32,32,0,2
118635,9to4,9,4,0.979540043444992,-7.58803170474855,33,33,0,3
118651,4to9,4,9,0.853330926714749,-10.1369873192145,32,32,0,2
118667,9to4,9,4,0.979540043444992,-7.58803170474855,32,32,0,3
118682,4to9,4,9,0.853330926714749,-10.1369873192145,31,31,0,2
118698,9to4,9,4,0.979540043444992,-7.58803170474855,31,31,0,3
118713,4to3,4,3,0.146669073285251,-11.8979559008873,159,159,0,2
118728,3to4,3,4,0.969407154137243,-4.3200135082935,30,30,0,3
118744,4to9,4,9,0.853330926714749,-10.1369873192145,62,62,0,2
118759,9to4,9,4,0.979540043444992,-7.58803170474855,31,31,0,3
118774,4to9,4,9,0.853330926714749,-10.1369873192145,30,30,0,2
118789,9to4,9,4,0.979540043444992,-7.58803170474855,30,30,0,3
118806,4to9,4,9,0.853330926714749,-10.1369873192145,32,32,0,2
118823,9to8,9,8,0.020154854009086,-11.47166966968,445,445,0,3
118839,8to3,8,3,0.225696151448692,-4.11464622477799,126,126,0,4
118855,3to4,3,4,0.969407154137243,-4.3200135082935,66,66,0,3
118871,4to9,4,9,0.853330926714749,-10.1369873192145,65,65,0,2
118886,9to4,9,4,0.979540043444992,-7.58803170474855,31,31,0,3
118901,4to9,4,9,0.853330926714749,-10.1369873192145,30,30,0,2
118917,9to4,9,4,0.979540043444992,-7.58803170474855,31,31,0,3
118933,4to9,4,9,0.853330926714749,-10.1369873192145,32,32,0,2
118949,9to4,9,4,0.979540043444992,-7.58803170474855,32,32,0,3
118965,4to3,4,3,0.146669073285251,-11.8979559008873,126,126,0,2
118983,3to8,3,8,0.029515950092424,-7.81176741331218,160,160,0,3
118998,8to9,8,9,0.764587544320271,-2.89449932615566,65,65,0,4
119013,9to4,9,4,0.979540043444992,-7.58803170474855,64,64,0,3
119028,4to3,4,3,0.146669073285251,-11.8979559008873,63,63,0,2
119043,3to4,3,4,0.969407154137243,-4.3200135082935,30,30,0,3
119059,4to9,4,9,0.853330926714749,-10.1369873192145,61,61,0,2
119074,9to4,9,4,0.979540043444992,-7.58803170474855,31,31,0,3
119089,4to9,4,9,0.853330926714749,-10.1369873192145,30,30,0,2
119104,9to4,9,4,0.979540043444992,-7.58803170474855,30,30,0,3
119121,4to9,4,9,0.853330926714749,-10.1369873192145,32,32,0,2
119137,9to4,9,4,0.979540043444992,-7.58803170474855,33,33,0,3
119152,4to3,4,3,0.146669073285251,-11.8979559008873,124,124,0,2
119168,3to4,3,4,0.969407154137243,-4.3200135082935,31,31,0,3
119184,4to9,4,9,0.853330926714749,-10.1369873192145,63,63,0,2
119199,9to4,9,4,0.979540043444992,-7.58803170474855,31,31,0,3
119215,4to9,4,9,0.853330926714749,-10.1369873192145,31,31,0,2
119231,9to4,9,4,0.979540043444992,-7.58803170474855,32,32,0,3
119246,4to9,4,9,0.853330926714749,-10.1369873192145,31,31,0,2
119261,9to4,9,4,0.979540043444992,-7.58803170474855,30,30,0,3
119276,4to9,4,9,0.853330926714749,-10.1369873192145,30,30,0,2
119291,9to4,9,4,0.979540043444992,-7.58803170474855,30,30,0,3
119306,4to3,4,3,0.146669073285251,-11.8979559008873,154,154,0,2
119321,3to4,3,4,0.969407154137243,-4.3200135082935,30,30,0,3
119337,4to9,4,9,0.853330926714749,-10.1369873192145,61,61,0,2
119353,9to4,9,4,0.979540043444992,-7.58803170474855,32,32,0,3
119368,4to9,4,9,0.853330926714749,-10.1369873192145,31,31,0,2
119386,9to4,9,4,0.979540043444992,-7.58803170474855,33,33,0,3
119403,4to9,4,9,0.853330926714749,-10.1369873192145,35,35,0,2
119419,9to4,9,4,0.979540043444992,-7.58803170474855,33,33,0,3
119435,4to3,4,3,0.146669073285251,-11.8979559008873,129,129,0,2
119452,3to4,3,4,0.969407154137243,-4.3200135082935,33,33,0,3
119468,4to9,4,9,0.853330926714749,-10.1369873192145,65,65,0,2
119483,9to4,9,4,0.979540043444992,-7.58803170474855,31,31,0,3
119498,4to9,4,9,0.853330926714749,-10.1369873192145,30,30,0,2
119514,9to4,9,4,0.979540043444992,-7.58803170474855,31,31,0,3
119529,4to9,4,9,0.853330926714749,-10.1369873192145,31,31,0,2
119545,9to4,9,4,0.979540043444992,-7.58803170474855,31,31,0,3
119560,4to3,4,3,0.146669073285251,-11.8979559008873,125,125,0,2
119576,3to8,3,8,0.029515950092424,-7.81176741331218,593,593,0,3
119591,8to9,8,9,0.764587544320271,-2.89449932615566,62,62,0,4
119607,9to4,9,4,0.979540043444992,-7.58803170474855,62,62,0,3
119622,4to9,4,9,0.853330926714749,-10.1369873192145,31,31,0,2
119637,9to4,9,4,0.979540043444992,-7.58803170474855,30,30,0,3
119655,4to9,4,9,0.853330926714749,-10.1369873192145,33,33,0,2
119671,9to4,9,4,0.979540043444992,-7.58803170474855,34,34,0,3
119687,4to3,4,3,0.146669073285251,-11.8979559008873,127,127,0,2
119702,3to4,3,4,0.969407154137243,-4.3200135082935,31,31,0,3
119720,4to9,4,9,0.853330926714749,-10.1369873192145,65,65,0,2
119734,9to4,9,4,0.979540043444992,-7.58803170474855,32,32,0,3
119749,4to9,4,9,0.853330926714749,-10.1369873192145,29,29,0,2
119764,9to4,9,4,0.979540043444992,-7.58803170474855,30,30,0,3
119779,4to9,4,9,0.853330926714749,-10.1369873192145,30,30,0,2
119795,9to4,9,4,0.979540043444992,-7.58803170474855,31,31,0,3
119810,4to3,4,3,0.146669073285251,-11.8979559008873,123,123,0,2
119826,3to4,3,4,0.969407154137243,-4.3200135082935,31,31,0,3
119842,4to9,4,9,0.853330926714749,-10.1369873192145,63,63,0,2
119857,9to4,9,4,0.979540043444992,-7.58803170474855,31,31,0,3
119873,4to9,4,9,0.853330926714749,-10.1369873192145,31,31,0,2
119889,9to4,9,4,0.979540043444992,-7.58803170474855,32,32,0,3
119905,4to9,4,9,0.853330926714749,-10.1369873192145,32,32,0,2
119921,9to4,9,4,0.979540043444992,-7.58803170474855,32,32,0,3
119937,4to3,4,3,0.146669073285251,-11.8979559008873,127,127,0,2
119953,3to4,3,4,0.969407154137243,-4.3200135082935,32,32,0,3
119969,4to9,4,9,0.853330926714749,-10.1369873192145,64,64,0,2
119985,9to4,9,4,0.979540043444992,-7.58803170474855,32,32,0,3
120002,4to9,4,9,0.853330926714749,-10.1369873192145,33,33,0,2
120019,9to4,9,4,0.979540043444992,-7.58803170474855,34,34,0,3
120035,4to3,4,3,0.146669073285251,-11.8979559008873,98,98,0,2
120052,3to4,3,4,0.969407154137243,-4.3200135082935,33,33,0,3
120067,4to9,4,9,0.853330926714749,-10.1369873192145,65,65,0,2
120083,9to4,9,4,0.979540043444992,-7.58803170474855,31,31,0,3
120099,4to9,4,9,0.853330926714749,-10.1369873192145,32,32,0,2
120115,9to4,9,4,0.979540043444992,-7.58803170474855,32,32,0,3
120129,4to9,4,9,0.853330926714749,-10.1369873192145,30,30,0,2
120146,9to4,9,4,0.979540043444992,-7.58803170474855,31,31,0,3
120163,4to9,4,9,0.853330926714749,-10.1369873192145,34,34,0,2
120180,9to4,9,4,0.979540043444992,-7.58803170474855,34,34,0,3
120196,4to9,4,9,0.853330926714749,-10.1369873192145,33,33,0,2
120212,9to4,9,4,0.979540043444992,-7.58803170474855,32,32,0,3
120229,4to3,4,3,0.146669073285251,-11.8979559008873,194,194,0,2
120246,3to8,3,8,0.029515950092424,-7.81176741331218,670,670,0,3
120262,8to9,8,9,0.764587544320271,-2.89449932615566,66,66,0,4
120279,9to4,9,4,0.979540043444992,-7.58803170474855,67,67,0,3
120295,4to9,4,9,0.853330926714749,-10.1369873192145,33,33,0,2
120311,9to4,9,4,0.979540043444992,-7.58803170474855,32,32,0,3
120326,4to9,4,9,0.853330926714749,-10.1369873192145,31,31,0,2
120341,9to4,9,4,0.979540043444992,-7.58803170474855,30,30,0,3
120358,4to3,4,3,0.146669073285251,-11.8979559008873,129,129,0,2
120374,3to8,3,8,0.029515950092424,-7.81176741331218,128,128,0,3
120390,8to9,8,9,0.764587544320271,-2.89449932615566,64,64,0,4
120405,9to4,9,4,0.979540043444992,-7.58803170474855,64,64,0,3
120419,4to9,4,9,0.853330926714749,-10.1369873192145,29,29,0,2
120434,9to4,9,4,0.979540043444992,-7.58803170474855,29,29,0,3
120450,4to9,4,9,0.853330926714749,-10.1369873192145,31,31,0,2
120466,9to4,9,4,0.979540043444992,-7.58803170474855,32,32,0,3
120482,4to3,4,3,0.146669073285251,-11.8979559008873,124,124,0,2
120497,3to4,3,4,0.969407154137243,-4.3200135082935,31,31,0,3
120513,4to9,4,9,0.853330926714749,-10.1369873192145,63,63,0,2
120528,9to4,9,4,0.979540043444992,-7.58803170474855,31,31,0,3
120544,4to9,4,9,0.853330926714749,-10.1369873192145,31,31,0,2
120560,9to4,9,4,0.979540043444992,-7.58803170474855,32,32,0,3
120577,4to9,4,9,0.853330926714749,-10.1369873192145,33,33,0,2
120594,9to4,9,4,0.979540043444992,-7.58803170474855,34,34,0,3
120609,4to3,4,3,0.146669073285251,-11.8979559008873,127,127,0,2
120627,3to4,3,4,0.969407154137243,-4.3200135082935,33,33,0,3
120643,4to9,4,9,0.853330926714749,-10.1369873192145,66,66,0,2
120658,9to4,9,4,0.979540043444992,-7.58803170474855,31,31,0,3
120675,4to9,4,9,0.853330926714749,-10.1369873192145,32,32,0,2
120690,9to8,9,8,0.020154854009086,-11.47166966968,316,316,0,3
120706,8to13,8,13,0.008144990726805,-7.43643275329358,3521,3521,0,4
120722,13to14,13,14,0.089485556942486,-9.66117431199995,3553,3553,0,4
120737,14to9,14,9,0.963868560337125,-5.13076416031772,62,62,0,3
120753,9to4,9,4,0.979540043444992,-7.58803170474855,95,95,0,3
120768,4to3,4,3,0.146669073285251,-11.8979559008873,159,159,0,2
120783,3to4,3,4,0.969407154137243,-4.3200135082935,30,30,0,3
120799,4to9,4,9,0.853330926714749,-10.1369873192145,62,62,0,2
120814,9to4,9,4,0.979540043444992,-7.58803170474855,31,31,0,3
120828,4to9,4,9,0.853330926714749,-10.1369873192145,29,29,0,2
120844,9to4,9,4,0.979540043444992,-7.58803170474855,30,30,0,3
120859,4to9,4,9,0.853330926714749,-10.1369873192145,31,31,0,2
120874,9to4,9,4,0.979540043444992,-7.58803170474855,30,30,0,3
120889,4to3,4,3,0.146669073285251,-11.8979559008873,121,121,0,2
120904,3to4,3,4,0.969407154137243,-4.3200135082935,30,30,0,3
120920,4to9,4,9,0.853330926714749,-10.1369873192145,61,61,0,2
120937,9to8,9,8,0.020154854009086,-11.47166966968,247,247,0,3
120953,8to9,8,9,0.764587544320271,-2.89449932615566,33,33,0,4
120968,9to4,9,4,0.979540043444992,-7.58803170474855,64,64,0,3
120983,4to9,4,9,0.853330926714749,-10.1369873192145,30,30,0,2
120999,9to4,9,4,0.979540043444992,-7.58803170474855,31,31,0,3
121015,4to3,4,3,0.146669073285251,-11.8979559008873,126,126,0,2
121031,3to4,3,4,0.969407154137243,-4.3200135082935,32,32,0,3
121046,4to9,4,9,0.853330926714749,-10.1369873192145,63,63,0,2
121062,9to4,9,4,0.979540043444992,-7.58803170474855,31,31,0,3
121078,4to9,4,9,0.853330926714749,-10.1369873192145,32,32,0,2
121094,9to4,9,4,0.979540043444992,-7.58803170474855,32,32,0,3
121109,4to9,4,9,0.853330926714749,-10.1369873192145,31,31,0,2
121125,9to4,9,4,0.979540043444992,-7.58803170474855,31,31,0,3
121141,4to3,4,3,0.146669073285251,-11.8979559008873,126,126,0,2
121157,3to4,3,4,0.969407154137243,-4.3200135082935,32,32,0,3
121174,4to9,4,9,0.853330926714749,-10.1369873192145,65,65,0,2
121190,9to4,9,4,0.979540043444992,-7.58803170474855,33,33,0,3
121207,4to9,4,9,0.853330926714749,-10.1369873192145,33,33,0,2
121223,9to4,9,4,0.979540043444992,-7.58803170474855,33,33,0,3
121238,4to9,4,9,0.853330926714749,-10.1369873192145,31,31,0,2
121254,9to14,9,14,0.000305102545922,-15.6622221655575,532,532,0,3
121270,14to9,14,9,0.963868560337125,-5.13076416031772,32,32,0,3
121288,9to4,9,4,0.979540043444992,-7.58803170474855,65,65,0,3
121304,4to3,4,3,0.146669073285251,-11.8979559008873,163,163,0,2
121320,3to4,3,4,0.969407154137243,-4.3200135082935,32,32,0,3
121337,4to9,4,9,0.853330926714749,-10.1369873192145,67,67,0,2
121353,9to4,9,4,0.979540043444992,-7.58803170474855,33,33,0,3
121369,4to9,4,9,0.853330926714749,-10.1369873192145,32,32,0,2
121384,9to4,9,4,0.979540043444992,-7.58803170474855,31,31,0,3
121400,4to9,4,9,0.853330926714749,-10.1369873192145,31,31,0,2
121416,9to4,9,4,0.979540043444992,-7.58803170474855,32,32,0,3
121431,4to3,4,3,0.146669073285251,-11.8979559008873,127,127,0,2
121446,3to8,3,8,0.029515950092424,-7.81176741331218,509,509,0,3
121462,8to9,8,9,0.764587544320271,-2.89449932615566,62,62,0,4
121478,9to4,9,4,0.979540043444992,-7.58803170474855,62,62,0,3
121496,4to9,4,9,0.853330926714749,-10.1369873192145,34,34,0,2
121511,9to4,9,4,0.979540043444992,-7.58803170474855,33,33,0,3
121528,4to9,4,9,0.853330926714749,-10.1369873192145,32,32,0,2
121544,9to4,9,4,0.979540043444992,-7.58803170474855,33,33,0,3
121560,4to3,4,3,0.146669073285251,-11.8979559008873,129,129,0,2
121576,3to4,3,4,0.969407154137243,-4.3200135082935,32,32,0,3
121592,4to9,4,9,0.853330926714749,-10.1369873192145,64,64,0,2
121607,9to4,9,4,0.979540043444992,-7.58803170474855,31,31,0,3
121623,4to9,4,9,0.853330926714749,-10.1369873192145,31,31,0,2
121638,9to4,9,4,0.979540043444992,-7.58803170474855,31,31,0,3
121653,4to9,4,9,0.853330926714749,-10.1369873192145,30,30,0,2
121669,9to4,9,4,0.979540043444992,-7.58803170474855,31,31,0,3
121684,4to3,4,3,0.146669073285251,-11.8979559008873,124,124,0,2
121698,3to8,3,8,0.029515950092424,-7.81176741331218,252,252,0,3
121714,8to9,8,9,0.764587544320271,-2.89449932615566,61,61,0,4
121729,9to4,9,4,0.979540043444992,-7.58803170474855,60,60,0,3
121746,4to9,4,9,0.853330926714749,-10.1369873192145,32,32,0,2
121761,9to4,9,4,0.979540043444992,-7.58803170474855,32,32,0,3
121776,4to9,4,9,0.853330926714749,-10.1369873192145,30,30,0,2
121793,9to4,9,4,0.979540043444992,-7.58803170474855,32,32,0,3
121809,4to3,4,3,0.146669073285251,-11.8979559008873,125,125,0,2
121826,3to8,3,8,0.029515950092424,-7.81176741331218,128,128,0,3
121842,8to9,8,9,0.764587544320271,-2.89449932615566,66,66,0,4
121858,9to4,9,4,0.979540043444992,-7.58803170474855,65,65,0,3
121876,4to9,4,9,0.853330926714749,-10.1369873192145,34,34,0,2
121891,9to4,9,4,0.979540043444992,-7.58803170474855,33,33,0,3
121905,4to9,4,9,0.853330926714749,-10.1369873192145,29,29,0,2
121920,9to4,9,4,0.979540043444992,-7.58803170474855,29,29,0,3
121936,4to3,4,3,0.146669073285251,-11.8979559008873,127,127,0,2
121951,3to4,3,4,0.969407154137243,-4.3200135082935,31,31,0,3
121967,4to9,4,9,0.853330926714749,-10.1369873192145,62,62,0,2
121981,9to4,9,4,0.979540043444992,-7.58803170474855,30,30,0,3
121997,4to3,4,3,0.146669073285251,-11.8979559008873,61,61,0,2
122011,3to4,3,4,0.969407154137243,-4.3200135082935,30,30,0,3
122028,4to9,4,9,0.853330926714749,-10.1369873192145,61,61,0,2
122044,9to4,9,4,0.979540043444992,-7.58803170474855,33,33,0,3
122060,4to9,4,9,0.853330926714749,-10.1369873192145,32,32,0,2
122074,9to4,9,4,0.979540043444992,-7.58803170474855,30,30,0,3
122090,4to9,4,9,0.853330926714749,-10.1369873192145,30,30,0,2
122106,9to4,9,4,0.979540043444992,-7.58803170474855,32,32,0,3
122121,4to9,4,9,0.853330926714749,-10.1369873192145,31,31,0,2
122136,9to4,9,4,0.979540043444992,-7.58803170474855,30,30,0,3
122152,4to3,4,3,0.146669073285251,-11.8979559008873,155,155,0,2
122168,3to4,3,4,0.969407154137243,-4.3200135082935,32,32,0,3
122185,4to9,4,9,0.853330926714749,-10.1369873192145,64,64,0,2
122200,9to4,9,4,0.979540043444992,-7.58803170474855,32,32,0,3
122216,4to9,4,9,0.853330926714749,-10.1369873192145,31,31,0,2
122233,9to4,9,4,0.979540043444992,-7.58803170474855,33,33,0,3
122248,4to9,4,9,0.853330926714749,-10.1369873192145,32,32,0,2
122263,9to4,9,4,0.979540043444992,-7.58803170474855,30,30,0,3
122280,4to3,4,3,0.146669073285251,-11.8979559008873,128,128,0,2
122297,3to8,3,8,0.029515950092424,-7.81176741331218,471,471,0,3
122312,8to9,8,9,0.764587544320271,-2.89449932615566,64,64,0,4
122327,9to8,9,8,0.020154854009086,-11.47166966968,30,30,0,3
122344,8to13,8,13,0.003022901012233,-8.43276974963057,1638,6,1632,4
122362,13to12,13,12,0.01120813751788,-11.7575258257807,7394,40,7354,4
122376,12to13,12,13,0.975305689097347,-6.36264020069652,32,32,0,4
122391,13to14,13,14,0.091194226792098,-9.66117431199995,1137,1137,0,4
122407,14to9,14,9,0.963868560337125,-5.13076416031772,95,95,0,3
122423,9to8,9,8,0.020154854009086,-11.47166966968,96,96,0,3
122439,8to3,8,3,0.226861680608847,-4.11464622477799,159,159,0,4
122456,3to4,3,4,0.969407154137243,-4.3200135082935,193,193,0,3
122472,4to9,4,9,0.853330926714749,-10.1369873192145,65,65,0,2
122488,9to4,9,4,0.979540043444992,-7.58803170474855,32,32,0,3
122504,4to9,4,9,0.853330926714749,-10.1369873192145,32,32,0,2
122519,9to4,9,4,0.979540043444992,-7.58803170474855,31,31,0,3
122534,4to9,4,9,0.853330926714749,-10.1369873192145,30,30,0,2
122549,9to4,9,4,0.979540043444992,-7.58803170474855,30,30,0,3
122565,4to3,4,3,0.146669073285251,-11.8979559008873,126,126,0,2
122580,3to4,3,4,0.969407154137243,-4.3200135082935,31,31,0,3
122596,4to9,4,9,0.853330926714749,-10.1369873192145,62,62,0,2
122612,9to4,9,4,0.979540043444992,-7.58803170474855,32,32,0,3
122629,4to9,4,9,0.853330926714749,-10.1369873192145,33,33,0,2
122644,9to4,9,4,0.979540043444992,-7.58803170474855,32,32,0,3
122659,4to9,4,9,0.853330926714749,-10.1369873192145,30,30,0,2
122675,9to4,9,4,0.979540043444992,-7.58803170474855,31,31,0,3
122690,4to3,4,3,0.146669073285251,-11.8979559008873,125,125,0,2
122704,3to4,3,4,0.969407154137243,-4.3200135082935,29,29,0,3
122720,4to9,4,9,0.853330926714749,-10.1369873192145,61,61,0,2
122734,9to4,9,4,0.979540043444992,-7.58803170474855,30,30,0,3
122748,4to9,4,9,0.853330926714749,-10.1369873192145,28,28,0,2
122763,9to4,9,4,0.979540043444992,-7.58803170474855,29,29,0,3
122778,4to9,4,9,0.853330926714749,-10.1369873192145,30,30,0,2
122792,9to4,9,4,0.979540043444992,-7.58803170474855,29,29,0,3
122808,4to3,4,3,0.146669073285251,-11.8979559008873,118,118,0,2
122824,3to4,3,4,0.969407154137243,-4.3200135082935,32,32,0,3
122840,4to9,4,9,0.853330926714749,-10.1369873192145,62,62,0,2
122856,9to14,9,14,0.000305102545922,-15.6622221655575,465,465,0,3
122872,14to13,14,13,0.036092380388884,-8.4156373239335,496,496,0,3
122889,13to8,13,8,0.897501085276546,-7.37455157477482,466,466,0,4
122905,8to9,8,9,0.768535990373411,-2.89449932615566,65,65,0,4
122921,9to4,9,4,0.979540043444992,-7.58803170474855,97,97,0,3
122937,4to3,4,3,0.146669073285251,-11.8979559008873,129,129,0,2
122952,3to4,3,4,0.969407154137243,-4.3200135082935,31,31,0,3
122968,4to9,4,9,0.853330926714749,-10.1369873192145,63,63,0,2
122983,9to4,9,4,0.979540043444992,-7.58803170474855,31,31,0,3
122998,4to9,4,9,0.853330926714749,-10.1369873192145,30,30,0,2
123013,9to4,9,4,0.979540043444992,-7.58803170474855,30,30,0,3
123028,4to9,4,9,0.853330926714749,-10.1369873192145,30,30,0,2
123045,9to4,9,4,0.979540043444992,-7.58803170474855,32,32,0,3
123060,4to3,4,3,0.146669073285251,-11.8979559008873,123,123,0,2
123077,3to4,3,4,0.969407154137243,-4.3200135082935,32,32,0,3
123093,4to9,4,9,0.853330926714749,-10.1369873192145,65,65,0,2
123107,9to4,9,4,0.979540043444992,-7.58803170474855,30,30,0,3
123123,4to9,4,9,0.853330926714749,-10.1369873192145,30,30,0,2
123139,9to4,9,4,0.979540043444992,-7.58803170474855,32,32,0,3
123156,4to9,4,9,0.853330926714749,-10.1369873192145,33,33,0,2
123174,9to14,9,14,0.000305102545922,-15.6622221655575,318,318,0,3
123190,14to9,14,9,0.963868560337125,-5.13076416031772,34,34,0,3
123207,9to4,9,4,0.979540043444992,-7.58803170474855,68,68,0,3
123224,4to3,4,3,0.146669073285251,-11.8979559008873,164,164,0,2
123240,3to4,3,4,0.969407154137243,-4.3200135082935,33,33,0,3
123256,4to9,4,9,0.853330926714749,-10.1369873192145,66,66,0,2
123271,9to4,9,4,0.979540043444992,-7.58803170474855,31,31,0,3
123286,4to9,4,9,0.853330926714749,-10.1369873192145,30,30,0,2
123303,9to4,9,4,0.979540043444992,-7.58803170474855,32,32,0,3
123317,4to9,4,9,0.853330926714749,-10.1369873192145,31,31,0,2
123333,9to4,9,4,0.979540043444992,-7.58803170474855,30,30,0,3
123348,4to3,4,3,0.146669073285251,-11.8979559008873,124,124,0,2
123365,3to4,3,4,0.969407154137243,-4.3200135082935,32,32,0,3
123382,4to9,4,9,0.853330926714749,-10.1369873192145,65,65,0,2
123397,9to4,9,4,0.979540043444992,-7.58803170474855,32,32,0,3
123413,4to9,4,9,0.853330926714749,-10.1369873192145,31,31,0,2
123430,9to4,9,4,0.979540043444992,-7.58803170474855,33,33,0,3
123447,4to9,4,9,0.853330926714749,-10.1369873192145,34,34,0,2
123463,9to4,9,4,0.979540043444992,-7.58803170474855,33,33,0,3
123478,4to3,4,3,0.146669073285251,-11.8979559008873,130,130,0,2
123494,3to8,3,8,0.029515950092424,-7.81176741331218,605,605,0,3
123510,8to9,8,9,0.768535990373411,-2.89449932615566,63,63,0,4
123527,9to4,9,4,0.979540043444992,-7.58803170474855,64,64,0,3
123543,4to9,4,9,0.853330926714749,-10.1369873192145,33,33,0,2
123560,9to4,9,4,0.979540043444992,-7.58803170474855,33,33,0,3
123575,4to9,4,9,0.853330926714749,-10.1369873192145,32,32,0,2
123590,9to4,9,4,0.979540043444992,-7.58803170474855,30,30,0,3
123607,4to3,4,3,0.146669073285251,-11.8979559008873,129,129,0,2
123623,3to4,3,4,0.969407154137243,-4.3200135082935,33,33,0,3
123639,4to9,4,9,0.853330926714749,-10.1369873192145,64,64,0,2
123654,9to4,9,4,0.979540043444992,-7.58803170474855,31,31,0,3
123669,4to3,4,3,0.146669073285251,-11.8979559008873,62,62,0,2
123684,3to4,3,4,0.969407154137243,-4.3200135082935,30,30,0,3
123702,4to9,4,9,0.853330926714749,-10.1369873192145,63,63,0,2
123718,9to4,9,4,0.979540043444992,-7.58803170474855,34,34,0,3
123734,4to9,4,9,0.853330926714749,-10.1369873192145,32,32,0,2
123748,9to4,9,4,0.979540043444992,-7.58803170474855,30,30,0,3
123764,4to9,4,9,0.853330926714749,-10.1369873192145,30,30,0,2
123780,9to4,9,4,0.979540043444992,-7.58803170474855,32,32,0,3
123795,4to3,4,3,0.146669073285251,-11.8979559008873,126,126,0,2
123811,3to4,3,4,0.969407154137243,-4.3200135082935,31,31,0,3
123826,4to9,4,9,0.853330926714749,-10.1369873192145,62,62,0,2
123843,9to4,9,4,0.979540043444992,-7.58803170474855,32,32,0,3
123859,4to3,4,3,0.146669073285251,-11.8979559008873,64,64,0,2
123875,3to4,3,4,0.969407154137243,-4.3200135082935,32,32,0,3
123891,4to9,4,9,0.853330926714749,-10.1369873192145,65,65,0,2
123907,9to4,9,4,0.979540043444992,-7.58803170474855,32,32,0,3
123922,4to9,4,9,0.853330926714749,-10.1369873192145,31,31,0,2
123937,9to4,9,4,0.979540043444992,-7.58803170474855,30,30,0,3
123954,4to9,4,9,0.853330926714749,-10.1369873192145,32,32,0,2
123970,9to4,9,4,0.979540043444992,-7.58803170474855,33,33,0,3
123986,4to3,4,3,0.146669073285251,-11.8979559008873,127,127,0,2
124002,3to4,3,4,0.969407154137243,-4.3200135082935,32,32,0,3
124017,4to9,4,9,0.853330926714749,-10.1369873192145,63,63,0,2
124032,9to4,9,4,0.979540043444992,-7.58803170474855,30,30,0,3
124047,4to9,4,9,0.853330926714749,-10.1369873192145,30,30,0,2
124063,9to4,9,4,0.979540043444992,-7.58803170474855,31,31,0,3
124078,4to9,4,9,0.853330926714749,-10.1369873192145,31,31,0,2
124095,9to4,9,4,0.979540043444992,-7.58803170474855,32,32,0,3
124110,4to3,4,3,0.146669073285251,-11.8979559008873,124,124,0,2
124126,3to8,3,8,0.029515950092424,-7.81176741331218,632,632,0,3
124143,8to9,8,9,0.768535990373411,-2.89449932615566,65,65,0,4
124158,9to4,9,4,0.979540043444992,-7.58803170474855,63,63,0,3
124175,4to9,4,9,0.853330926714749,-10.1369873192145,32,32,0,2
124190,9to4,9,4,0.979540043444992,-7.58803170474855,32,32,0,3
124206,4to9,4,9,0.853330926714749,-10.1369873192145,31,31,0,2
124221,9to4,9,4,0.979540043444992,-7.58803170474855,31,31,0,3
124237,4to3,4,3,0.146669073285251,-11.8979559008873,127,127,0,2
124252,3to4,3,4,0.969407154137243,-4.3200135082935,31,31,0,3
124268,4to9,4,9,0.853330926714749,-10.1369873192145,62,62,0,2
124284,9to4,9,4,0.979540043444992,-7.58803170474855,32,32,0,3
124298,4to9,4,9,0.853330926714749,-10.1369873192145,30,30,0,2
124314,9to4,9,4,0.979540043444992,-7.58803170474855,30,30,0,3
124330,4to9,4,9,0.853330926714749,-10.1369873192145,32,32,0,2
124345,9to4,9,4,0.979540043444992,-7.58803170474855,31,31,0,3
124360,4to3,4,3,0.146669073285251,-11.8979559008873,123,123,0,2
124375,3to4,3,4,0.969407154137243,-4.3200135082935,30,30,0,3
124391,4to9,4,9,0.853330926714749,-10.1369873192145,61,61,0,2
124407,9to8,9,8,0.020154854009086,-11.47166966968,281,281,0,3
124423,8to9,8,9,0.768535990373411,-2.89449932615566,32,32,0,4
124438,9to4,9,4,0.979540043444992,-7.58803170474855,63,63,0,3
124454,4to3,4,3,0.146669073285251,-11.8979559008873,94,94,0,2
124470,3to4,3,4,0.969407154137243,-4.3200135082935,32,32,0,3
124486,4to9,4,9,0.853330926714749,-10.1369873192145,63,63,0,2
124501,9to4,9,4,0.979540043444992,-7.58803170474855,31,31,0,3
124518,4to9,4,9,0.853330926714749,-10.1369873192145,32,32,0,2
124533,9to4,9,4,0.979540043444992,-7.58803170474855,32,32,0,3
124548,4to9,4,9,0.853330926714749,-10.1369873192145,30,30,0,2
124564,9to4,9,4,0.979540043444992,-7.58803170474855,31,31,0,3
124579,4to3,4,3,0.146669073285251,-11.8979559008873,125,125,0,2
124595,3to4,3,4,0.969407154137243,-4.3200135082935,31,31,0,3
124611,4to9,4,9,0.853330926714749,-10.1369873192145,63,63,0,2
124627,9to4,9,4,0.979540043444992,-7.58803170474855,32,32,0,3
124642,4to9,4,9,0.853330926714749,-10.1369873192145,31,31,0,2
124657,9to4,9,4,0.979540043444992,-7.58803170474855,30,30,0,3
124673,4to9,4,9,0.853330926714749,-10.1369873192145,31,31,0,2
124688,9to4,9,4,0.979540043444992,-7.58803170474855,31,31,0,3
124705,4to3,4,3,0.146669073285251,-11.8979559008873,126,126,0,2
124720,3to4,3,4,0.969407154137243,-4.3200135082935,32,32,0,3
124737,4to9,4,9,0.853330926714749,-10.1369873192145,64,64,0,2
124753,9to4,9,4,0.979540043444992,-7.58803170474855,33,33,0,3
124768,4to9,4,9,0.853330926714749,-10.1369873192145,31,31,0,2
124784,9to4,9,4,0.979540043444992,-7.58803170474855,31,31,0,3
124798,4to9,4,9,0.853330926714749,-10.1369873192145,30,30,0,2
124814,9to4,9,4,0.979540043444992,-7.58803170474855,30,30,0,3
124829,4to9,4,9,0.853330926714749,-10.1369873192145,31,31,0,2
124845,9to4,9,4,0.979540043444992,-7.58803170474855,31,31,0,3
124862,4to3,4,3,0.146669073285251,-11.8979559008873,157,157,0,2
124876,3to4,3,4,0.969407154137243,-4.3200135082935,31,31,0,3
124892,4to9,4,9,0.853330926714749,-10.1369873192145,63,63,0,2
124907,9to4,9,4,0.979540043444992,-7.58803170474855,31,31,0,3
124923,4to9,4,9,0.853330926714749,-10.1369873192145,31,31,0,2
124937,9to4,9,4,0.979540043444992,-7.58803170474855,30,30,0,3
124953,4to9,4,9,0.853330926714749,-10.1369873192145,30,30,0,2
124968,9to4,9,4,0.979540043444992,-7.58803170474855,31,31,0,3
124982,4to3,4,3,0.146669073285251,-11.8979559008873,120,120,0,2
124998,3to8,3,8,0.029515950092424,-7.81176741331218,591,591,0,3
125014,8to9,8,9,0.768535990373411,-2.89449932615566,61,61,0,4
125030,9to4,9,4,0.979540043444992,-7.58803170474855,62,62,0,3
125045,4to9,4,9,0.853330926714749,-10.1369873192145,31,31,0,2
125060,9to4,9,4,0.979540043444992,-7.58803170474855,30,30,0,3
125076,4to9,4,9,0.853330926714749,-10.1369873192145,31,31,0,2
125090,9to4,9,4,0.979540043444992,-7.58803170474855,30,30,0,3
125105,4to3,4,3,0.146669073285251,-11.8979559008873,123,123,0,2
125120,3to4,3,4,0.969407154137243,-4.3200135082935,30,30,0,3
125137,4to9,4,9,0.853330926714749,-10.1369873192145,61,61,0,2
125153,9to4,9,4,0.979540043444992,-7.58803170474855,33,33,0,3
125170,4to9,4,9,0.853330926714749,-10.1369873192145,33,33,0,2
125186,9to4,9,4,0.979540043444992,-7.58803170474855,33,33,0,3
125202,4to9,4,9,0.853330926714749,-10.1369873192145,32,32,0,2
125218,9to4,9,4,0.979540043444992,-7.58803170474855,32,32,0,3
125234,4to3,4,3,0.146669073285251,-11.8979559008873,129,129,0,2
125251,3to4,3,4,0.969407154137243,-4.3200135082935,33,33,0,3
125267,4to9,4,9,0.853330926714749,-10.1369873192145,65,65,0,2
125283,9to4,9,4,0.979540043444992,-7.58803170474855,32,32,0,3
125299,4to9,4,9,0.853330926714749,-10.1369873192145,32,32,0,2
125314,9to4,9,4,0.979540043444992,-7.58803170474855,31,31,0,3
125329,4to9,4,9,0.853330926714749,-10.1369873192145,30,30,0,2
125344,9to4,9,4,0.979540043444992,-7.58803170474855,30,30,0,3
125361,4to3,4,3,0.146669073285251,-11.8979559008873,127,127,0,2
125377,3to4,3,4,0.969407154137243,-4.3200135082935,33,33,0,3
125395,4to9,4,9,0.853330926714749,-10.1369873192145,66,66,0,2
125410,9to4,9,4,0.979540043444992,-7.58803170474855,33,33,0,3
125426,4to9,4,9,0.853330926714749,-10.1369873192145,31,31,0,2
125442,9to4,9,4,0.979540043444992,-7.58803170474855,32,32,0,3
125459,4to9,4,9,0.853330926714749,-10.1369873192145,33,33,0,2
125474,9to4,9,4,0.979540043444992,-7.58803170474855,32,32,0,3
125490,4to3,4,3,0.146669073285251,-11.8979559008873,129,129,0,2
125506,3to4,3,4,0.969407154137243,-4.3200135082935,32,32,0,3
125522,4to9,4,9,0.853330926714749,-10.1369873192145,63,63,0,2
125538,9to4,9,4,0.979540043444992,-7.58803170474855,32,32,0,3
125553,4to9,4,9,0.853330926714749,-10.1369873192145,31,31,0,2
125569,9to4,9,4,0.979540043444992,-7.58803170474855,31,31,0,3
125584,4to9,4,9,0.853330926714749,-10.1369873192145,31,31,0,2
125599,9to8,9,8,0.020154854009086,-11.47166966968,601,601,0,3
125615,8to9,8,9,0.768535990373411,-2.89449932615566,31,31,0,4
125631,9to4,9,4,0.979540043444992,-7.58803170474855,62,62,0,3
125646,4to3,4,3,0.146669073285251,-11.8979559008873,156,156,0,2
125663,3to8,3,8,0.029515950092424,-7.81176741331218,64,64,0,3
125678,8to9,8,9,0.768535990373411,-2.89449932615566,63,63,0,4
125695,9to4,9,4,0.979540043444992,-7.58803170474855,64,64,0,3
125711,4to9,4,9,0.853330926714749,-10.1369873192145,33,33,0,2
125726,9to4,9,4,0.979540043444992,-7.58803170474855,31,31,0,3
125741,4to9,4,9,0.853330926714749,-10.1369873192145,30,30,0,2
125758,9to4,9,4,0.979540043444992,-7.58803170474855,32,32,0,3
125775,4to3,4,3,0.146669073285251,-11.8979559008873,129,129,0,2
125790,3to4,3,4,0.969407154137243,-4.3200135082935,32,32,0,3
125805,4to9,4,9,0.853330926714749,-10.1369873192145,64,64,0,2
125822,9to4,9,4,0.979540043444992,-7.58803170474855,32,32,0,3
125838,4to9,4,9,0.853330926714749,-10.1369873192145,33,33,0,2
125853,9to14,9,14,0.000305102545922,-15.6622221655575,2679,2679,0,3
125870,14to13,14,13,0.036092380388884,-8.4156373239335,2998,2998,0,3
125886,13to8,13,8,0.897501085276546,-7.37455157477482,223,223,0,4
125903,8to9,8,9,0.768535990373411,-2.89449932615566,65,65,0,4
125920,9to4,9,4,0.979540043444992,-7.58803170474855,98,98,0,3
125936,4to3,4,3,0.146669073285251,-11.8979559008873,161,161,0,2
125951,3to4,3,4,0.969407154137243,-4.3200135082935,31,31,0,3
125967,4to3,4,3,0.146669073285251,-11.8979559008873,31,31,0,2
125983,3to4,3,4,0.969407154137243,-4.3200135082935,32,32,0,3
126000,4to9,4,9,0.853330926714749,-10.1369873192145,97,97,0,2
126016,9to4,9,4,0.979540043444992,-7.58803170474855,33,33,0,3
126031,4to9,4,9,0.853330926714749,-10.1369873192145,31,31,0,2
126047,9to4,9,4,0.979540043444992,-7.58803170474855,31,31,0,3
126064,4to9,4,9,0.853330926714749,-10.1369873192145,33,33,0,2
126080,9to4,9,4,0.979540043444992,-7.58803170474855,33,33,0,3
126097,4to3,4,3,0.146669073285251,-11.8979559008873,130,130,0,2
126112,3to4,3,4,0.969407154137243,-4.3200135082935,32,32,0,3
126130,4to9,4,9,0.853330926714749,-10.1369873192145,66,66,0,2
126144,9to4,9,4,0.979540043444992,-7.58803170474855,32,32,0,3
126160,4to9,4,9,0.853330926714749,-10.1369873192145,30,30,0,2
126176,9to4,9,4,0.979540043444992,-7.58803170474855,32,32,0,3
126192,4to9,4,9,0.853330926714749,-10.1369873192145,32,32,0,2
126208,9to4,9,4,0.979540043444992,-7.58803170474855,32,32,0,3
126224,4to3,4,3,0.146669073285251,-11.8979559008873,127,127,0,2
126239,3to4,3,4,0.969407154137243,-4.3200135082935,31,31,0,3
126254,4to9,4,9,0.853330926714749,-10.1369873192145,62,62,0,2
126270,9to4,9,4,0.979540043444992,-7.58803170474855,31,31,0,3
126287,4to9,4,9,0.853330926714749,-10.1369873192145,33,33,0,2
126304,9to14,9,14,0.000305102545922,-15.6622221655575,451,451,0,3
126319,14to9,14,9,0.963868560337125,-5.13076416031772,32,32,0,3
126336,9to4,9,4,0.979540043444992,-7.58803170474855,66,66,0,3
126352,4to3,4,3,0.146669073285251,-11.8979559008873,128,128,0,2
126366,3to4,3,4,0.969407154137243,-4.3200135082935,30,30,0,3
126382,4to9,4,9,0.853330926714749,-10.1369873192145,63,63,0,2
126397,9to4,9,4,0.979540043444992,-7.58803170474855,31,31,0,3
126412,4to9,4,9,0.853330926714749,-10.1369873192145,30,30,0,2
126427,9to4,9,4,0.979540043444992,-7.58803170474855,30,30,0,3
126442,4to9,4,9,0.853330926714749,-10.1369873192145,30,30,0,2
126457,9to4,9,4,0.979540043444992,-7.58803170474855,30,30,0,3
126473,4to3,4,3,0.146669073285251,-11.8979559008873,121,121,0,2
126490,3to8,3,8,0.029515950092424,-7.81176741331218,604,604,0,3
126505,8to9,8,9,0.768535990373411,-2.89449932615566,63,63,0,4
126522,9to4,9,4,0.979540043444992,-7.58803170474855,65,65,0,3
126539,4to9,4,9,0.853330926714749,-10.1369873192145,34,34,0,2
126555,9to4,9,4,0.979540043444992,-7.58803170474855,33,33,0,3
126570,4to3,4,3,0.146669073285251,-11.8979559008873,97,97,0,2
126586,3to4,3,4,0.969407154137243,-4.3200135082935,31,31,0,3
126602,4to9,4,9,0.853330926714749,-10.1369873192145,63,63,0,2
126618,9to4,9,4,0.979540043444992,-7.58803170474855,32,32,0,3
126635,4to9,4,9,0.853330926714749,-10.1369873192145,33,33,0,2
126651,9to4,9,4,0.979540043444992,-7.58803170474855,33,33,0,3
126667,4to9,4,9,0.853330926714749,-10.1369873192145,32,32,0,2
126682,9to4,9,4,0.979540043444992,-7.58803170474855,31,31,0,3
126698,4to3,4,3,0.146669073285251,-11.8979559008873,128,128,0,2
126712,3to4,3,4,0.969407154137243,-4.3200135082935,30,30,0,3
126727,4to9,4,9,0.853330926714749,-10.1369873192145,60,60,0,2
126743,9to4,9,4,0.979540043444992,-7.58803170474855,31,31,0,3
126759,4to9,4,9,0.853330926714749,-10.1369873192145,32,32,0,2
126775,9to4,9,4,0.979540043444992,-7.58803170474855,32,32,0,3
126792,4to9,4,9,0.853330926714749,-10.1369873192145,33,33,0,2
126806,9to4,9,4,0.979540043444992,-7.58803170474855,31,31,0,3
126822,4to3,4,3,0.146669073285251,-11.8979559008873,124,124,0,2
126838,3to4,3,4,0.969407154137243,-4.3200135082935,32,32,0,3
126853,4to9,4,9,0.853330926714749,-10.1369873192145,61,61,0,2
126870,9to4,9,4,0.979540043444992,-7.58803170474855,32,32,0,3
126886,4to9,4,9,0.853330926714749,-10.1369873192145,33,33,0,2
126902,9to4,9,4,0.979540043444992,-7.58803170474855,32,32,0,3
126917,4to9,4,9,0.853330926714749,-10.1369873192145,31,31,0,2
126933,9to4,9,4,0.979540043444992,-7.58803170474855,31,31,0,3
126949,4to3,4,3,0.146669073285251,-11.8979559008873,127,127,0,2
126965,3to4,3,4,0.969407154137243,-4.3200135082935,32,32,0,3
126981,4to9,4,9,0.853330926714749,-10.1369873192145,64,64,0,2
126998,9to4,9,4,0.979540043444992,-7.58803170474855,33,33,0,3
127013,4to9,4,9,0.853330926714749,-10.1369873192145,32,32,0,2
127028,9to4,9,4,0.979540043444992,-7.58803170474855,30,30,0,3
127044,4to9,4,9,0.853330926714749,-10.1369873192145,31,31,0,2
127060,9to4,9,4,0.979540043444992,-7.58803170474855,32,32,0,3
127075,4to3,4,3,0.146669073285251,-11.8979559008873,126,126,0,2
127092,3to8,3,8,0.029515950092424,-7.81176741331218,602,602,0,3
127108,8to9,8,9,0.768535990373411,-2.89449932615566,64,64,0,4
127123,9to4,9,4,0.979540043444992,-7.58803170474855,63,63,0,3
127138,4to9,4,9,0.853330926714749,-10.1369873192145,30,30,0,2
127153,9to4,9,4,0.979540043444992,-7.58803170474855,30,30,0,3
127170,4to9,4,9,0.853330926714749,-10.1369873192145,32,32,0,2
127185,9to4,9,4,0.979540043444992,-7.58803170474855,32,32,0,3
127202,4to3,4,3,0.146669073285251,-11.8979559008873,127,127,0,2
127218,3to4,3,4,0.969407154137243,-4.3200135082935,33,33,0,3
127235,4to9,4,9,0.853330926714749,-10.1369873192145,65,65,0,2
127250,9to4,9,4,0.979540043444992,-7.58803170474855,32,32,0,3
127266,4to9,4,9,0.853330926714749,-10.1369873192145,31,31,0,2
127281,9to4,9,4,0.979540043444992,-7.58803170474855,31,31,0,3
127297,4to9,4,9,0.853330926714749,-10.1369873192145,31,31,0,2
127313,9to4,9,4,0.979540043444992,-7.58803170474855,32,32,0,3
127327,4to3,4,3,0.146669073285251,-11.8979559008873,125,125,0,2
127343,3to4,3,4,0.969407154137243,-4.3200135082935,30,30,0,3
127359,4to3,4,3,0.146669073285251,-11.8979559008873,32,32,0,2
127374,3to4,3,4,0.969407154137243,-4.3200135082935,31,31,0,3
127391,4to9,4,9,0.853330926714749,-10.1369873192145,94,94,0,2
127407,9to4,9,4,0.979540043444992,-7.58803170474855,33,33,0,3
127421,4to9,4,9,0.853330926714749,-10.1369873192145,30,30,0,2
127436,9to4,9,4,0.979540043444992,-7.58803170474855,29,29,0,3
127451,4to9,4,9,0.853330926714749,-10.1369873192145,30,30,0,2
127467,9to4,9,4,0.979540043444992,-7.58803170474855,31,31,0,3
127483,4to3,4,3,0.146669073285251,-11.8979559008873,124,124,0,2
127498,3to4,3,4,0.969407154137243,-4.3200135082935,31,31,0,3
127513,4to9,4,9,0.853330926714749,-10.1369873192145,62,62,0,2
127529,9to4,9,4,0.979540043444992,-7.58803170474855,31,31,0,3
127545,4to9,4,9,0.853330926714749,-10.1369873192145,32,32,0,2
127559,9to4,9,4,0.979540043444992,-7.58803170474855,30,30,0,3
127574,4to9,4,9,0.853330926714749,-10.1369873192145,29,29,0,2
127589,9to4,9,4,0.979540043444992,-7.58803170474855,30,30,0,3
127606,4to3,4,3,0.146669073285251,-11.8979559008873,123,123,0,2
127620,3to4,3,4,0.969407154137243,-4.3200135082935,31,31,0,3
127636,4to3,4,3,0.146669073285251,-11.8979559008873,30,30,0,2
127651,3to2,3,2,0.001076895770333,-11.1226155959287,11024,11024,0,3
127667,2to7,2,7,0.001422317589326,-10.5105158519261,11023,5361,5662,3
127682,7to6,7,6,0.004540155103826,-7.63796705531162,12586,5394,7192,4
127698,6to11,6,11,0.063372108493635,-7.72798927947644,12618,5490,7128,4
127715,11to12,11,12,0.81671866736625,-6.02382308801248,5353,5353,0,4
127730,12to13,12,13,0.975305689097347,-6.36264020069652,1860,1860,0,4
127745,13to8,13,8,0.897501085276546,-7.37455157477482,653,653,0,4
127761,8to9,8,9,0.768535990373411,-2.89449932615566,187,187,0,4
127777,9to4,9,4,0.979540043444992,-7.58803170474855,157,157,0,3
127793,4to3,4,3,0.146669073285251,-11.8979559008873,157,157,0,2
127809,3to2,3,2,0.001076895770333,-11.1226155959287,158,158,0,3
127825,2to3,2,3,0.99807865202861,-3.95697141540815,32,32,0,3
127842,3to4,3,4,0.969407154137243,-4.3200135082935,65,65,0,3
127859,4to9,4,9,0.853330926714749,-10.1369873192145,98,98,0,2
127875,9to4,9,4,0.979540043444992,-7.58803170474855,33,33,0,3
127890,4to9,4,9,0.853330926714749,-10.1369873192145,31,31,0,2
127907,9to4,9,4,0.979540043444992,-7.58803170474855,32,32,0,3
127923,4to9,4,9,0.853330926714749,-10.1369873192145,33,33,0,2
127938,9to4,9,4,0.979540043444992,-7.58803170474855,31,31,0,3
127954,4to3,4,3,0.146669073285251,-11.8979559008873,129,129,0,2
127969,3to4,3,4,0.969407154137243,-4.3200135082935,31,31,0,3
127985,4to9,4,9,0.853330926714749,-10.1369873192145,62,62,0,2
128002,9to14,9,14,0.000305102545922,-15.6622221655575,1698,1698,0,3
128018,14to9,14,9,0.963868560337125,-5.13076416031772,33,33,0,3
128035,9to4,9,4,0.979540043444992,-7.58803170474855,66,66,0,3
128049,4to9,4,9,0.853330926714749,-10.1369873192145,31,31,0,2
128064,9to4,9,4,0.979540043444992,-7.58803170474855,29,29,0,3
128080,4to3,4,3,0.146669073285251,-11.8979559008873,126,126,0,2
128097,3to8,3,8,0.029515950092424,-7.81176741331218,352,352,0,3
128111,8to9,8,9,0.768535990373411,-2.89449932615566,62,62,0,4
128127,9to4,9,4,0.979540043444992,-7.58803170474855,63,63,0,3
128142,4to9,4,9,0.853330926714749,-10.1369873192145,31,31,0,2
128157,9to4,9,4,0.979540043444992,-7.58803170474855,30,30,0,3
128173,4to9,4,9,0.853330926714749,-10.1369873192145,31,31,0,2
128188,9to4,9,4,0.979540043444992,-7.58803170474855,31,31,0,3
128204,4to3,4,3,0.146669073285251,-11.8979559008873,124,124,0,2
128220,3to4,3,4,0.969407154137243,-4.3200135082935,32,32,0,3
128237,4to9,4,9,0.853330926714749,-10.1369873192145,64,64,0,2
128253,9to4,9,4,0.979540043444992,-7.58803170474855,33,33,0,3
128267,4to3,4,3,0.146669073285251,-11.8979559008873,63,63,0,2
128283,3to4,3,4,0.969407154137243,-4.3200135082935,30,30,0,3
128299,4to9,4,9,0.853330926714749,-10.1369873192145,62,62,0,2
128315,9to4,9,4,0.979540043444992,-7.58803170474855,32,32,0,3
128331,4to9,4,9,0.853330926714749,-10.1369873192145,32,32,0,2
128346,9to4,9,4,0.979540043444992,-7.58803170474855,31,31,0,3
128361,4to9,4,9,0.853330926714749,-10.1369873192145,30,30,0,2
128376,9to4,9,4,0.979540043444992,-7.58803170474855,30,30,0,3
128392,4to3,4,3,0.146669073285251,-11.8979559008873,125,125,0,2
128408,3to4,3,4,0.969407154137243,-4.3200135082935,32,32,0,3
128425,4to9,4,9,0.853330926714749,-10.1369873192145,64,64,0,2
128440,9to4,9,4,0.979540043444992,-7.58803170474855,32,32,0,3
128456,4to9,4,9,0.853330926714749,-10.1369873192145,31,31,0,2
128472,9to14,9,14,0.000305102545922,-15.6622221655575,470,470,0,3
128487,14to13,14,13,0.036092380388884,-8.4156373239335,757,757,0,3
128502,13to8,13,8,0.897501085276546,-7.37455157477482,405,405,0,4
128518,8to9,8,9,0.768535990373411,-2.89449932615566,62,62,0,4
128535,9to4,9,4,0.979540043444992,-7.58803170474855,95,95,0,3
128551,4to3,4,3,0.146669073285251,-11.8979559008873,159,159,0,2
128566,3to4,3,4,0.969407154137243,-4.3200135082935,31,31,0,3
128582,4to9,4,9,0.853330926714749,-10.1369873192145,64,64,0,2
128597,9to4,9,4,0.979540043444992,-7.58803170474855,31,31,0,3
128614,4to9,4,9,0.853330926714749,-10.1369873192145,32,32,0,2
128629,9to8,9,8,0.020154854009086,-11.47166966968,127,127,0,3
128645,8to3,8,3,0.226861680608847,-4.11464622477799,94,94,0,4
128662,3to4,3,4,0.969407154137243,-4.3200135082935,65,65,0,3
128678,4to9,4,9,0.853330926714749,-10.1369873192145,64,64,0,2
128695,9to4,9,4,0.979540043444992,-7.58803170474855,33,33,0,3
128712,4to9,4,9,0.853330926714749,-10.1369873192145,34,34,0,2
128728,9to4,9,4,0.979540043444992,-7.58803170474855,33,33,0,3
128744,4to9,4,9,0.853330926714749,-10.1369873192145,32,32,0,2
128759,9to4,9,4,0.979540043444992,-7.58803170474855,31,31,0,3
128774,4to3,4,3,0.146669073285251,-11.8979559008873,129,129,0,2
128790,3to4,3,4,0.969407154137243,-4.3200135082935,31,31,0,3
128806,4to9,4,9,0.853330926714749,-10.1369873192145,62,62,0,2
128821,9to4,9,4,0.979540043444992,-7.58803170474855,31,31,0,3
128836,4to9,4,9,0.853330926714749,-10.1369873192145,30,30,0,2
128851,9to4,9,4,0.979540043444992,-7.58803170474855,30,30,0,3
128866,4to9,4,9,0.853330926714749,-10.1369873192145,30,30,0,2
128883,9to4,9,4,0.979540043444992,-7.58803170474855,32,32,0,3
128899,4to3,4,3,0.146669073285251,-11.8979559008873,125,125,0,2
128916,3to4,3,4,0.969407154137243,-4.3200135082935,33,33,0,3
128933,4to9,4,9,0.853330926714749,-10.1369873192145,67,67,0,2
128948,9to4,9,4,0.979540043444992,-7.58803170474855,32,32,0,3
128964,4to9,4,9,0.853330926714749,-10.1369873192145,31,31,0,2
128980,9to4,9,4,0.979540043444992,-7.58803170474855,32,32,0,3
128994,4to9,4,9,0.853330926714749,-10.1369873192145,30,30,0,2
129011,9to4,9,4,0.979540043444992,-7.58803170474855,31,31,0,3
129027,4to3,4,3,0.146669073285251,-11.8979559008873,128,128,0,2
129043,3to4,3,4,0.969407154137243,-4.3200135082935,32,32,0,3
129060,4to9,4,9,0.853330926714749,-10.1369873192145,66,66,0,2
129076,9to14,9,14,0.000305102545922,-15.6622221655575,604,604,0,3
129093,14to13,14,13,0.036092380388884,-8.4156373239335,606,606,0,3
129109,13to8,13,8,0.897501085276546,-7.37455157477482,480,480,0,4
129126,8to9,8,9,0.768535990373411,-2.89449932615566,66,66,0,4
129143,9to4,9,4,0.979540043444992,-7.58803170474855,100,100,0,3
129159,4to3,4,3,0.146669073285251,-11.8979559008873,132,132,0,2
129176,3to4,3,4,0.969407154137243,-4.3200135082935,33,33,0,3
129192,4to9,4,9,0.853330926714749,-10.1369873192145,66,66,0,2
129206,9to4,9,4,0.979540043444992,-7.58803170474855,30,30,0,3
129222,4to9,4,9,0.853330926714749,-10.1369873192145,30,30,0,2
129238,9to4,9,4,0.979540043444992,-7.58803170474855,32,32,0,3
129255,4to9,4,9,0.853330926714749,-10.1369873192145,33,33,0,2
129270,9to4,9,4,0.979540043444992,-7.58803170474855,32,32,0,3
129285,4to3,4,3,0.146669073285251,-11.8979559008873,126,126,0,2
129300,3to4,3,4,0.969407154137243,-4.3200135082935,30,30,0,3
129316,4to9,4,9,0.853330926714749,-10.1369873192145,61,61,0,2
129331,9to4,9,4,0.979540043444992,-7.58803170474855,31,31,0,3
129348,4to9,4,9,0.853330926714749,-10.1369873192145,32,32,0,2
129364,9to4,9,4,0.979540043444992,-7.58803170474855,33,33,0,3
129380,4to9,4,9,0.853330926714749,-10.1369873192145,32,32,0,2
129396,9to4,9,4,0.979540043444992,-7.58803170474855,32,32,0,3
129410,4to3,4,3,0.146669073285251,-11.8979559008873,125,125,0,2
129425,3to4,3,4,0.969407154137243,-4.3200135082935,29,29,0,3
129441,4to9,4,9,0.853330926714749,-10.1369873192145,61,61,0,2
129456,9to4,9,4,0.979540043444992,-7.58803170474855,31,31,0,3
129470,4to9,4,9,0.853330926714749,-10.1369873192145,29,29,0,2
129485,9to4,9,4,0.979540043444992,-7.58803170474855,29,29,0,3
129500,4to9,4,9,0.853330926714749,-10.1369873192145,30,30,0,2
129517,9to4,9,4,0.979540043444992,-7.58803170474855,32,32,0,3
129534,4to3,4,3,0.146669073285251,-11.8979559008873,124,124,0,2
129549,3to4,3,4,0.969407154137243,-4.3200135082935,32,32,0,3
129565,4to9,4,9,0.853330926714749,-10.1369873192145,65,65,0,2
129581,9to4,9,4,0.979540043444992,-7.58803170474855,32,32,0,3
129596,4to9,4,9,0.853330926714749,-10.1369873192145,31,31,0,2
129611,9to4,9,4,0.979540043444992,-7.58803170474855,30,30,0,3
129628,4to9,4,9,0.853330926714749,-10.1369873192145,32,32,0,2
129644,9to4,9,4,0.979540043444992,-7.58803170474855,33,33,0,3
129661,4to3,4,3,0.146669073285251,-11.8979559008873,127,127,0,2
129677,3to4,3,4,0.969407154137243,-4.3200135082935,33,33,0,3
129693,4to9,4,9,0.853330926714749,-10.1369873192145,65,65,0,2
129708,9to4,9,4,0.979540043444992,-7.58803170474855,31,31,0,3
129723,4to9,4,9,0.853330926714749,-10.1369873192145,30,30,0,2
129740,9to4,9,4,0.979540043444992,-7.58803170474855,32,32,0,3
129756,4to9,4,9,0.853330926714749,-10.1369873192145,33,33,0,2
129771,9to4,9,4,0.979540043444992,-7.58803170474855,31,31,0,3
129788,4to3,4,3,0.146669073285251,-11.8979559008873,127,127,0,2
129803,3to8,3,8,0.029515950092424,-7.81176741331218,694,694,0,3
129820,8to9,8,9,0.768535990373411,-2.89449932615566,64,64,0,4
129837,9to4,9,4,0.979540043444992,-7.58803170474855,66,66,0,3
129854,4to9,4,9,0.853330926714749,-10.1369873192145,34,34,0,2
129869,9to4,9,4,0.979540043444992,-7.58803170474855,32,32,0,3
129883,4to9,4,9,0.853330926714749,-10.1369873192145,29,29,0,2
129898,9to4,9,4,0.979540043444992,-7.58803170474855,29,29,0,3
129914,4to3,4,3,0.146669073285251,-11.8979559008873,126,126,0,2
129930,3to4,3,4,0.969407154137243,-4.3200135082935,32,32,0,3
129947,4to9,4,9,0.853330926714749,-10.1369873192145,64,64,0,2
129963,9to4,9,4,0.979540043444992,-7.58803170474855,33,33,0,3
129978,4to9,4,9,0.853330926714749,-10.1369873192145,31,31,0,2
129995,9to4,9,4,0.979540043444992,-7.58803170474855,32,32,0,3
130011,4to9,4,9,0.853330926714749,-10.1369873192145,33,33,0,2
130026,9to4,9,4,0.979540043444992,-7.58803170474855,31,31,0,3
130041,4to3,4,3,0.146669073285251,-11.8979559008873,127,127,0,2
130057,3to4,3,4,0.969407154137243,-4.3200135082935,31,31,0,3
130072,4to3,4,3,0.146669073285251,-11.8979559008873,31,31,0,2
130088,3to4,3,4,0.969407154137243,-4.3200135082935,31,31,0,3
130105,4to9,4,9,0.853330926714749,-10.1369873192145,94,94,0,2
130120,9to4,9,4,0.979540043444992,-7.58803170474855,32,32,0,3
130135,4to9,4,9,0.853330926714749,-10.1369873192145,30,30,0,2
130150,9to4,9,4,0.979540043444992,-7.58803170474855,30,30,0,3
130166,4to9,4,9,0.853330926714749,-10.1369873192145,31,31,0,2
130182,9to4,9,4,0.979540043444992,-7.58803170474855,32,32,0,3
130198,4to3,4,3,0.146669073285251,-11.8979559008873,126,126,0,2
130214,3to2,3,2,0.001076895770333,-11.1226155959287,2405,2405,0,3
130229,2to3,2,3,0.99807865202861,-3.95697141540815,31,31,0,3
130245,3to4,3,4,0.969407154137243,-4.3200135082935,63,63,0,3
130261,4to9,4,9,0.853330926714749,-10.1369873192145,95,95,0,2
130277,9to4,9,4,0.979540043444992,-7.58803170474855,32,32,0,3
130292,4to9,4,9,0.853330926714749,-10.1369873192145,31,31,0,2
130307,9to4,9,4,0.979540043444992,-7.58803170474855,30,30,0,3
130322,4to9,4,9,0.853330926714749,-10.1369873192145,30,30,0,2
130339,9to4,9,4,0.979540043444992,-7.58803170474855,32,32,0,3
130356,4to3,4,3,0.146669073285251,-11.8979559008873,127,127,0,2
130371,3to4,3,4,0.969407154137243,-4.3200135082935,32,32,0,3
130387,4to9,4,9,0.853330926714749,-10.1369873192145,65,65,0,2
130402,9to4,9,4,0.979540043444992,-7.58803170474855,31,31,0,3
130417,4to9,4,9,0.853330926714749,-10.1369873192145,30,30,0,2
130434,9to4,9,4,0.979540043444992,-7.58803170474855,32,32,0,3
130449,4to9,4,9,0.853330926714749,-10.1369873192145,32,32,0,2
130465,9to4,9,4,0.979540043444992,-7.58803170474855,31,31,0,3
130481,4to3,4,3,0.146669073285251,-11.8979559008873,125,125,0,2
130497,3to8,3,8,0.029515950092424,-7.81176741331218,694,694,0,3
130514,8to9,8,9,0.768535990373411,-2.89449932615566,65,65,0,4
130531,9to4,9,4,0.979540043444992,-7.58803170474855,66,66,0,3
130549,4to9,4,9,0.853330926714749,-10.1369873192145,35,35,0,2
130565,9to4,9,4,0.979540043444992,-7.58803170474855,34,34,0,3
130580,4to9,4,9,0.853330926714749,-10.1369873192145,31,31,0,2
130596,9to4,9,4,0.979540043444992,-7.58803170474855,31,31,0,3
130612,4to3,4,3,0.146669073285251,-11.8979559008873,131,131,0,2
130627,3to4,3,4,0.969407154137243,-4.3200135082935,31,31,0,3
130642,4to9,4,9,0.853330926714749,-10.1369873192145,62,62,0,2
130657,9to4,9,4,0.979540043444992,-7.58803170474855,30,30,0,3
130672,4to9,4,9,0.853330926714749,-10.1369873192145,30,30,0,2
130688,9to4,9,4,0.979540043444992,-7.58803170474855,31,31,0,3
130704,4to9,4,9,0.853330926714749,-10.1369873192145,32,32,0,2
130720,9to4,9,4,0.979540043444992,-7.58803170474855,32,32,0,3
130737,4to3,4,3,0.146669073285251,-11.8979559008873,125,125,0,2
130752,3to4,3,4,0.969407154137243,-4.3200135082935,32,32,0,3
130769,4to9,4,9,0.853330926714749,-10.1369873192145,65,65,0,2
130784,9to4,9,4,0.979540043444992,-7.58803170474855,32,32,0,3
130800,4to9,4,9,0.853330926714749,-10.1369873192145,31,31,0,2
130817,9to14,9,14,0.000305102545922,-15.6622221655575,1741,1741,0,3
130834,14to13,14,13,0.036092380388884,-8.4156373239335,1741,1741,0,3
130852,13to8,13,8,0.897501085276546,-7.37455157477482,355,355,0,4
130867,8to9,8,9,0.768535990373411,-2.89449932615566,67,67,0,4
130882,9to4,9,4,0.979540043444992,-7.58803170474855,98,98,0,3
130897,4to3,4,3,0.146669073285251,-11.8979559008873,160,160,0,2
130912,3to4,3,4,0.969407154137243,-4.3200135082935,30,30,0,3
130928,4to9,4,9,0.853330926714749,-10.1369873192145,61,61,0,2
130944,9to4,9,4,0.979540043444992,-7.58803170474855,32,32,0,3
130960,4to9,4,9,0.853330926714749,-10.1369873192145,32,32,0,2
130976,9to4,9,4,0.979540043444992,-7.58803170474855,32,32,0,3
130991,4to9,4,9,0.853330926714749,-10.1369873192145,31,31,0,2
131006,9to4,9,4,0.979540043444992,-7.58803170474855,30,30,0,3
131020,4to3,4,3,0.146669073285251,-11.8979559008873,123,123,0,2
131034,3to4,3,4,0.969407154137243,-4.3200135082935,28,28,0,3
131049,4to9,4,9,0.853330926714749,-10.1369873192145,58,58,0,2
131065,9to4,9,4,0.979540043444992,-7.58803170474855,31,31,0,3
131081,4to9,4,9,0.853330926714749,-10.1369873192145,32,32,0,2
131098,9to14,9,14,0.000305102545922,-15.6622221655575,281,281,0,3
131115,14to9,14,9,0.963868560337125,-5.13076416031772,34,34,0,3
131131,9to4,9,4,0.979540043444992,-7.58803170474855,66,66,0,3
131146,4to3,4,3,0.146669073285251,-11.8979559008873,126,126,0,2
131163,3to4,3,4,0.969407154137243,-4.3200135082935,32,32,0,3
131179,4to9,4,9,0.853330926714749,-10.1369873192145,64,64,0,2
131195,9to4,9,4,0.979540043444992,-7.58803170474855,32,32,0,3
131210,4to9,4,9,0.853330926714749,-10.1369873192145,31,31,0,2
131225,9to4,9,4,0.979540043444992,-7.58803170474855,30,30,0,3
131240,4to9,4,9,0.853330926714749,-10.1369873192145,30,30,0,2
131255,9to4,9,4,0.979540043444992,-7.58803170474855,30,30,0,3
131271,4to3,4,3,0.146669073285251,-11.8979559008873,125,125,0,2
131287,3to4,3,4,0.969407154137243,-4.3200135082935,32,32,0,3
131304,4to9,4,9,0.853330926714749,-10.1369873192145,64,64,0,2
131320,9to4,9,4,0.979540043444992,-7.58803170474855,33,33,0,3
131338,4to9,4,9,0.853330926714749,-10.1369873192145,34,34,0,2
131354,9to4,9,4,0.979540043444992,-7.58803170474855,34,34,0,3
131370,4to9,4,9,0.853330926714749,-10.1369873192145,32,32,0,2
131386,9to4,9,4,0.979540043444992,-7.58803170474855,32,32,0,3
131401,4to3,4,3,0.146669073285251,-11.8979559008873,130,130,0,2
131417,3to2,3,2,0.001076895770333,-11.1226155959287,1203,1203,0,3
131433,2to3,2,3,0.99807865202861,-3.95697141540815,32,32,0,3
131449,3to4,3,4,0.969407154137243,-4.3200135082935,63,63,0,3
131466,4to9,4,9,0.853330926714749,-10.1369873192145,96,96,0,2
131482,9to14,9,14,0.000305102545922,-15.6622221655575,384,384,0,3
131498,14to13,14,13,0.036092380388884,-8.4156373239335,664,664,0,3
131515,13to8,13,8,0.897501085276546,-7.37455157477482,663,663,0,4
131532,8to9,8,9,0.768535990373411,-2.89449932615566,66,66,0,4
131549,9to4,9,4,0.979540043444992,-7.58803170474855,100,100,0,3
131565,4to3,4,3,0.146669073285251,-11.8979559008873,132,132,0,2
131580,3to4,3,4,0.969407154137243,-4.3200135082935,31,31,0,3
131595,4to9,4,9,0.853330926714749,-10.1369873192145,63,63,0,2
131610,9to4,9,4,0.979540043444992,-7.58803170474855,30,30,0,3
131626,4to9,4,9,0.853330926714749,-10.1369873192145,31,31,0,2
131641,9to4,9,4,0.979540043444992,-7.58803170474855,31,31,0,3
131657,4to9,4,9,0.853330926714749,-10.1369873192145,31,31,0,2
131673,9to4,9,4,0.979540043444992,-7.58803170474855,32,32,0,3
131689,4to3,4,3,0.146669073285251,-11.8979559008873,124,124,0,2
131704,3to4,3,4,0.969407154137243,-4.3200135082935,31,31,0,3
131721,4to9,4,9,0.853330926714749,-10.1369873192145,64,64,0,2
131737,9to4,9,4,0.979540043444992,-7.58803170474855,33,33,0,3
131752,4to9,4,9,0.853330926714749,-10.1369873192145,31,31,0,2
131768,9to4,9,4,0.979540043444992,-7.58803170474855,31,31,0,3
131783,4to9,4,9,0.853330926714749,-10.1369873192145,31,31,0,2
131799,9to4,9,4,0.979540043444992,-7.58803170474855,31,31,0,3
131814,4to3,4,3,0.146669073285251,-11.8979559008873,125,125,0,2
131831,3to4,3,4,0.969407154137243,-4.3200135082935,32,32,0,3
131848,4to9,4,9,0.853330926714749,-10.1369873192145,65,65,0,2
131864,9to4,9,4,0.979540043444992,-7.58803170474855,33,33,0,3
131879,4to9,4,9,0.853330926714749,-10.1369873192145,31,31,0,2
131894,9to4,9,4,0.979540043444992,-7.58803170474855,30,30,0,3
131910,4to9,4,9,0.853330926714749,-10.1369873192145,31,31,0,2
131927,9to4,9,4,0.979540043444992,-7.58803170474855,33,33,0,3
131943,4to3,4,3,0.146669073285251,-11.8979559008873,129,129,0,2
131959,3to8,3,8,0.029515950092424,-7.81176741331218,444,444,0,3
131976,8to9,8,9,0.768535990373411,-2.89449932615566,66,66,0,4
131993,9to4,9,4,0.979540043444992,-7.58803170474855,66,66,0,3
132010,4to9,4,9,0.853330926714749,-10.1369873192145,34,34,0,2
132028,9to8,9,8,0.020154854009086,-11.47166966968,69,69,0,3
132043,8to3,8,3,0.226861680608847,-4.11464622477799,100,100,0,4
132060,3to4,3,4,0.969407154137243,-4.3200135082935,67,67,0,3
132076,4to9,4,9,0.853330926714749,-10.1369873192145,66,66,0,2
132092,9to4,9,4,0.979540043444992,-7.58803170474855,32,32,0,3
132106,4to9,4,9,0.853330926714749,-10.1369873192145,30,30,0,2
132121,9to4,9,4,0.979540043444992,-7.58803170474855,29,29,0,3
132136,4to9,4,9,0.853330926714749,-10.1369873192145,30,30,0,2
132152,9to4,9,4,0.979540043444992,-7.58803170474855,31,31,0,3
132168,4to3,4,3,0.146669073285251,-11.8979559008873,125,125,0,2
132183,3to4,3,4,0.969407154137243,-4.3200135082935,31,31,0,3
132198,4to9,4,9,0.853330926714749,-10.1369873192145,62,62,0,2
132214,9to4,9,4,0.979540043444992,-7.58803170474855,31,31,0,3
132229,4to9,4,9,0.853330926714749,-10.1369873192145,31,31,0,2
132244,9to4,9,4,0.979540043444992,-7.58803170474855,30,30,0,3
132260,4to9,4,9,0.853330926714749,-10.1369873192145,31,31,0,2
132275,9to4,9,4,0.979540043444992,-7.58803170474855,31,31,0,3
132291,4to3,4,3,0.129283356295418,-12.0442973643019,123,105,18,2
132305,3to4,3,4,0.969407154137243,-4.3200135082935,30,30,0,3
132321,4to9,4,9,0.870716643704582,-10.1369873192145,61,61,0,2
132336,9to4,9,4,0.979540043444992,-7.58803170474855,31,31,0,3
132350,4to9,4,9,0.870716643704582,-10.1369873192145,29,29,0,2
132366,9to4,9,4,0.979540043444992,-7.58803170474855,30,30,0,3
132382,4to9,4,9,0.870716643704582,-10.1369873192145,32,32,0,2
132397,9to4,9,4,0.979540043444992,-7.58803170474855,31,31,0,3
132413,4to3,4,3,0.129283356295418,-12.0442973643019,122,122,0,2
132429,3to4,3,4,0.969407154137243,-4.3200135082935,32,32,0,3
132446,4to9,4,9,0.870716643704582,-10.1369873192145,64,64,0,2
132463,9to4,9,4,0.979540043444992,-7.58803170474855,34,34,0,3
132479,4to9,4,9,0.870716643704582,-10.1369873192145,33,33,0,2
132493,9to4,9,4,0.979540043444992,-7.58803170474855,30,30,0,3
132509,4to9,4,9,0.870716643704582,-10.1369873192145,30,30,0,2
132523,9to4,9,4,0.979540043444992,-7.58803170474855,30,30,0,3
132538,4to3,4,3,0.129283356295418,-12.0442973643019,125,125,0,2
132554,3to8,3,8,0.022733383926707,-8.07982824981408,526,385,141,3
132570,8to9,8,9,0.768535990373411,-2.89449932615566,61,61,0,4
132587,9to4,9,4,0.979540043444992,-7.58803170474855,64,64,0,3
132602,4to9,4,9,0.870716643704582,-10.1369873192145,32,32,0,2
132616,9to4,9,4,0.979540043444992,-7.58803170474855,29,29,0,3
132632,4to9,4,9,0.870716643704582,-10.1369873192145,30,30,0,2
132648,9to8,9,8,0.020154854009086,-11.47166966968,94,94,0,3
132664,8to3,8,3,0.226861680608847,-4.11464622477799,126,126,0,4
132681,3to4,3,4,0.976182194041383,-4.3200135082935,65,65,0,3
132698,4to9,4,9,0.870716643704582,-10.1369873192145,66,66,0,2
132712,9to4,9,4,0.979540043444992,-7.58803170474855,31,31,0,3
132729,4to9,4,9,0.870716643704582,-10.1369873192145,31,31,0,2
132744,9to4,9,4,0.979540043444992,-7.58803170474855,32,32,0,3
132761,4to9,4,9,0.870716643704582,-10.1369873192145,32,32,0,2
132777,9to8,9,8,0.020154854009086,-11.47166966968,129,129,0,3
132793,8to3,8,3,0.226861680608847,-4.11464622477799,129,129,0,4
132810,3to4,3,4,0.976182194041383,-4.3200135082935,66,66,0,3
132827,4to9,4,9,0.870716643704582,-10.1369873192145,66,66,0,2
132844,9to4,9,4,0.979540043444992,-7.58803170474855,34,34,0,3
132860,4to9,4,9,0.870716643704582,-10.1369873192145,33,33,0,2
132875,9to4,9,4,0.979540043444992,-7.58803170474855,31,31,0,3
132889,4to9,4,9,0.870716643704582,-10.1369873192145,29,29,0,2
132906,9to14,9,14,0.000305102545922,-15.6622221655575,1424,1424,0,3
132922,14to13,14,13,0.036092380388884,-8.4156373239335,1424,1424,0,3
132939,13to8,13,8,0.897501085276546,-7.37455157477482,162,162,0,4
132955,8to9,8,9,0.768535990373411,-2.89449932615566,66,66,0,4
132971,9to4,9,4,0.979540043444992,-7.58803170474855,96,96,0,3
132985,4to3,4,3,0.129283356295418,-12.0442973643019,192,192,0,2
133000,3to4,3,4,0.976182194041383,-4.3200135082935,29,29,0,3
133016,4to9,4,9,0.870716643704582,-10.1369873192145,61,61,0,2
133033,9to4,9,4,0.979540043444992,-7.58803170474855,33,33,0,3
133049,4to9,4,9,0.870716643704582,-10.1369873192145,33,33,0,2
133065,9to4,9,4,0.979540043444992,-7.58803170474855,32,32,0,3
133081,4to9,4,9,0.870716643704582,-10.1369873192145,32,32,0,2
133096,9to4,9,4,0.979540043444992,-7.58803170474855,31,31,0,3
133112,4to3,4,3,0.129283356295418,-12.0442973643019,127,127,0,2
133128,3to4,3,4,0.976182194041383,-4.3200135082935,32,32,0,3
133144,4to9,4,9,0.870716643704582,-10.1369873192145,63,63,0,2
133159,9to4,9,4,0.979540043444992,-7.58803170474855,31,31,0,3
133175,4to9,4,9,0.870716643704582,-10.1369873192145,31,31,0,2
133191,9to4,9,4,0.979540043444992,-7.58803170474855,32,32,0,3
133207,4to9,4,9,0.870716643704582,-10.1369873192145,32,32,0,2
133222,9to4,9,4,0.979540043444992,-7.58803170474855,31,31,0,3
133238,4to3,4,3,0.129283356295418,-12.0442973643019,126,126,0,2
133254,3to4,3,4,0.976182194041383,-4.3200135082935,32,32,0,3
133270,4to9,4,9,0.870716643704582,-10.1369873192145,63,63,0,2
133285,9to4,9,4,0.979540043444992,-7.58803170474855,31,31,0,3
133302,4to9,4,9,0.870716643704582,-10.1369873192145,32,32,0,2
133318,9to4,9,4,0.979540043444992,-7.58803170474855,33,33,0,3
133335,4to9,4,9,0.870716643704582,-10.1369873192145,33,33,0,2
133350,9to4,9,4,0.979540043444992,-7.58803170474855,32,32,0,3
133367,4to3,4,3,0.129283356295418,-12.0442973643019,129,129,0,2
133383,3to4,3,4,0.976182194041383,-4.3200135082935,33,33,0,3
133398,4to3,4,3,0.129283356295418,-12.0442973643019,31,31,0,2
133414,3to4,3,4,0.976182194041383,-4.3200135082935,31,31,0,3
133429,4to9,4,9,0.870716643704582,-10.1369873192145,94,94,0,2
133445,9to4,9,4,0.979540043444992,-7.58803170474855,31,31,0,3
133462,4to3,4,3,0.129283356295418,-12.0442973643019,64,64,0,2
133478,3to2,3,2,0.000741194377962,-11.5034986624013,2061,1276,785,3
133493,2to3,2,3,0.99807865202861,-3.95697141540815,31,31,0,3
133510,3to4,3,4,0.976517610498667,-4.3200135082935,65,65,0,3
133526,4to9,4,9,0.870716643704582,-10.1369873192145,97,97,0,2
133543,9to4,9,4,0.979540043444992,-7.58803170474855,33,33,0,3
133558,4to9,4,9,0.870716643704582,-10.1369873192145,32,32,0,2
133573,9to4,9,4,0.979540043444992,-7.58803170474855,30,30,0,3
133588,4to9,4,9,0.870716643704582,-10.1369873192145,30,30,0,2
133605,9to4,9,4,0.979540043444992,-7.58803170474855,32,32,0,3
133621,4to9,4,9,0.870716643704582,-10.1369873192145,33,33,0,2
133636,9to4,9,4,0.979540043444992,-7.58803170474855,31,31,0,3
133651,4to3,4,3,0.129283356295418,-12.0442973643019,158,158,0,2
133667,3to8,3,8,0.022741195123372,-8.07982824981408,728,728,0,3
133683,8to9,8,9,0.768535990373411,-2.89449932615566,62,62,0,4
133699,9to4,9,4,0.979540043444992,-7.58803170474855,63,63,0,3
133713,4to9,4,9,0.745352440554012,-10.9703206525479,30,5,25,2
133733,9to4,9,4,0.957053642206884,-8.35273758710149,34,8,26,3
133749,4to3,4,3,0.121090899902233,-12.952460629608,98,9,89,2
133763,3to4,3,4,0.976517610498667,-4.3200135082935,30,30,0,3
133779,4to9,4,9,0.878909100097767,-10.9703206525479,66,66,0,2
133795,9to8,9,8,0.04230593399429,-11.47166966968,128,128,0,3
133812,8to9,8,9,0.768535990373411,-2.89449932615566,33,33,0,4
133828,9to4,9,4,0.957053642206884,-8.35273758710149,65,65,0,3
133843,4to9,4,9,0.878909100097767,-10.9703206525479,31,31,0,2
133860,9to4,9,4,0.957053642206884,-8.35273758710149,32,32,0,3
133875,4to9,4,9,0.878909100097767,-10.9703206525479,32,32,0,2
133891,9to4,9,4,0.957053642206884,-8.35273758710149,31,31,0,3
133906,4to3,4,3,0.121090899902233,-12.952460629608,157,157,0,2
133921,3to4,3,4,0.976517610498667,-4.3200135082935,30,30,0,3
133937,4to9,4,9,0.878909100097767,-10.9703206525479,62,62,0,2
133954,9to4,9,4,0.957053642206884,-8.35273758710149,33,33,0,3
133968,4to9,4,9,0.878909100097767,-10.9703206525479,31,31,0,2
133985,9to4,9,4,0.957053642206884,-8.35273758710149,31,31,0,3
134001,4to9,4,9,0.878909100097767,-10.9703206525479,33,33,0,2
134017,9to4,9,4,0.957053642206884,-8.35273758710149,32,32,0,3
134034,4to9,4,9,0.878909100097767,-10.9703206525479,33,33,0,2
134049,9to4,9,4,0.957053642206884,-8.35273758710149,32,32,0,3
134064,4to3,4,3,0.121090899902233,-12.952460629608,158,158,0,2
134080,3to4,3,4,0.976517610498667,-4.3200135082935,31,31,0,3
134098,4to9,4,9,0.878909100097767,-10.9703206525479,64,64,0,2
134114,9to4,9,4,0.957053642206884,-8.35273758710149,34,34,0,3
134129,4to9,4,9,0.878909100097767,-10.9703206525479,31,31,0,2
134144,9to4,9,4,0.957053642206884,-8.35273758710149,30,30,0,3
134159,4to9,4,9,0.878909100097767,-10.9703206525479,30,30,0,2
134175,9to8,9,8,0.04230593399429,-11.47166966968,380,380,0,3
134190,8to3,8,3,0.226861680608847,-4.11464622477799,126,126,0,4
134207,3to4,3,4,0.976517610498667,-4.3200135082935,63,63,0,3
134223,4to9,4,9,0.878909100097767,-10.9703206525479,64,64,0,2
134239,9to4,9,4,0.957053642206884,-8.35273758710149,32,32,0,3
134255,4to3,4,3,0.121090899902233,-12.952460629608,65,65,0,2
134272,3to4,3,4,0.976517610498667,-4.3200135082935,33,33,0,3
134289,4to9,4,9,0.878909100097767,-10.9703206525479,66,66,0,2
134306,9to4,9,4,0.957053642206884,-8.35273758710149,34,34,0,3
134321,4to9,4,9,0.878909100097767,-10.9703206525479,32,32,0,2
134336,9to4,9,4,0.957053642206884,-8.35273758710149,30,30,0,3
134351,4to9,4,9,0.878909100097767,-10.9703206525479,30,30,0,2
134366,9to4,9,4,0.957053642206884,-8.35273758710149,30,30,0,3
134382,4to3,4,3,0.121090899902233,-12.952460629608,127,127,0,2
134398,3to4,3,4,0.976517610498667,-4.3200135082935,32,32,0,3
134415,4to3,4,3,0.121090899902233,-12.952460629608,33,33,0,2
134431,3to4,3,4,0.976517610498667,-4.3200135082935,33,33,0,3
134446,4to9,4,9,0.878909100097767,-10.9703206525479,95,95,0,2
134461,9to4,9,4,0.957053642206884,-8.35273758710149,30,30,0,3
134477,4to9,4,9,0.878909100097767,-10.9703206525479,31,31,0,2
134492,9to4,9,4,0.957053642206884,-8.35273758710149,31,31,0,3
134508,4to9,4,9,0.878909100097767,-10.9703206525479,31,31,0,2
134524,9to4,9,4,0.957053642206884,-8.35273758710149,32,32,0,3
134540,4to9,4,9,0.878909100097767,-10.9703206525479,32,32,0,2
134556,9to8,9,8,0.04230593399429,-11.47166966968,381,381,0,3
134573,8to3,8,3,0.226861680608847,-4.11464622477799,158,158,0,4
134591,3to4,3,4,0.976517610498667,-4.3200135082935,67,67,0,3
134608,4to9,4,9,0.878909100097767,-10.9703206525479,68,68,0,2
134625,9to4,9,4,0.957053642206884,-8.35273758710149,34,34,0,3
134641,4to9,4,9,0.878909100097767,-10.9703206525479,33,33,0,2
134657,9to4,9,4,0.957053642206884,-8.35273758710149,32,32,0,3
134672,4to9,4,9,0.878909100097767,-10.9703206525479,31,31,0,2
134688,9to4,9,4,0.957053642206884,-8.35273758710149,31,31,0,3
134703,4to9,4,9,0.878909100097767,-10.9703206525479,31,31,0,2
134717,9to4,9,4,0.957053642206884,-8.35273758710149,29,29,0,3
134733,4to3,4,3,0.121090899902233,-12.952460629608,160,160,0,2
134749,3to8,3,8,0.022741195123372,-8.07982824981408,193,193,0,3
134764,8to9,8,9,0.768535990373411,-2.89449932615566,61,61,0,4
134779,9to4,9,4,0.957053642206884,-8.35273758710149,62,62,0,3
134795,4to9,4,9,0.878909100097767,-10.9703206525479,31,31,0,2
134812,9to4,9,4,0.957053642206884,-8.35273758710149,33,33,0,3
134828,4to9,4,9,0.878909100097767,-10.9703206525479,33,33,0,2
134844,9to4,9,4,0.957053642206884,-8.35273758710149,32,32,0,3
134861,4to9,4,9,0.878909100097767,-10.9703206525479,33,33,0,2
134878,9to4,9,4,0.957053642206884,-8.35273758710149,34,34,0,3
134893,4to3,4,3,0.121090899902233,-12.952460629608,160,160,0,2
134909,3to4,3,4,0.976517610498667,-4.3200135082935,31,31,0,3
134924,4to9,4,9,0.878909100097767,-10.9703206525479,63,63,0,2
134938,9to4,9,4,0.957053642206884,-8.35273758710149,29,29,0,3
134954,4to9,4,9,0.878909100097767,-10.9703206525479,30,30,0,2
134971,9to8,9,8,0.04230593399429,-11.47166966968,222,222,0,3
134987,8to3,8,3,0.226861680608847,-4.11464622477799,94,94,0,4
135004,3to4,3,4,0.976517610498667,-4.3200135082935,66,66,0,3
135021,4to9,4,9,0.878909100097767,-10.9703206525479,67,67,0,2
135037,9to4,9,4,0.957053642206884,-8.35273758710149,33,33,0,3
135053,4to9,4,9,0.878909100097767,-10.9703206525479,32,32,0,2
135068,9to4,9,4,0.957053642206884,-8.35273758710149,31,31,0,3
135084,4to9,4,9,0.878909100097767,-10.9703206525479,31,31,0,2
135100,9to4,9,4,0.957053642206884,-8.35273758710149,32,32,0,3
135115,4to9,4,9,0.878909100097767,-10.9703206525479,31,31,0,2
135130,9to4,9,4,0.957053642206884,-8.35273758710149,30,30,0,3
135145,4to3,4,3,0.121090899902233,-12.952460629608,158,158,0,2
135160,3to4,3,4,0.976517610498667,-4.3200135082935,30,30,0,3
135176,4to9,4,9,0.878909100097767,-10.9703206525479,61,61,0,2
135192,9to4,9,4,0.957053642206884,-8.35273758710149,32,32,0,3
135207,4to9,4,9,0.878909100097767,-10.9703206525479,31,31,0,2
135222,9to4,9,4,0.957053642206884,-8.35273758710149,30,30,0,3
135238,4to9,4,9,0.878909100097767,-10.9703206525479,31,31,0,2
135253,9to4,9,4,0.957053642206884,-8.35273758710149,31,31,0,3
135269,4to9,4,9,0.878909100097767,-10.9703206525479,31,31,0,2
135284,9to4,9,4,0.957053642206884,-8.35273758710149,31,31,0,3
135299,4to3,4,3,0.121090899902233,-12.952460629608,154,154,0,2
135314,3to4,3,4,0.976517610498667,-4.3200135082935,30,30,0,3
135330,4to9,4,9,0.878909100097767,-10.9703206525479,61,61,0,2
135345,9to4,9,4,0.957053642206884,-8.35273758710149,31,31,0,3
135360,4to9,4,9,0.878909100097767,-10.9703206525479,30,30,0,2
135376,9to8,9,8,0.04230593399429,-11.47166966968,405,405,0,3
135392,8to3,8,3,0.226861680608847,-4.11464622477799,93,93,0,4
135408,3to4,3,4,0.976517610498667,-4.3200135082935,63,63,0,3
135425,4to9,4,9,0.878909100097767,-10.9703206525479,65,65,0,2
135441,9to4,9,4,0.957053642206884,-8.35273758710149,33,33,0,3
135456,4to9,4,9,0.878909100097767,-10.9703206525479,31,31,0,2
135470,9to4,9,4,0.957053642206884,-8.35273758710149,29,29,0,3
135486,4to9,4,9,0.878909100097767,-10.9703206525479,30,30,0,2
135501,9to4,9,4,0.957053642206884,-8.35273758710149,31,31,0,3
135517,4to3,4,3,0.121090899902233,-12.952460629608,125,125,0,2
135532,3to4,3,4,0.976517610498667,-4.3200135082935,31,31,0,3
135547,4to9,4,9,0.878909100097767,-10.9703206525479,61,61,0,2
135563,9to4,9,4,0.957053642206884,-8.35273758710149,31,31,0,3
135579,4to9,4,9,0.878909100097767,-10.9703206525479,32,32,0,2
135594,9to4,9,4,0.957053642206884,-8.35273758710149,31,31,0,3
135611,4to9,4,9,0.878909100097767,-10.9703206525479,32,32,0,2
135626,9to4,9,4,0.957053642206884,-8.35273758710149,32,32,0,3
135641,4to3,4,3,0.121090899902233,-12.952460629608,124,124,0,2
135658,3to4,3,4,0.976517610498667,-4.3200135082935,32,32,0,3
135675,4to9,4,9,0.878909100097767,-10.9703206525479,64,64,0,2
135691,9to4,9,4,0.957053642206884,-8.35273758710149,33,33,0,3
135708,4to3,4,3,0.121090899902233,-12.952460629608,67,67,0,2
135722,3to4,3,4,0.976517610498667,-4.3200135082935,31,31,0,3
135738,4to9,4,9,0.878909100097767,-10.9703206525479,63,63,0,2
135753,9to8,9,8,0.04230593399429,-11.47166966968,377,377,0,3
135769,8to7,8,7,0.000908728145689,-9.63536755452497,8102,3618,4484,4
135784,7to12,7,12,0.068765463699289,-4.92022659283001,8069,8069,0,4
135800,12to13,12,13,0.975305689097347,-6.36264020069652,2878,2878,0,4
135817,13to14,13,14,0.071150450944958,-9.93118461773681,2911,2125,786,4
135833,14to9,14,9,0.963868560337125,-5.13076416031772,95,95,0,3
135850,9to4,9,4,0.957053642206884,-8.35273758710149,128,128,0,3
135865,4to3,4,3,0.121090899902233,-12.952460629608,157,157,0,2
135881,3to4,3,4,0.976517610498667,-4.3200135082935,31,31,0,3
135897,4to9,4,9,0.878909100097767,-10.9703206525479,64,64,0,2
135912,9to4,9,4,0.957053642206884,-8.35273758710149,31,31,0,3
135928,4to9,4,9,0.878909100097767,-10.9703206525479,31,31,0,2
135943,9to4,9,4,0.957053642206884,-8.35273758710149,31,31,0,3
135959,4to9,4,9,0.878909100097767,-10.9703206525479,31,31,0,2
135975,9to4,9,4,0.957053642206884,-8.35273758710149,32,32,0,3
135992,4to9,4,9,0.878909100097767,-10.9703206525479,33,33,0,2
136008,9to4,9,4,0.957053642206884,-8.35273758710149,33,33,0,3
136026,4to3,4,3,0.121090899902233,-12.952460629608,161,161,0,2
136040,3to4,3,4,0.976517610498667,-4.3200135082935,32,32,0,3
136056,4to9,4,9,0.878909100097767,-10.9703206525479,64,64,0,2
136073,9to4,9,4,0.957053642206884,-8.35273758710149,33,33,0,3
136090,4to9,4,9,0.878909100097767,-10.9703206525479,34,34,0,2
136107,9to4,9,4,0.957053642206884,-8.35273758710149,34,34,0,3
136124,4to9,4,9,0.878909100097767,-10.9703206525479,34,34,0,2
136140,9to4,9,4,0.957053642206884,-8.35273758710149,33,33,0,3
136155,4to3,4,3,0.121090899902233,-12.952460629608,129,129,0,2
136172,3to4,3,4,0.976517610498667,-4.3200135082935,32,32,0,3
136189,4to9,4,9,0.878909100097767,-10.9703206525479,65,65,0,2
136207,9to8,9,8,0.04230593399429,-11.47166966968,454,454,0,3
136222,8to9,8,9,0.769052262769502,-2.89449932615566,33,33,0,4
136237,9to14,9,14,0.000640423798826,-15.6622221655575,420,420,0,3
136254,14to13,14,13,0.036092380388884,-8.4156373239335,454,454,0,3
136270,13to8,13,8,0.917295535428803,-7.37455157477482,63,63,0,4
136286,8to9,8,9,0.769052262769502,-2.89449932615566,64,64,0,4
136302,9to4,9,4,0.957053642206884,-8.35273758710149,130,130,0,3
136317,4to3,4,3,0.121090899902233,-12.952460629608,162,162,0,2
136332,3to4,3,4,0.976517610498667,-4.3200135082935,30,30,0,3
136350,4to9,4,9,0.878909100097767,-10.9703206525479,64,64,0,2
136366,9to4,9,4,0.957053642206884,-8.35273758710149,34,34,0,3
136381,4to9,4,9,0.878909100097767,-10.9703206525479,31,31,0,2
136398,9to4,9,4,0.957053642206884,-8.35273758710149,32,32,0,3
136413,4to9,4,9,0.878909100097767,-10.9703206525479,32,32,0,2
136429,9to4,9,4,0.957053642206884,-8.35273758710149,31,31,0,3
136444,4to9,4,9,0.878909100097767,-10.9703206525479,31,31,0,2
136460,9to4,9,4,0.957053642206884,-8.35273758710149,31,31,0,3
136476,4to3,4,3,0.121090899902233,-12.952460629608,159,159,0,2
136493,3to4,3,4,0.976517610498667,-4.3200135082935,33,33,0,3
136509,4to9,4,9,0.878909100097767,-10.9703206525479,65,65,0,2
136524,9to4,9,4,0.957053642206884,-8.35273758710149,31,31,0,3
136540,4to9,4,9,0.878909100097767,-10.9703206525479,31,31,0,2
136556,9to4,9,4,0.957053642206884,-8.35273758710149,32,32,0,3
136570,4to9,4,9,0.878909100097767,-10.9703206525479,30,30,0,2
136587,9to4,9,4,0.957053642206884,-8.35273758710149,31,31,0,3
136604,4to9,4,9,0.878909100097767,-10.9703206525479,34,34,0,2
136620,9to4,9,4,0.957053642206884,-8.35273758710149,33,33,0,3
136636,4to3,4,3,0.121090899902233,-12.952460629608,160,160,0,2
136652,3to2,3,2,0.000679079650815,-11.5910853038632,3174,2896,278,3
136667,2to3,2,3,0.99807865202861,-3.95697141540815,31,31,0,3
136684,3to4,3,4,0.976578311614922,-4.3200135082935,64,64,0,3
136699,4to3,4,3,0.121090899902233,-12.952460629608,32,32,0,2
136715,3to4,3,4,0.976578311614922,-4.3200135082935,31,31,0,3
136731,4to9,4,9,0.878909100097767,-10.9703206525479,127,127,0,2
136746,9to8,9,8,0.04230593399429,-11.47166966968,476,476,0,3
136761,8to9,8,9,0.769052262769502,-2.89449932615566,30,30,0,4
136777,9to4,9,4,0.957053642206884,-8.35273758710149,62,62,0,3
136794,4to9,4,9,0.878909100097767,-10.9703206525479,33,33,0,2
136809,9to4,9,4,0.957053642206884,-8.35273758710149,32,32,0,3
136825,4to3,4,3,0.121090899902233,-12.952460629608,126,126,0,2
136841,3to4,3,4,0.976578311614922,-4.3200135082935,32,32,0,3
136858,4to9,4,9,0.878909100097767,-10.9703206525479,64,64,0,2
136874,9to4,9,4,0.957053642206884,-8.35273758710149,33,33,0,3
136888,4to9,4,9,0.878909100097767,-10.9703206525479,30,30,0,2
136904,9to4,9,4,0.957053642206884,-8.35273758710149,30,30,0,3
136921,4to9,4,9,0.878909100097767,-10.9703206525479,33,33,0,2
136935,9to4,9,4,0.957053642206884,-8.35273758710149,31,31,0,3
136951,4to3,4,3,0.121090899902233,-12.952460629608,126,126,0,2
136968,3to4,3,4,0.976578311614922,-4.3200135082935,33,33,0,3
136984,4to9,4,9,0.878909100097767,-10.9703206525479,63,63,0,2
137001,9to4,9,4,0.957053642206884,-8.35273758710149,33,33,0,3
137017,4to9,4,9,0.878909100097767,-10.9703206525479,33,33,0,2
137032,9to4,9,4,0.957053642206884,-8.35273758710149,31,31,0,3
137048,4to9,4,9,0.878909100097767,-10.9703206525479,31,31,0,2
137063,9to4,9,4,0.957053642206884,-8.35273758710149,31,31,0,3
137078,4to3,4,3,0.121090899902233,-12.952460629608,127,127,0,2
137095,3to4,3,4,0.976578311614922,-4.3200135082935,32,32,0,3
137111,4to9,4,9,0.878909100097767,-10.9703206525479,63,63,0,2
137128,9to8,9,8,0.04230593399429,-11.47166966968,382,382,0,3
137144,8to9,8,9,0.769052262769502,-2.89449932615566,33,33,0,4
137161,9to4,9,4,0.957053642206884,-8.35273758710149,66,66,0,3
137177,4to9,4,9,0.878909100097767,-10.9703206525479,33,33,0,2
137192,9to4,9,4,0.957053642206884,-8.35273758710149,31,31,0,3
137207,4to3,4,3,0.121090899902233,-12.952460629608,129,129,0,2
137224,3to2,3,2,0.000679079650815,-11.5910853038632,572,572,0,3
137240,2to3,2,3,0.99807865202861,-3.95697141540815,33,33,0,3
137256,3to4,3,4,0.976578311614922,-4.3200135082935,64,64,0,3
137271,4to9,4,9,0.878909100097767,-10.9703206525479,94,94,0,2
137287,9to4,9,4,0.957053642206884,-8.35273758710149,31,31,0,3
137302,4to9,4,9,0.878909100097767,-10.9703206525479,31,31,0,2
137318,9to4,9,4,0.957053642206884,-8.35273758710149,31,31,0,3
137334,4to9,4,9,0.878909100097767,-10.9703206525479,32,32,0,2
137350,9to4,9,4,0.957053642206884,-8.35273758710149,32,32,0,3
137366,4to9,4,9,0.878909100097767,-10.9703206525479,32,32,0,2
137382,9to4,9,4,0.957053642206884,-8.35273758710149,32,32,0,3
137397,4to3,4,3,0.121090899902233,-12.952460629608,157,157,0,2
137412,3to4,3,4,0.976578311614922,-4.3200135082935,30,30,0,3
137427,4to9,4,9,0.878909100097767,-10.9703206525479,61,61,0,2
137442,9to4,9,4,0.957053642206884,-8.35273758710149,30,30,0,3
137458,4to9,4,9,0.878909100097767,-10.9703206525479,31,31,0,2
137474,9to4,9,4,0.957053642206884,-8.35273758710149,32,32,0,3
137489,4to9,4,9,0.878909100097767,-10.9703206525479,31,31,0,2
137505,9to8,9,8,0.04230593399429,-11.47166966968,377,377,0,3
137522,8to3,8,3,0.227014077405999,-4.11464622477799,125,125,0,4
137538,3to4,3,4,0.976578311614922,-4.3200135082935,64,64,0,3
137553,4to9,4,9,0.878909100097767,-10.9703206525479,64,64,0,2
137568,9to4,9,4,0.957053642206884,-8.35273758710149,30,30,0,3
137583,4to9,4,9,0.878909100097767,-10.9703206525479,30,30,0,2
137600,9to8,9,8,0.04230593399429,-11.47166966968,95,95,0,3
137616,8to3,8,3,0.227014077405999,-4.11464622477799,94,94,0,4
137631,3to4,3,4,0.976578311614922,-4.3200135082935,63,63,0,3
137647,4to9,4,9,0.878909100097767,-10.9703206525479,64,64,0,2
137662,9to4,9,4,0.957053642206884,-8.35273758710149,31,31,0,3
137677,4to3,4,3,0.121090899902233,-12.952460629608,61,61,0,2
137692,3to4,3,4,0.976578311614922,-4.3200135082935,30,30,0,3
137707,4to9,4,9,0.878909100097767,-10.9703206525479,60,60,0,2
137721,9to4,9,4,0.957053642206884,-8.35273758710149,29,29,0,3
137737,4to9,4,9,0.878909100097767,-10.9703206525479,30,30,0,2
137752,9to4,9,4,0.957053642206884,-8.35273758710149,31,31,0,3
137767,4to9,4,9,0.878909100097767,-10.9703206525479,30,30,0,2
137782,9to4,9,4,0.957053642206884,-8.35273758710149,30,30,0,3
137799,4to9,4,9,0.878909100097767,-10.9703206525479,32,32,0,2
137815,9to4,9,4,0.957053642206884,-8.35273758710149,33,33,0,3
137830,4to3,4,3,0.121090899902233,-12.952460629608,153,153,0,2
137846,3to4,3,4,0.976578311614922,-4.3200135082935,31,31,0,3
137862,4to9,4,9,0.878909100097767,-10.9703206525479,63,63,0,2
137877,9to4,9,4,0.957053642206884,-8.35273758710149,31,31,0,3
137892,4to9,4,9,0.878909100097767,-10.9703206525479,30,30,0,2
137908,9to4,9,4,0.957053642206884,-8.35273758710149,31,31,0,3
137922,4to9,4,9,0.878909100097767,-10.9703206525479,30,30,0,2
137939,9to8,9,8,0.04230593399429,-11.47166966968,339,339,0,3
137955,8to3,8,3,0.227014077405999,-4.11464622477799,125,125,0,4
137971,3to4,3,4,0.976578311614922,-4.3200135082935,63,63,0,3
137986,4to3,4,3,0.121090899902233,-12.952460629608,31,31,0,2
138001,3to4,3,4,0.976578311614922,-4.3200135082935,30,30,0,3
138017,4to9,4,9,0.878909100097767,-10.9703206525479,95,95,0,2
138034,9to4,9,4,0.957053642206884,-8.35273758710149,33,33,0,3
138050,4to9,4,9,0.878909100097767,-10.9703206525479,33,33,0,2
138067,9to4,9,4,0.957053642206884,-8.35273758710149,33,33,0,3
138083,4to9,4,9,0.878909100097767,-10.9703206525479,33,33,0,2
138100,9to4,9,4,0.957053642206884,-8.35273758710149,33,33,0,3
138115,4to9,4,9,0.878909100097767,-10.9703206525479,32,32,0,2
138130,9to4,9,4,0.957053642206884,-8.35273758710149,30,30,0,3
138146,4to3,4,3,0.121090899902233,-12.952460629608,160,160,0,2
138162,3to4,3,4,0.976578311614922,-4.3200135082935,32,32,0,3
138178,4to9,4,9,0.878909100097767,-10.9703206525479,63,63,0,2
138194,9to4,9,4,0.957053642206884,-8.35273758710149,32,32,0,3
138209,4to9,4,9,0.878909100097767,-10.9703206525479,31,31,0,2
138226,9to4,9,4,0.957053642206884,-8.35273758710149,32,32,0,3
138242,4to9,4,9,0.878909100097767,-10.9703206525479,33,33,0,2
138257,9to4,9,4,0.957053642206884,-8.35273758710149,31,31,0,3
138272,4to3,4,3,0.121090899902233,-12.952460629608,126,126,0,2
138287,3to4,3,4,0.976578311614922,-4.3200135082935,30,30,0,3
138304,4to9,4,9,0.878909100097767,-10.9703206525479,62,62,0,2
138319,9to4,9,4,0.957053642206884,-8.35273758710149,32,32,0,3
138334,4to9,4,9,0.878909100097767,-10.9703206525479,30,30,0,2
138350,9to8,9,8,0.04230593399429,-11.47166966968,411,411,0,3
138366,8to3,8,3,0.227014077405999,-4.11464622477799,94,94,0,4
138383,3to4,3,4,0.976578311614922,-4.3200135082935,64,64,0,3
138399,4to9,4,9,0.878909100097767,-10.9703206525479,65,65,0,2
138416,9to4,9,4,0.957053642206884,-8.35273758710149,33,33,0,3
138432,4to9,4,9,0.878909100097767,-10.9703206525479,33,33,0,2
138447,9to4,9,4,0.957053642206884,-8.35273758710149,31,31,0,3
138463,4to9,4,9,0.878909100097767,-10.9703206525479,31,31,0,2
138479,9to4,9,4,0.957053642206884,-8.35273758710149,32,32,0,3
138494,4to9,4,9,0.878909100097767,-10.9703206525479,31,31,0,2
138510,9to4,9,4,0.957053642206884,-8.35273758710149,31,31,0,3
138526,4to3,4,3,0.121090899902233,-12.952460629608,160,160,0,2
138542,3to4,3,4,0.976578311614922,-4.3200135082935,32,32,0,3
138559,4to9,4,9,0.878909100097767,-10.9703206525479,65,65,0,2
138575,9to8,9,8,0.04230593399429,-11.47166966968,225,225,0,3
138590,8to9,8,9,0.769052262769502,-2.89449932615566,31,31,0,4
138607,9to4,9,4,0.957053642206884,-8.35273758710149,65,65,0,3
138622,4to9,4,9,0.878909100097767,-10.9703206525479,32,32,0,2
138637,9to4,9,4,0.957053642206884,-8.35273758710149,30,30,0,3
138653,4to3,4,3,0.121090899902233,-12.952460629608,127,127,0,2
138668,3to4,3,4,0.976578311614922,-4.3200135082935,31,31,0,3
138683,4to9,4,9,0.878909100097767,-10.9703206525479,61,61,0,2
138699,9to4,9,4,0.957053642206884,-8.35273758710149,31,31,0,3
138715,4to9,4,9,0.878909100097767,-10.9703206525479,32,32,0,2
138730,9to4,9,4,0.957053642206884,-8.35273758710149,31,31,0,3
138746,4to9,4,9,0.878909100097767,-10.9703206525479,31,31,0,2
138762,9to4,9,4,0.957053642206884,-8.35273758710149,32,32,0,3
138777,4to9,4,9,0.878909100097767,-10.9703206525479,31,31,0,2
138795,9to4,9,4,0.957053642206884,-8.35273758710149,33,33,0,3
138812,4to3,4,3,0.121090899902233,-12.952460629608,159,159,0,2
138828,3to4,3,4,0.976578311614922,-4.3200135082935,33,33,0,3
138843,4to9,4,9,0.878909100097767,-10.9703206525479,66,66,0,2
138859,9to4,9,4,0.957053642206884,-8.35273758710149,31,31,0,3
138876,4to9,4,9,0.878909100097767,-10.9703206525479,33,33,0,2
138892,9to4,9,4,0.957053642206884,-8.35273758710149,33,33,0,3
138908,4to9,4,9,0.878909100097767,-10.9703206525479,32,32,0,2
138924,9to4,9,4,0.957053642206884,-8.35273758710149,32,32,0,3
138940,4to9,4,9,0.878909100097767,-10.9703206525479,32,32,0,2
138956,9to8,9,8,0.04230593399429,-11.47166966968,381,381,0,3
138972,8to3,8,3,0.227014077405999,-4.11464622477799,160,160,0,4
138988,3to4,3,4,0.976578311614922,-4.3200135082935,64,64,0,3
139004,4to9,4,9,0.878909100097767,-10.9703206525479,64,64,0,2
139021,9to4,9,4,0.957053642206884,-8.35273758710149,33,33,0,3
139036,4to9,4,9,0.878909100097767,-10.9703206525479,32,32,0,2
139052,9to4,9,4,0.957053642206884,-8.35273758710149,31,31,0,3
139069,4to9,4,9,0.878909100097767,-10.9703206525479,33,33,0,2
139084,9to4,9,4,0.957053642206884,-8.35273758710149,32,32,0,3
139101,4to3,4,3,0.121090899902233,-12.952460629608,129,129,0,2
139116,3to4,3,4,0.976578311614922,-4.3200135082935,32,32,0,3
139132,4to9,4,9,0.878909100097767,-10.9703206525479,63,63,0,2
139147,9to4,9,4,0.957053642206884,-8.35273758710149,31,31,0,3
139164,4to9,4,9,0.878909100097767,-10.9703206525479,32,32,0,2
139179,9to4,9,4,0.957053642206884,-8.35273758710149,32,32,0,3
139195,4to9,4,9,0.878909100097767,-10.9703206525479,31,31,0,2
139211,9to4,9,4,0.957053642206884,-8.35273758710149,32,32,0,3
139228,4to9,4,9,0.878909100097767,-10.9703206525479,33,33,0,2
139244,9to4,9,4,0.957053642206884,-8.35273758710149,33,33,0,3
139260,4to3,4,3,0.121090899902233,-12.952460629608,159,159,0,2
139275,3to4,3,4,0.976578311614922,-4.3200135082935,31,31,0,3
139291,4to9,4,9,0.878909100097767,-10.9703206525479,63,63,0,2
139307,9to4,9,4,0.957053642206884,-8.35273758710149,32,32,0,3
139323,4to9,4,9,0.878909100097767,-10.9703206525479,32,32,0,2
139339,9to8,9,8,0.04230593399429,-11.47166966968,383,383,0,3
139356,8to3,8,3,0.227014077405999,-4.11464622477799,96,96,0,4
139373,3to4,3,4,0.976578311614922,-4.3200135082935,66,66,0,3
139390,4to9,4,9,0.878909100097767,-10.9703206525479,67,67,0,2
139404,9to4,9,4,0.957053642206884,-8.35273758710149,31,31,0,3
139420,4to9,4,9,0.878909100097767,-10.9703206525479,30,30,0,2
139435,9to4,9,4,0.957053642206884,-8.35273758710149,31,31,0,3
139451,4to9,4,9,0.878909100097767,-10.9703206525479,31,31,0,2
139465,9to4,9,4,0.957053642206884,-8.35273758710149,30,30,0,3
139482,4to3,4,3,0.121090899902233,-12.952460629608,126,126,0,2
139496,3to4,3,4,0.976578311614922,-4.3200135082935,31,31,0,3
139510,4to9,4,9,0.878909100097767,-10.9703206525479,59,59,0,2
139527,9to4,9,4,0.957053642206884,-8.35273758710149,31,31,0,3
139543,4to9,4,9,0.878909100097767,-10.9703206525479,33,33,0,2
139559,9to4,9,4,0.957053642206884,-8.35273758710149,32,32,0,3
139575,4to9,4,9,0.878909100097767,-10.9703206525479,32,32,0,2
139591,9to4,9,4,0.957053642206884,-8.35273758710149,32,32,0,3
139606,4to9,4,9,0.878909100097767,-10.9703206525479,31,31,0,2
139620,9to4,9,4,0.957053642206884,-8.35273758710149,29,29,0,3
139636,4to3,4,3,0.121090899902233,-12.952460629608,154,154,0,2
139652,3to4,3,4,0.976578311614922,-4.3200135082935,32,32,0,3
139668,4to9,4,9,0.878909100097767,-10.9703206525479,62,62,0,2
139683,9to4,9,4,0.957053642206884,-8.35273758710149,31,31,0,3
139698,4to9,4,9,0.878909100097767,-10.9703206525479,30,30,0,2
139715,9to8,9,8,0.04230593399429,-11.47166966968,376,376,0,3
139731,8to3,8,3,0.227014077405999,-4.11464622477799,95,95,0,4
139749,3to4,3,4,0.976578311614922,-4.3200135082935,66,66,0,3
139764,4to9,4,9,0.878909100097767,-10.9703206525479,66,66,0,2
139781,9to4,9,4,0.957053642206884,-8.35273758710149,32,32,0,3
139796,4to9,4,9,0.878909100097767,-10.9703206525479,32,32,0,2
139812,9to4,9,4,0.957053642206884,-8.35273758710149,31,31,0,3
139830,4to9,4,9,0.878909100097767,-10.9703206525479,34,34,0,2
139846,9to4,9,4,0.957053642206884,-8.35273758710149,34,34,0,3
139864,4to9,4,9,0.878909100097767,-10.9703206525479,34,34,0,2
139881,9to4,9,4,0.957053642206884,-8.35273758710149,35,35,0,3
139897,4to3,4,3,0.121090899902233,-12.952460629608,166,166,0,2
139913,3to4,3,4,0.976578311614922,-4.3200135082935,32,32,0,3
139929,4to9,4,9,0.878909100097767,-10.9703206525479,65,65,0,2
139945,9to4,9,4,0.957053642206884,-8.35273758710149,32,32,0,3
139960,4to9,4,9,0.878909100097767,-10.9703206525479,31,31,0,2
139976,9to4,9,4,0.957053642206884,-8.35273758710149,31,31,0,3
139992,4to9,4,9,0.878909100097767,-10.9703206525479,32,32,0,2
140008,9to4,9,4,0.957053642206884,-8.35273758710149,32,32,0,3
140025,4to9,4,9,0.878909100097767,-10.9703206525479,33,33,0,2
140042,9to4,9,4,0.957053642206884,-8.35273758710149,34,34,0,3
140057,4to3,4,3,0.121090899902233,-12.952460629608,160,160,0,2
140073,3to4,3,4,0.976578311614922,-4.3200135082935,31,31,0,3
140087,4to9,4,9,0.878909100097767,-10.9703206525479,62,62,0,2
140103,9to8,9,8,0.04230593399429,-11.47166966968,388,388,0,3
140119,8to9,8,9,0.769052262769502,-2.89449932615566,32,32,0,4
140135,9to4,9,4,0.957053642206884,-8.35273758710149,62,62,0,3
140152,4to9,4,9,0.878909100097767,-10.9703206525479,33,33,0,2
140169,9to4,9,4,0.957053642206884,-8.35273758710149,34,34,0,3
140185,4to9,4,9,0.878909100097767,-10.9703206525479,33,33,0,2
140200,9to4,9,4,0.957053642206884,-8.35273758710149,31,31,0,3
140215,4to3,4,3,0.121090899902233,-12.952460629608,158,158,0,2
140231,3to2,3,2,0.000679079650815,-11.5910853038632,3007,3007,0,3
140246,2to3,2,3,0.99807865202861,-3.95697141540815,31,31,0,3
140263,3to4,3,4,0.976578311614922,-4.3200135082935,63,63,0,3
140278,4to9,4,9,0.878909100097767,-10.9703206525479,93,93,0,2
140294,9to4,9,4,0.957053642206884,-8.35273758710149,31,31,0,3
140311,4to9,4,9,0.878909100097767,-10.9703206525479,33,33,0,2
140327,9to4,9,4,0.957053642206884,-8.35273758710149,33,33,0,3
140343,4to9,4,9,0.878909100097767,-10.9703206525479,32,32,0,2
140358,9to4,9,4,0.957053642206884,-8.35273758710149,31,31,0,3
140374,4to3,4,3,0.121090899902233,-12.952460629608,128,128,0,2
140389,3to4,3,4,0.976578311614922,-4.3200135082935,31,31,0,3
140405,4to9,4,9,0.878909100097767,-10.9703206525479,62,62,0,2
140421,9to4,9,4,0.957053642206884,-8.35273758710149,32,32,0,3
140438,4to3,4,3,0.121090899902233,-12.952460629608,64,64,0,2
140454,3to4,3,4,0.976578311614922,-4.3200135082935,33,33,0,3
140471,4to9,4,9,0.878909100097767,-10.9703206525479,66,66,0,2
140486,9to4,9,4,0.957053642206884,-8.35273758710149,32,32,0,3
140501,4to9,4,9,0.878909100097767,-10.9703206525479,30,30,0,2
140517,9to8,9,8,0.04230593399429,-11.47166966968,414,414,0,3
140534,8to3,8,3,0.227014077405999,-4.11464622477799,96,96,0,4
140551,3to4,3,4,0.976578311614922,-4.3200135082935,65,65,0,3
140568,4to9,4,9,0.878909100097767,-10.9703206525479,67,67,0,2
140583,9to4,9,4,0.957053642206884,-8.35273758710149,32,32,0,3
140598,4to9,4,9,0.878909100097767,-10.9703206525479,30,30,0,2
140614,9to4,9,4,0.957053642206884,-8.35273758710149,31,31,0,3
140628,4to9,4,9,0.878909100097767,-10.9703206525479,30,30,0,2
140643,9to4,9,4,0.957053642206884,-8.35273758710149,29,29,0,3
140657,4to3,4,3,0.121090899902233,-12.952460629608,123,123,0,2
140673,3to4,3,4,0.976578311614922,-4.3200135082935,30,30,0,3
140689,4to9,4,9,0.878909100097767,-10.9703206525479,61,61,0,2
140704,9to4,9,4,0.957053642206884,-8.35273758710149,31,31,0,3
140719,4to9,4,9,0.878909100097767,-10.9703206525479,30,30,0,2
140735,9to8,9,8,0.04230593399429,-11.47166966968,218,218,0,3
140754,8to3,8,3,0.227014077405999,-4.11464622477799,97,97,0,4
140769,3to4,3,4,0.976578311614922,-4.3200135082935,65,65,0,3
140785,4to9,4,9,0.878909100097767,-10.9703206525479,66,66,0,2
140801,9to4,9,4,0.957053642206884,-8.35273758710149,32,32,0,3
140817,4to9,4,9,0.878909100097767,-10.9703206525479,32,32,0,2
140832,9to4,9,4,0.957053642206884,-8.35273758710149,31,31,0,3
140849,4to9,4,9,0.878909100097767,-10.9703206525479,32,32,0,2
140864,9to4,9,4,0.957053642206884,-8.35273758710149,32,32,0,3
140880,4to3,4,3,0.121090899902233,-12.952460629608,126,126,0,2
140894,3to4,3,4,0.976578311614922,-4.3200135082935,30,30,0,3
140911,4to9,4,9,0.878909100097767,-10.9703206525479,62,62,0,2
140927,9to4,9,4,0.957053642206884,-8.35273758710149,33,33,0,3
140944,4to9,4,9,0.878909100097767,-10.9703206525479,33,33,0,2
140961,9to4,9,4,0.957053642206884,-8.35273758710149,34,34,0,3
140975,4to9,4,9,0.878909100097767,-10.9703206525479,31,31,0,2
140992,9to4,9,4,0.957053642206884,-8.35273758710149,31,31,0,3
141008,4to9,4,9,0.878909100097767,-10.9703206525479,33,33,0,2
141024,9to4,9,4,0.957053642206884,-8.35273758710149,32,32,0,3
141040,4to3,4,3,0.121090899902233,-12.952460629608,160,160,0,2
141056,3to4,3,4,0.976578311614922,-4.3200135082935,32,32,0,3
141074,4to9,4,9,0.878909100097767,-10.9703206525479,66,66,0,2
141089,9to4,9,4,0.957053642206884,-8.35273758710149,33,33,0,3
141105,4to9,4,9,0.878909100097767,-10.9703206525479,31,31,0,2
141122,9to8,9,8,0.04230593399429,-11.47166966968,387,387,0,3
141137,8to3,8,3,0.227014077405999,-4.11464622477799,97,97,0,4
141153,3to4,3,4,0.976578311614922,-4.3200135082935,64,64,0,3
141169,4to9,4,9,0.878909100097767,-10.9703206525479,64,64,0,2
141183,9to4,9,4,0.957053642206884,-8.35273758710149,30,30,0,3
141199,4to9,4,9,0.878909100097767,-10.9703206525479,30,30,0,2
141215,9to4,9,4,0.957053642206884,-8.35273758710149,32,32,0,3
141231,4to9,4,9,0.878909100097767,-10.9703206525479,32,32,0,2
141246,9to4,9,4,0.957053642206884,-8.35273758710149,31,31,0,3
141263,4to3,4,3,0.121090899902233,-12.952460629608,126,126,0,2
141278,3to4,3,4,0.976578311614922,-4.3200135082935,32,32,0,3
141296,4to9,4,9,0.878909100097767,-10.9703206525479,65,65,0,2
141312,9to4,9,4,0.957053642206884,-8.35273758710149,34,34,0,3
141327,4to9,4,9,0.878909100097767,-10.9703206525479,31,31,0,2
141342,9to4,9,4,0.957053642206884,-8.35273758710149,30,30,0,3
141359,4to3,4,3,0.121090899902233,-12.952460629608,96,96,0,2
141375,3to4,3,4,0.976578311614922,-4.3200135082935,33,33,0,3
141391,4to9,4,9,0.878909100097767,-10.9703206525479,64,64,0,2
141406,9to4,9,4,0.957053642206884,-8.35273758710149,31,31,0,3
141423,4to9,4,9,0.878909100097767,-10.9703206525479,32,32,0,2
141438,9to4,9,4,0.957053642206884,-8.35273758710149,32,32,0,3
141454,4to9,4,9,0.878909100097767,-10.9703206525479,31,31,0,2
141470,9to4,9,4,0.957053642206884,-8.35273758710149,32,32,0,3
141484,4to9,4,9,0.878909100097767,-10.9703206525479,30,30,0,2
141501,9to8,9,8,0.04230593399429,-11.47166966968,379,379,0,3
141516,8to7,8,7,0.000908728145689,-9.63536755452497,5747,5747,0,4
141531,7to12,7,12,0.032778628546067,-5.69906772733497,5747,1271,4476,4
141548,12to13,12,13,0.975305689097347,-6.36264020069652,5294,5294,0,4
141564,13to14,13,14,0.071150450944958,-9.93118461773681,5327,5327,0,4
141580,14to9,14,9,0.963868560337125,-5.13076416031772,96,96,0,3
141596,9to4,9,4,0.957053642206884,-8.35273758710149,126,126,0,3
141613,4to3,4,3,0.121090899902233,-12.952460629608,254,254,0,2
141628,3to4,3,4,0.976578311614922,-4.3200135082935,32,32,0,3
141644,4to9,4,9,0.878909100097767,-10.9703206525479,64,64,0,2
141659,9to4,9,4,0.957053642206884,-8.35273758710149,31,31,0,3
141676,4to9,4,9,0.878909100097767,-10.9703206525479,32,32,0,2
141691,9to4,9,4,0.957053642206884,-8.35273758710149,32,32,0,3
141707,4to9,4,9,0.878909100097767,-10.9703206525479,31,31,0,2
141722,9to4,9,4,0.957053642206884,-8.35273758710149,31,31,0,3
141738,4to3,4,3,0.121090899902233,-12.952460629608,125,125,0,2
141755,3to4,3,4,0.976578311614922,-4.3200135082935,33,33,0,3
141771,4to9,4,9,0.878909100097767,-10.9703206525479,64,64,0,2
141786,9to4,9,4,0.957053642206884,-8.35273758710149,31,31,0,3
141802,4to9,4,9,0.878909100097767,-10.9703206525479,31,31,0,2
141816,9to4,9,4,0.957053642206884,-8.35273758710149,30,30,0,3
141832,4to9,4,9,0.878909100097767,-10.9703206525479,30,30,0,2
141848,9to4,9,4,0.957053642206884,-8.35273758710149,32,32,0,3
141863,4to9,4,9,0.878909100097767,-10.9703206525479,31,31,0,2
141879,9to8,9,8,0.04230593399429,-11.47166966968,378,378,0,3
141895,8to3,8,3,0.227014077405999,-4.11464622477799,157,157,0,4
141912,3to4,3,4,0.976578311614922,-4.3200135082935,64,64,0,3
141927,4to9,4,9,0.878909100097767,-10.9703206525479,64,64,0,2
141944,9to4,9,4,0.957053642206884,-8.35273758710149,32,32,0,3
141959,4to9,4,9,0.878909100097767,-10.9703206525479,32,32,0,2
141974,9to4,9,4,0.957053642206884,-8.35273758710149,30,30,0,3
141991,4to9,4,9,0.878909100097767,-10.9703206525479,32,32,0,2
142007,9to4,9,4,0.957053642206884,-8.35273758710149,33,33,0,3
142023,4to9,4,9,0.878909100097767,-10.9703206525479,32,32,0,2
142039,9to4,9,4,0.957053642206884,-8.35273758710149,32,32,0,3
142055,4to3,4,3,0.121090899902233,-12.952460629608,160,160,0,2
142072,3to4,3,4,0.976578311614922,-4.3200135082935,33,33,0,3
142088,4to9,4,9,0.878909100097767,-10.9703206525479,65,65,0,2
142103,9to4,9,4,0.957053642206884,-8.35273758710149,31,31,0,3
142120,4to9,4,9,0.878909100097767,-10.9703206525479,32,32,0,2
142135,9to4,9,4,0.957053642206884,-8.35273758710149,32,32,0,3
142150,4to9,4,9,0.878909100097767,-10.9703206525479,30,30,0,2
142166,9to4,9,4,0.957053642206884,-8.35273758710149,31,31,0,3
142181,4to9,4,9,0.878909100097767,-10.9703206525479,31,31,0,2
142196,9to4,9,4,0.957053642206884,-8.35273758710149,30,30,0,3
142211,4to3,4,3,0.121090899902233,-12.952460629608,156,156,0,2
142228,3to4,3,4,0.976578311614922,-4.3200135082935,32,32,0,3
142245,4to9,4,9,0.878909100097767,-10.9703206525479,64,64,0,2
142263,9to14,9,14,0.00033032121997,-16.3245969867306,699,236,463,3
142278,14to13,14,13,0.018651595113073,-9.09371951571432,730,235,495,3
142295,13to8,13,8,0.917295535428803,-7.37455157477482,416,416,0,4
142312,8to9,8,9,0.769052262769502,-2.89449932615566,67,67,0,4
142327,9to4,9,4,0.957350617199289,-8.35273758710149,99,99,0,3
142343,4to3,4,3,0.121090899902233,-12.952460629608,132,132,0,2
142360,3to2,3,2,0.000679079650815,-11.5910853038632,2129,2129,0,3
142377,2to3,2,3,0.99807865202861,-3.95697141540815,34,34,0,3
142394,3to4,3,4,0.976578311614922,-4.3200135082935,67,67,0,3
142410,4to9,4,9,0.878909100097767,-10.9703206525479,98,98,0,2
142425,9to4,9,4,0.957350617199289,-8.35273758710149,31,31,0,3
142440,4to9,4,9,0.878909100097767,-10.9703206525479,30,30,0,2
142455,9to4,9,4,0.957350617199289,-8.35273758710149,30,30,0,3
142470,4to9,4,9,0.878909100097767,-10.9703206525479,30,30,0,2
142485,9to4,9,4,0.957350617199289,-8.35273758710149,30,30,0,3
142501,4to9,4,9,0.878909100097767,-10.9703206525479,31,31,0,2
142515,9to4,9,4,0.957350617199289,-8.35273758710149,30,30,0,3
142532,4to3,4,3,0.121090899902233,-12.952460629608,155,155,0,2
142549,3to4,3,4,0.976578311614922,-4.3200135082935,34,34,0,3
142566,4to9,4,9,0.878909100097767,-10.9703206525479,65,65,0,2
142582,9to4,9,4,0.957350617199289,-8.35273758710149,33,33,0,3
142598,4to9,4,9,0.878909100097767,-10.9703206525479,32,32,0,2
142614,9to4,9,4,0.957350617199289,-8.35273758710149,32,32,0,3
142628,4to9,4,9,0.878909100097767,-10.9703206525479,30,30,0,2
142644,9to8,9,8,0.042319061580741,-11.47166966968,349,349,0,3
142659,8to3,8,3,0.227014077405999,-4.11464622477799,127,127,0,4
142675,3to4,3,4,0.976578311614922,-4.3200135082935,61,61,0,3
142691,4to9,4,9,0.878909100097767,-10.9703206525479,63,63,0,2
142706,9to4,9,4,0.957350617199289,-8.35273758710149,31,31,0,3
142722,4to9,4,9,0.878909100097767,-10.9703206525479,31,31,0,2
142737,9to4,9,4,0.957350617199289,-8.35273758710149,31,31,0,3
142753,4to9,4,9,0.878909100097767,-10.9703206525479,31,31,0,2
142769,9to4,9,4,0.957350617199289,-8.35273758710149,32,32,0,3
142785,4to9,4,9,0.878909100097767,-10.9703206525479,32,32,0,2
142799,9to4,9,4,0.957350617199289,-8.35273758710149,30,30,0,3
142816,4to3,4,3,0.121090899902233,-12.952460629608,157,157,0,2
142831,3to4,3,4,0.976578311614922,-4.3200135082935,32,32,0,3
142847,4to9,4,9,0.878909100097767,-10.9703206525479,62,62,0,2
142861,9to14,9,14,0.00033032121997,-16.3245969867306,598,598,0,3
142877,14to9,14,9,0.981308638880882,-5.13076416031772,30,30,0,3
142894,9to4,9,4,0.957350617199289,-8.35273758710149,63,63,0,3
142910,4to9,4,9,0.878909100097767,-10.9703206525479,33,33,0,2
142926,9to4,9,4,0.957350617199289,-8.35273758710149,32,32,0,3
142941,4to9,4,9,0.878909100097767,-10.9703206525479,31,31,0,2
142957,9to4,9,4,0.957350617199289,-8.35273758710149,31,31,0,3
142973,4to3,4,3,0.121090899902233,-12.952460629608,157,157,0,2
142989,3to4,3,4,0.976578311614922,-4.3200135082935,32,32,0,3
143005,4to9,4,9,0.878909100097767,-10.9703206525479,64,64,0,2
143021,9to4,9,4,0.957350617199289,-8.35273758710149,32,32,0,3
143036,4to9,4,9,0.878909100097767,-10.9703206525479,31,31,0,2
143053,9to8,9,8,0.042319061580741,-11.47166966968,409,409,0,3
143071,8to3,8,3,0.227014077405999,-4.11464622477799,98,98,0,4
143088,3to4,3,4,0.976578311614922,-4.3200135082935,67,67,0,3
143105,4to9,4,9,0.878909100097767,-10.9703206525479,69,69,0,2
143120,9to4,9,4,0.957350617199289,-8.35273758710149,32,32,0,3
143135,4to9,4,9,0.878909100097767,-10.9703206525479,30,30,0,2
143150,9to4,9,4,0.957350617199289,-8.35273758710149,30,30,0,3
143166,4to9,4,9,0.878909100097767,-10.9703206525479,31,31,0,2
143181,9to4,9,4,0.957350617199289,-8.35273758710149,31,31,0,3
143195,4to3,4,3,0.121090899902233,-12.952460629608,124,124,0,2
143210,3to4,3,4,0.976578311614922,-4.3200135082935,29,29,0,3
143226,4to9,4,9,0.878909100097767,-10.9703206525479,60,60,0,2
143243,9to4,9,4,0.957350617199289,-8.35273758710149,33,33,0,3
143258,4to9,4,9,0.878909100097767,-10.9703206525479,32,32,0,2
143273,9to4,9,4,0.957350617199289,-8.35273758710149,30,30,0,3
143288,4to9,4,9,0.878909100097767,-10.9703206525479,30,30,0,2
143302,9to4,9,4,0.957350617199289,-8.35273758710149,29,29,0,3
143318,4to3,4,3,0.121090899902233,-12.952460629608,123,123,0,2
143335,3to4,3,4,0.976578311614922,-4.3200135082935,33,33,0,3
143352,4to9,4,9,0.878909100097767,-10.9703206525479,64,64,0,2
143368,9to4,9,4,0.957350617199289,-8.35273758710149,33,33,0,3
143382,4to9,4,9,0.878909100097767,-10.9703206525479,30,30,0,2
143398,9to8,9,8,0.042319061580741,-11.47166966968,345,345,0,3
143416,8to3,8,3,0.227014077405999,-4.11464622477799,98,98,0,4
143433,3to4,3,4,0.976578311614922,-4.3200135082935,65,65,0,3
143449,4to9,4,9,0.878909100097767,-10.9703206525479,67,67,0,2
143466,9to4,9,4,0.957350617199289,-8.35273758710149,33,33,0,3
143482,4to9,4,9,0.878909100097767,-10.9703206525479,33,33,0,2
143497,9to4,9,4,0.957350617199289,-8.35273758710149,31,31,0,3
143512,4to9,4,9,0.878909100097767,-10.9703206525479,30,30,0,2
143528,9to4,9,4,0.957350617199289,-8.35273758710149,31,31,0,3
143543,4to9,4,9,0.878909100097767,-10.9703206525479,31,31,0,2
143559,9to4,9,4,0.957350617199289,-8.35273758710149,31,31,0,3
143573,4to3,4,3,0.121090899902233,-12.952460629608,157,157,0,2
143588,3to4,3,4,0.976578311614922,-4.3200135082935,29,29,0,3
143604,4to9,4,9,0.878909100097767,-10.9703206525479,61,61,0,2
143618,9to4,9,4,0.957350617199289,-8.35273758710149,30,30,0,3
143633,4to9,4,9,0.878909100097767,-10.9703206525479,29,29,0,2
143648,9to4,9,4,0.957350617199289,-8.35273758710149,30,30,0,3
143664,4to9,4,9,0.878909100097767,-10.9703206525479,31,31,0,2
143679,9to4,9,4,0.957350617199289,-8.35273758710149,31,31,0,3
143696,4to9,4,9,0.878909100097767,-10.9703206525479,32,32,0,2
143712,9to14,9,14,0.00033032121997,-16.3245969867306,851,851,0,3
143727,14to13,14,13,0.018651595113073,-9.09371951571432,1449,1449,0,3
143744,13to8,13,8,0.917295535428803,-7.37455157477482,346,346,0,4
143760,8to3,8,3,0.227014077405999,-4.11464622477799,187,187,0,4
143776,3to4,3,4,0.976578311614922,-4.3200135082935,97,97,0,3
143792,4to9,4,9,0.878909100097767,-10.9703206525479,96,96,0,2
143809,9to4,9,4,0.957350617199289,-8.35273758710149,33,33,0,3
143824,4to9,4,9,0.878909100097767,-10.9703206525479,32,32,0,2
143841,9to4,9,4,0.957350617199289,-8.35273758710149,32,32,0,3
143858,4to9,4,9,0.878909100097767,-10.9703206525479,34,34,0,2
143873,9to4,9,4,0.957350617199289,-8.35273758710149,32,32,0,3
143887,4to3,4,3,0.121090899902233,-12.952460629608,127,127,0,2
143901,3to4,3,4,0.976578311614922,-4.3200135082935,28,28,0,3
143918,4to9,4,9,0.878909100097767,-10.9703206525479,60,60,0,2
143934,9to4,9,4,0.957350617199289,-8.35273758710149,33,33,0,3
143950,4to9,4,9,0.878909100097767,-10.9703206525479,32,32,0,2
143967,9to4,9,4,0.957350617199289,-8.35273758710149,33,33,0,3
143982,4to9,4,9,0.878909100097767,-10.9703206525479,32,32,0,2
143997,9to4,9,4,0.957350617199289,-8.35273758710149,30,30,0,3
144012,4to9,4,9,0.878909100097767,-10.9703206525479,30,30,0,2
144027,9to4,9,4,0.957350617199289,-8.35273758710149,30,30,0,3
144043,4to3,4,3,0.121090899902233,-12.952460629608,156,156,0,2
144060,3to8,3,8,0.022742608734262,-8.07982824981408,316,316,0,3
144076,8to3,8,3,0.227014077405999,-4.11464622477799,33,33,0,4
144091,3to4,3,4,0.976578311614922,-4.3200135082935,64,64,0,3
144107,4to9,4,9,0.878909100097767,-10.9703206525479,95,95,0,2
144122,9to4,9,4,0.957350617199289,-8.35273758710149,31,31,0,3
144137,4to9,4,9,0.878909100097767,-10.9703206525479,30,30,0,2
144153,9to4,9,4,0.957350617199289,-8.35273758710149,31,31,0,3
144169,4to9,4,9,0.878909100097767,-10.9703206525479,32,32,0,2
144184,9to4,9,4,0.957350617199289,-8.35273758710149,31,31,0,3
144199,4to9,4,9,0.878909100097767,-10.9703206525479,30,30,0,2
144216,9to4,9,4,0.957350617199289,-8.35273758710149,32,32,0,3
144232,4to3,4,3,0.121090899902233,-12.952460629608,156,156,0,2
144247,3to4,3,4,0.976578311614922,-4.3200135082935,31,31,0,3
144261,4to9,4,9,0.878909100097767,-10.9703206525479,62,62,0,2
144276,9to4,9,4,0.957350617199289,-8.35273758710149,29,29,0,3
144291,4to9,4,9,0.878909100097767,-10.9703206525479,30,30,0,2
144306,9to4,9,4,0.957350617199289,-8.35273758710149,30,30,0,3
144321,4to9,4,9,0.878909100097767,-10.9703206525479,30,30,0,2
144336,9to4,9,4,0.957350617199289,-8.35273758710149,30,30,0,3
144351,4to9,4,9,0.878909100097767,-10.9703206525479,30,30,0,2
144367,9to4,9,4,0.957350617199289,-8.35273758710149,31,31,0,3
144382,4to3,4,3,0.121090899902233,-12.952460629608,150,150,0,2
144397,3to4,3,4,0.976578311614922,-4.3200135082935,30,30,0,3
144413,4to9,4,9,0.878909100097767,-10.9703206525479,62,62,0,2
144429,9to4,9,4,0.957350617199289,-8.35273758710149,32,32,0,3
144445,4to9,4,9,0.878909100097767,-10.9703206525479,32,32,0,2
144461,9to8,9,8,0.042319061580741,-11.47166966968,401,401,0,3
144477,8to3,8,3,0.227014077405999,-4.11464622477799,95,95,0,4
144493,3to4,3,4,0.976578311614922,-4.3200135082935,64,64,0,3
144509,4to3,4,3,0.121090899902233,-12.952460629608,32,32,0,2
144526,3to4,3,4,0.976578311614922,-4.3200135082935,33,33,0,3
144543,4to9,4,9,0.878909100097767,-10.9703206525479,98,98,0,2
144559,9to4,9,4,0.957350617199289,-8.35273758710149,33,33,0,3
144575,4to9,4,9,0.878909100097767,-10.9703206525479,32,32,0,2
144591,9to4,9,4,0.957350617199289,-8.35273758710149,32,32,0,3
144607,4to9,4,9,0.878909100097767,-10.9703206525479,32,32,0,2
144623,9to4,9,4,0.957350617199289,-8.35273758710149,32,32,0,3
144637,4to9,4,9,0.878909100097767,-10.9703206525479,30,30,0,2
144652,9to4,9,4,0.957350617199289,-8.35273758710149,29,29,0,3
144669,4to3,4,3,0.121090899902233,-12.952460629608,160,160,0,2
144686,3to4,3,4,0.976578311614922,-4.3200135082935,34,34,0,3
144701,4to9,4,9,0.878909100097767,-10.9703206525479,64,64,0,2
144717,9to4,9,4,0.957350617199289,-8.35273758710149,31,31,0,3
144732,4to3,4,3,0.121090899902233,-12.952460629608,63,63,0,2
144748,3to2,3,2,0.000679079650815,-11.5910853038632,2388,2388,0,3
144765,2to1,2,1,0.000266137501632,-12.186778660608,29619,10992,18627,3
144781,1to0,1,0,0.034128337655383,-10.2340901217056,29653,12679,16974,3
144797,0to5,0,5,0.773820929474193,-5.98773230551033,29686,12710,16976,2
144812,5to10,5,10,0.333387080848655,-8.09930497968363,29748,12741,17007,3
144829,10to11,10,11,0.492915584021038,-10.8968230504388,17131,4552,12579,3
144846,11to16,11,16,0.021031708309038,-9.71856713934573,54769,20,54749,4
144862,16to17,16,17,0.08873561944022,-6.48472957875261,29879,21,29858,4
144878,17to12,17,12,0.955006792211011,-5.20631123779532,3347,3347,0,4
144894,12to13,12,13,0.975305689097347,-6.36264020069652,1167,1167,0,4
144908,13to8,13,8,0.917295535428803,-7.37455157477482,447,447,0,4
144925,8to3,8,3,0.227014077405999,-4.11464622477799,193,193,0,4
144943,3to4,3,4,0.976578311614922,-4.3200135082935,226,226,0,3
144958,4to9,4,9,0.878909100097767,-10.9703206525479,257,257,0,2
144974,9to4,9,4,0.957350617199289,-8.35273758710149,31,31,0,3
144991,4to9,4,9,0.878909100097767,-10.9703206525479,33,33,0,2
145006,9to4,9,4,0.957350617199289,-8.35273758710149,32,32,0,3
145021,4to9,4,9,0.878909100097767,-10.9703206525479,30,30,0,2
145036,9to4,9,4,0.957350617199289,-8.35273758710149,30,30,0,3
145052,4to3,4,3,0.121090899902233,-12.952460629608,127,127,0,2
145067,3to4,3,4,0.976578311614922,-4.3200135082935,31,31,0,3
145084,4to9,4,9,0.878909100097767,-10.9703206525479,63,63,0,2
145101,9to4,9,4,0.957350617199289,-8.35273758710149,34,34,0,3
145117,4to9,4,9,0.878909100097767,-10.9703206525479,33,33,0,2
145132,9to4,9,4,0.957350617199289,-8.35273758710149,31,31,0,3
145147,4to9,4,9,0.878909100097767,-10.9703206525479,30,30,0,2
145162,9to4,9,4,0.957350617199289,-8.35273758710149,30,30,0,3
145178,4to3,4,3,0.121090899902233,-12.952460629608,126,126,0,2
145194,3to4,3,4,0.976578311614922,-4.3200135082935,32,32,0,3
145212,4to9,4,9,0.878909100097767,-10.9703206525479,65,65,0,2
145229,9to8,9,8,0.042319061580741,-11.47166966968,321,321,0,3
145245,8to9,8,9,0.769052262769502,-2.89449932615566,33,33,0,4
145260,9to4,9,4,0.957350617199289,-8.35273758710149,66,66,0,3
145275,4to9,4,9,0.878909100097767,-10.9703206525479,30,30,0,2
145289,9to4,9,4,0.957350617199289,-8.35273758710149,29,29,0,3
145305,4to3,4,3,0.121090899902233,-12.952460629608,127,127,0,2
145321,3to4,3,4,0.976578311614922,-4.3200135082935,32,32,0,3
145338,4to9,4,9,0.878909100097767,-10.9703206525479,63,63,0,2
145354,9to4,9,4,0.957350617199289,-8.35273758710149,33,33,0,3
145370,4to9,4,9,0.878909100097767,-10.9703206525479,32,32,0,2
145386,9to4,9,4,0.957350617199289,-8.35273758710149,32,32,0,3
145402,4to9,4,9,0.878909100097767,-10.9703206525479,32,32,0,2
145418,9to4,9,4,0.957350617199289,-8.35273758710149,32,32,0,3
145434,4to9,4,9,0.878909100097767,-10.9703206525479,32,32,0,2
145449,9to4,9,4,0.957350617199289,-8.35273758710149,31,31,0,3
145464,4to3,4,3,0.121090899902233,-12.952460629608,159,159,0,2
145480,3to4,3,4,0.976578311614922,-4.3200135082935,31,31,0,3
145497,4to9,4,9,0.878909100097767,-10.9703206525479,63,63,0,2
145513,9to4,9,4,0.957350617199289,-8.35273758710149,33,33,0,3
145529,4to9,4,9,0.878909100097767,-10.9703206525479,32,32,0,2
145544,9to4,9,4,0.957350617199289,-8.35273758710149,31,31,0,3
145559,4to9,4,9,0.878909100097767,-10.9703206525479,30,30,0,2
145574,9to4,9,4,0.957350617199289,-8.35273758710149,30,30,0,3
145590,4to3,4,3,0.121090899902233,-12.952460629608,126,126,0,2
145606,3to4,3,4,0.976578311614922,-4.3200135082935,32,32,0,3
145622,4to9,4,9,0.878909100097767,-10.9703206525479,63,63,0,2
145639,9to8,9,8,0.042319061580741,-11.47166966968,410,410,0,3
145655,8to9,8,9,0.769052262769502,-2.89449932615566,33,33,0,4
145671,9to4,9,4,0.957350617199289,-8.35273758710149,65,65,0,3
145687,4to9,4,9,0.878909100097767,-10.9703206525479,32,32,0,2
145703,9to4,9,4,0.957350617199289,-8.35273758710149,32,32,0,3
145719,4to9,4,9,0.878909100097767,-10.9703206525479,32,32,0,2
145736,9to4,9,4,0.957350617199289,-8.35273758710149,33,33,0,3
145752,4to3,4,3,0.121090899902233,-12.952460629608,162,162,0,2
145767,3to4,3,4,0.976578311614922,-4.3200135082935,31,31,0,3
145784,4to9,4,9,0.878909100097767,-10.9703206525479,65,65,0,2
145801,9to14,9,14,0.000230043917518,-16.6864926305794,2089,1333,756,3
145817,14to13,14,13,0.018651595113073,-9.09371951571432,923,923,0,3
145835,13to8,13,8,0.917295535428803,-7.37455157477482,196,196,0,4
145852,8to9,8,9,0.769052262769502,-2.89449932615566,68,68,0,4
145868,9to4,9,4,0.957446649458175,-8.35273758710149,101,101,0,3
145883,4to9,4,9,0.878909100097767,-10.9703206525479,31,31,0,2
145898,9to4,9,4,0.957446649458175,-8.35273758710149,30,30,0,3
145916,4to3,4,3,0.121090899902233,-12.952460629608,164,164,0,2
145932,3to4,3,4,0.976578311614922,-4.3200135082935,34,34,0,3
145948,4to9,4,9,0.878909100097767,-10.9703206525479,65,65,0,2
145963,9to4,9,4,0.957446649458175,-8.35273758710149,31,31,0,3
145979,4to9,4,9,0.878909100097767,-10.9703206525479,31,31,0,2
145993,9to4,9,4,0.957446649458175,-8.35273758710149,30,30,0,3
146009,4to9,4,9,0.878909100097767,-10.9703206525479,30,30,0,2
146025,9to4,9,4,0.957446649458175,-8.35273758710149,32,32,0,3
146040,4to9,4,9,0.878909100097767,-10.9703206525479,31,31,0,2
146054,9to4,9,4,0.957446649458175,-8.35273758710149,29,29,0,3
146071,4to3,4,3,0.121090899902233,-12.952460629608,155,155,0,2
146087,3to4,3,4,0.976578311614922,-4.3200135082935,33,33,0,3
146103,4to9,4,9,0.878909100097767,-10.9703206525479,63,63,0,2
146120,9to4,9,4,0.957446649458175,-8.35273758710149,33,33,0,3
146136,4to9,4,9,0.878909100097767,-10.9703206525479,33,33,0,2
146152,9to4,9,4,0.957446649458175,-8.35273758710149,32,32,0,3
146168,4to9,4,9,0.878909100097767,-10.9703206525479,32,32,0,2
146183,9to4,9,4,0.957446649458175,-8.35273758710149,31,31,0,3
146198,4to3,4,3,0.121090899902233,-12.952460629608,127,127,0,2
146215,3to4,3,4,0.976578311614922,-4.3200135082935,32,32,0,3
146231,4to3,4,3,0.121090899902233,-12.952460629608,33,33,0,2
146247,3to4,3,4,0.976578311614922,-4.3200135082935,32,32,0,3
146264,4to9,4,9,0.878909100097767,-10.9703206525479,96,96,0,2
146280,9to8,9,8,0.042323306624307,-11.47166966968,445,445,0,3
146295,8to9,8,9,0.769052262769502,-2.89449932615566,31,31,0,4
146312,9to4,9,4,0.957446649458175,-8.35273758710149,65,65,0,3
146326,4to9,4,9,0.878909100097767,-10.9703206525479,31,31,0,2
146341,9to4,9,4,0.957446649458175,-8.35273758710149,29,29,0,3
146357,4to3,4,3,0.121090899902233,-12.952460629608,126,126,0,2
146373,3to4,3,4,0.976578311614922,-4.3200135082935,32,32,0,3
146389,4to9,4,9,0.878909100097767,-10.9703206525479,63,63,0,2
146404,9to4,9,4,0.957446649458175,-8.35273758710149,31,31,0,3
146422,4to9,4,9,0.878909100097767,-10.9703206525479,33,33,0,2
146437,9to4,9,4,0.957446649458175,-8.35273758710149,33,33,0,3
146454,4to9,4,9,0.878909100097767,-10.9703206525479,32,32,0,2
146469,9to14,9,14,0.000230043917518,-16.6864926305794,668,668,0,3
146484,14to9,14,9,0.981308638880882,-5.13076416031772,30,30,0,3
146500,9to4,9,4,0.957446649458175,-8.35273758710149,63,63,0,3
146517,4to3,4,3,0.121090899902233,-12.952460629608,160,160,0,2
146533,3to4,3,4,0.976578311614922,-4.3200135082935,33,33,0,3
146548,4to9,4,9,0.878909100097767,-10.9703206525479,64,64,0,2
146565,9to4,9,4,0.957446649458175,-8.35273758710149,32,32,0,3
146582,4to9,4,9,0.878909100097767,-10.9703206525479,34,34,0,2
146597,9to4,9,4,0.957446649458175,-8.35273758710149,32,32,0,3
146614,4to9,4,9,0.878909100097767,-10.9703206525479,32,32,0,2
146629,9to4,9,4,0.957446649458175,-8.35273758710149,32,32,0,3
146645,4to3,4,3,0.121090899902233,-12.952460629608,128,128,0,2
146660,3to4,3,4,0.976578311614922,-4.3200135082935,31,31,0,3
146676,4to9,4,9,0.878909100097767,-10.9703206525479,62,62,0,2
146691,9to8,9,8,0.042323306624307,-11.47166966968,411,411,0,3
146706,8to13,8,13,0.00302493167881,-8.43276974963057,889,889,0,4
146722,13to12,13,12,0.011455333786539,-11.7575258257807,1844,1844,0,4
146738,12to7,12,7,0.019195020372649,-10.2907402600302,5222,5222,0,4
146753,7to8,7,8,0.891261489172192,-2.39620659892225,62,62,0,4
146769,8to9,8,9,0.769052262769502,-2.89449932615566,93,93,0,4
146785,9to4,9,4,0.957446649458175,-8.35273758710149,125,125,0,3
146801,4to3,4,3,0.121090899902233,-12.952460629608,156,156,0,2
146815,3to4,3,4,0.976578311614922,-4.3200135082935,30,30,0,3
146832,4to9,4,9,0.878909100097767,-10.9703206525479,63,63,0,2
146847,9to4,9,4,0.957446649458175,-8.35273758710149,32,32,0,3
146863,4to9,4,9,0.878909100097767,-10.9703206525479,31,31,0,2
146879,9to4,9,4,0.957446649458175,-8.35273758710149,32,32,0,3
146894,4to9,4,9,0.878909100097767,-10.9703206525479,31,31,0,2
146910,9to4,9,4,0.957446649458175,-8.35273758710149,31,31,0,3
146926,4to9,4,9,0.878909100097767,-10.9703206525479,32,32,0,2
146944,9to4,9,4,0.957446649458175,-8.35273758710149,34,34,0,3
146959,4to3,4,3,0.121090899902233,-12.952460629608,158,158,0,2
146974,3to4,3,4,0.976578311614922,-4.3200135082935,30,30,0,3
146991,4to9,4,9,0.878909100097767,-10.9703206525479,65,65,0,2
147006,9to4,9,4,0.957446649458175,-8.35273758710149,32,32,0,3
147022,4to9,4,9,0.878909100097767,-10.9703206525479,31,31,0,2
147037,9to4,9,4,0.957446649458175,-8.35273758710149,31,31,0,3
147053,4to9,4,9,0.878909100097767,-10.9703206525479,31,31,0,2
147068,9to4,9,4,0.957446649458175,-8.35273758710149,31,31,0,3
147082,4to3,4,3,0.121090899902233,-12.952460629608,123,123,0,2
147097,3to4,3,4,0.976578311614922,-4.3200135082935,29,29,0,3
147114,4to9,4,9,0.878909100097767,-10.9703206525479,61,61,0,2
147129,9to4,9,4,0.957446649458175,-8.35273758710149,32,32,0,3
147146,4to9,4,9,0.878909100097767,-10.9703206525479,32,32,0,2
147162,9to8,9,8,0.042323306624307,-11.47166966968,409,409,0,3
147178,8to3,8,3,0.227014077405999,-4.11464622477799,96,96,0,4
147196,3to4,3,4,0.976578311614922,-4.3200135082935,67,67,0,3
147213,4to9,4,9,0.878909100097767,-10.9703206525479,67,67,0,2
147229,9to4,9,4,0.957446649458175,-8.35273758710149,33,33,0,3
147244,4to9,4,9,0.878909100097767,-10.9703206525479,31,31,0,2
147259,9to4,9,4,0.957446649458175,-8.35273758710149,30,30,0,3
147275,4to9,4,9,0.878909100097767,-10.9703206525479,31,31,0,2
147291,9to4,9,4,0.957446649458175,-8.35273758710149,32,32,0,3
147306,4to3,4,3,0.121090899902233,-12.952460629608,128,128,0,2
147322,3to4,3,4,0.976578311614922,-4.3200135082935,31,31,0,3
147339,4to9,4,9,0.878909100097767,-10.9703206525479,64,64,0,2
147356,9to4,9,4,0.957446649458175,-8.35273758710149,34,34,0,3
147372,4to9,4,9,0.878909100097767,-10.9703206525479,33,33,0,2
147389,9to8,9,8,0.042323306624307,-11.47166966968,227,227,0,3
147405,8to3,8,3,0.227014077405999,-4.11464622477799,99,99,0,4
147420,3to4,3,4,0.976578311614922,-4.3200135082935,64,64,0,3
147435,4to9,4,9,0.878909100097767,-10.9703206525479,63,63,0,2
147450,9to4,9,4,0.957446649458175,-8.35273758710149,30,30,0,3
147466,4to9,4,9,0.878909100097767,-10.9703206525479,31,31,0,2
147482,9to4,9,4,0.957446649458175,-8.35273758710149,32,32,0,3
147497,4to9,4,9,0.878909100097767,-10.9703206525479,31,31,0,2
147513,9to4,9,4,0.957446649458175,-8.35273758710149,31,31,0,3
147528,4to9,4,9,0.878909100097767,-10.9703206525479,31,31,0,2
147544,9to4,9,4,0.957446649458175,-8.35273758710149,31,31,0,3
147560,4to3,4,3,0.121090899902233,-12.952460629608,155,155,0,2
147576,3to4,3,4,0.976578311614922,-4.3200135082935,32,32,0,3
147591,4to9,4,9,0.878909100097767,-10.9703206525479,63,63,0,2
147608,9to4,9,4,0.957446649458175,-8.35273758710149,32,32,0,3
147623,4to9,4,9,0.878909100097767,-10.9703206525479,32,32,0,2
147639,9to4,9,4,0.957446649458175,-8.35273758710149,31,31,0,3
147655,4to9,4,9,0.878909100097767,-10.9703206525479,32,32,0,2
147670,9to4,9,4,0.957446649458175,-8.35273758710149,31,31,0,3
147687,4to3,4,3,0.121090899902233,-12.952460629608,127,127,0,2
147702,3to4,3,4,0.976578311614922,-4.3200135082935,32,32,0,3
147718,4to9,4,9,0.878909100097767,-10.9703206525479,63,63,0,2
147735,9to4,9,4,0.957446649458175,-8.35273758710149,33,33,0,3
147749,4to9,4,9,0.878909100097767,-10.9703206525479,31,31,0,2
147765,9to8,9,8,0.042323306624307,-11.47166966968,376,376,0,3
147782,8to3,8,3,0.227014077405999,-4.11464622477799,95,95,0,4
147799,3to4,3,4,0.976578311614922,-4.3200135082935,64,64,0,3
147815,4to9,4,9,0.878909100097767,-10.9703206525479,66,66,0,2
147830,9to4,9,4,0.957446649458175,-8.35273758710149,31,31,0,3
147845,4to9,4,9,0.878909100097767,-10.9703206525479,30,30,0,2
147860,9to4,9,4,0.957446649458175,-8.35273758710149,30,30,0,3
147876,4to3,4,3,0.121090899902233,-12.952460629608,94,94,0,2
147892,3to8,3,8,0.022742608734262,-8.07982824981408,127,127,0,3
147907,8to3,8,3,0.227014077405999,-4.11464622477799,31,31,0,4
147922,3to4,3,4,0.976578311614922,-4.3200135082935,62,62,0,3
147938,4to9,4,9,0.878909100097767,-10.9703206525479,93,93,0,2
147953,9to4,9,4,0.957446649458175,-8.35273758710149,31,31,0,3
147968,4to9,4,9,0.878909100097767,-10.9703206525479,30,30,0,2
147984,9to4,9,4,0.957446649458175,-8.35273758710149,31,31,0,3
148000,4to9,4,9,0.878909100097767,-10.9703206525479,32,32,0,2
148016,9to4,9,4,0.957446649458175,-8.35273758710149,32,32,0,3
148032,4to9,4,9,0.878909100097767,-10.9703206525479,32,32,0,2
148048,9to4,9,4,0.957446649458175,-8.35273758710149,32,32,0,3
148064,4to3,4,3,0.121090899902233,-12.952460629608,157,157,0,2
148079,3to4,3,4,0.976578311614922,-4.3200135082935,31,31,0,3
148093,4to9,4,9,0.878909100097767,-10.9703206525479,61,61,0,2
148109,9to4,9,4,0.957446649458175,-8.35273758710149,30,30,0,3
148124,4to9,4,9,0.878909100097767,-10.9703206525479,31,31,0,2
148141,9to4,9,4,0.957446649458175,-8.35273758710149,32,32,0,3
148158,4to9,4,9,0.878909100097767,-10.9703206525479,34,34,0,2
148172,9to4,9,4,0.957446649458175,-8.35273758710149,31,31,0,3
148186,4to3,4,3,0.121090899902233,-12.952460629608,122,122,0,2
148202,3to4,3,4,0.976578311614922,-4.3200135082935,30,30,0,3
148219,4to9,4,9,0.878909100097767,-10.9703206525479,61,61,0,2
148237,9to4,9,4,0.957446649458175,-8.35273758710149,35,35,0,3
148252,4to9,4,9,0.878909100097767,-10.9703206525479,33,33,0,2
148268,9to8,9,8,0.042323306624307,-11.47166966968,376,376,0,3
148283,8to3,8,3,0.227014077405999,-4.11464622477799,97,97,0,4
148298,3to4,3,4,0.976578311614922,-4.3200135082935,61,61,0,3
148313,4to9,4,9,0.878909100097767,-10.9703206525479,61,61,0,2
148329,9to4,9,4,0.957446649458175,-8.35273758710149,31,31,0,3
148345,4to9,4,9,0.878909100097767,-10.9703206525479,32,32,0,2
148360,9to4,9,4,0.957446649458175,-8.35273758710149,31,31,0,3
148375,4to9,4,9,0.878909100097767,-10.9703206525479,30,30,0,2
148389,9to4,9,4,0.957446649458175,-8.35273758710149,29,29,0,3
148406,4to9,4,9,0.878909100097767,-10.9703206525479,31,31,0,2
148422,9to4,9,4,0.957446649458175,-8.35273758710149,33,33,0,3
148440,4to3,4,3,0.121090899902233,-12.952460629608,157,157,0,2
148455,3to4,3,4,0.976578311614922,-4.3200135082935,33,33,0,3
148470,4to9,4,9,0.878909100097767,-10.9703206525479,64,64,0,2
148486,9to4,9,4,0.957446649458175,-8.35273758710149,31,31,0,3
148501,4to9,4,9,0.878909100097767,-10.9703206525479,31,31,0,2
148518,9to4,9,4,0.957446649458175,-8.35273758710149,32,32,0,3
148532,4to9,4,9,0.878909100097767,-10.9703206525479,31,31,0,2
148547,9to4,9,4,0.957446649458175,-8.35273758710149,29,29,0,3
148562,4to9,4,9,0.878909100097767,-10.9703206525479,30,30,0,2
148579,9to4,9,4,0.957446649458175,-8.35273758710149,32,32,0,3
148595,4to3,4,3,0.121090899902233,-12.952460629608,155,155,0,2
148610,3to4,3,4,0.976578311614922,-4.3200135082935,31,31,0,3
148627,4to9,4,9,0.878909100097767,-10.9703206525479,65,65,0,2
148642,9to14,9,14,0.000230043917518,-16.6864926305794,2173,2173,0,3
148658,14to13,14,13,0.018651595113073,-9.09371951571432,1952,1952,0,3
148673,13to12,13,12,0.011455333786539,-11.7575258257807,1951,1951,0,4
148689,12to7,12,7,0.019195020372649,-10.2907402600302,1951,1951,0,4
148706,7to8,7,8,0.891261489172192,-2.39620659892225,438,438,0,4
148723,8to9,8,9,0.769052262769502,-2.89449932615566,96,96,0,4
148740,9to4,9,4,0.957446649458175,-8.35273758710149,130,130,0,3
148754,4to3,4,3,0.121090899902233,-12.952460629608,159,159,0,2
148769,3to4,3,4,0.976578311614922,-4.3200135082935,29,29,0,3
148786,4to9,4,9,0.878909100097767,-10.9703206525479,63,63,0,2
148800,9to4,9,4,0.957446649458175,-8.35273758710149,31,31,0,3
148816,4to9,4,9,0.878909100097767,-10.9703206525479,30,30,0,2
148832,9to4,9,4,0.957446649458175,-8.35273758710149,32,32,0,3
148846,4to9,4,9,0.878909100097767,-10.9703206525479,30,30,0,2
148862,9to4,9,4,0.957446649458175,-8.35273758710149,30,30,0,3
148879,4to9,4,9,0.878909100097767,-10.9703206525479,33,33,0,2
148894,9to4,9,4,0.957446649458175,-8.35273758710149,32,32,0,3
148910,4to3,4,3,0.121090899902233,-12.952460629608,156,156,0,2
148926,3to4,3,4,0.976578311614922,-4.3200135082935,32,32,0,3
148941,4to9,4,9,0.878909100097767,-10.9703206525479,62,62,0,2
148956,9to4,9,4,0.957446649458175,-8.35273758710149,30,30,0,3
148972,4to9,4,9,0.878909100097767,-10.9703206525479,31,31,0,2
148987,9to4,9,4,0.957446649458175,-8.35273758710149,31,31,0,3
149001,4to9,4,9,0.878909100097767,-10.9703206525479,29,29,0,2
149016,9to4,9,4,0.957446649458175,-8.35273758710149,29,29,0,3
149030,4to9,4,9,0.878909100097767,-10.9703206525479,29,29,0,2
149046,9to8,9,8,0.042323306624307,-11.47166966968,340,340,0,3
149063,8to3,8,3,0.227014077405999,-4.11464622477799,153,153,0,4
149081,3to4,3,4,0.976578311614922,-4.3200135082935,65,65,0,3
149098,4to9,4,9,0.878909100097767,-10.9703206525479,68,68,0,2
149113,9to4,9,4,0.957446649458175,-8.35273758710149,32,32,0,3
149129,4to9,4,9,0.878909100097767,-10.9703206525479,31,31,0,2
149146,9to4,9,4,0.957446649458175,-8.35273758710149,33,33,0,3
149163,4to9,4,9,0.878909100097767,-10.9703206525479,34,34,0,2
149181,9to4,9,4,0.957446649458175,-8.35273758710149,35,35,0,3
149197,4to9,4,9,0.878909100097767,-10.9703206525479,34,34,0,2
149212,9to4,9,4,0.957446649458175,-8.35273758710149,31,31,0,3
149228,4to3,4,3,0.121090899902233,-12.952460629608,165,165,0,2
149243,3to4,3,4,0.976578311614922,-4.3200135082935,31,31,0,3
149259,4to9,4,9,0.878909100097767,-10.9703206525479,62,62,0,2
149275,9to14,9,14,0.000230043917518,-16.6864926305794,633,633,0,3
149291,14to9,14,9,0.981308638880882,-5.13076416031772,32,32,0,3
149309,9to4,9,4,0.957446649458175,-8.35273758710149,66,66,0,3
149325,4to9,4,9,0.878909100097767,-10.9703206525479,34,34,0,2
149341,9to4,9,4,0.957446649458175,-8.35273758710149,32,32,0,3
149358,4to9,4,9,0.878909100097767,-10.9703206525479,33,33,0,2
149372,9to4,9,4,0.957446649458175,-8.35273758710149,31,31,0,3
149388,4to3,4,3,0.121090899902233,-12.952460629608,160,160,0,2
149403,3to4,3,4,0.976578311614922,-4.3200135082935,31,31,0,3
149420,4to9,4,9,0.878909100097767,-10.9703206525479,62,62,0,2
149436,9to4,9,4,0.957446649458175,-8.35273758710149,33,33,0,3
149451,4to9,4,9,0.878909100097767,-10.9703206525479,31,31,0,2
149467,9to8,9,8,0.042323306624307,-11.47166966968,421,421,0,3
149482,8to3,8,3,0.227014077405999,-4.11464622477799,94,94,0,4
149498,3to4,3,4,0.976578311614922,-4.3200135082935,62,62,0,3
149514,4to9,4,9,0.878909100097767,-10.9703206525479,63,63,0,2
149530,9to4,9,4,0.957446649458175,-8.35273758710149,32,32,0,3
149547,4to9,4,9,0.878909100097767,-10.9703206525479,33,33,0,2
149562,9to4,9,4,0.957446649458175,-8.35273758710149,32,32,0,3
149577,4to9,4,9,0.878909100097767,-10.9703206525479,30,30,0,2
149593,9to14,9,14,0.000230043917518,-16.6864926305794,318,318,0,3
149609,14to13,14,13,0.018651595113073,-9.09371951571432,951,951,0,3
149626,13to8,13,8,0.917295535428803,-7.37455157477482,159,159,0,4
149641,8to7,8,7,0.000908728145689,-9.63536755452497,952,952,0,4
149658,7to2,7,2,0.071244276411301,-4.92272997679187,4910,4910,0,4
149675,2to3,2,3,0.998311213496016,-3.95697141540815,193,193,0,3
149691,3to4,3,4,0.976578311614922,-4.3200135082935,129,129,0,3
149706,4to9,4,9,0.878909100097767,-10.9703206525479,129,129,0,2
149721,9to4,9,4,0.957446649458175,-8.35273758710149,30,30,0,3
149736,4to9,4,9,0.878909100097767,-10.9703206525479,30,30,0,2
149752,9to4,9,4,0.957446649458175,-8.35273758710149,31,31,0,3
149767,4to9,4,9,0.878909100097767,-10.9703206525479,31,31,0,2
149783,9to4,9,4,0.957446649458175,-8.35273758710149,31,31,0,3
149799,4to9,4,9,0.878909100097767,-10.9703206525479,32,32,0,2
149816,9to4,9,4,0.957446649458175,-8.35273758710149,33,33,0,3
149831,4to3,4,3,0.121090899902233,-12.952460629608,156,156,0,2
149847,3to4,3,4,0.976578311614922,-4.3200135082935,31,31,0,3
149861,4to3,4,3,0.121090899902233,-12.952460629608,30,30,0,2
149877,3to2,3,2,0.000679079650815,-11.5910853038632,219,219,0,3
149891,2to3,2,3,0.998311213496016,-3.95697141540815,30,30,0,3
149908,3to8,3,8,0.022742608734262,-8.07982824981408,282,282,0,3
149925,8to9,8,9,0.769052262769502,-2.89449932615566,126,126,0,4
149941,9to4,9,4,0.957446649458175,-8.35273758710149,94,94,0,3
149956,4to9,4,9,0.878909100097767,-10.9703206525479,31,31,0,2
149972,9to4,9,4,0.957446649458175,-8.35273758710149,31,31,0,3
149987,4to9,4,9,0.878909100097767,-10.9703206525479,31,31,0,2
150003,9to4,9,4,0.957446649458175,-8.35273758710149,31,31,0,3
150020,4to9,4,9,0.878909100097767,-10.9703206525479,33,33,0,2
150035,9to4,9,4,0.957446649458175,-8.35273758710149,32,32,0,3
150051,4to3,4,3,0.121090899902233,-12.952460629608,160,160,0,2
150066,3to4,3,4,0.976578311614922,-4.3200135082935,31,31,0,3
150082,4to9,4,9,0.878909100097767,-10.9703206525479,62,62,0,2
150097,9to8,9,8,0.042323306624307,-11.47166966968,189,189,0,3
150113,8to9,8,9,0.769052262769502,-2.89449932615566,31,31,0,4
150129,9to4,9,4,0.957446649458175,-8.35273758710149,63,63,0,3
150145,4to9,4,9,0.878909100097767,-10.9703206525479,32,32,0,2
150159,9to4,9,4,0.957446649458175,-8.35273758710149,30,30,0,3
150174,4to3,4,3,0.121090899902233,-12.952460629608,123,123,0,2
150188,3to4,3,4,0.976578311614922,-4.3200135082935,29,29,0,3
150204,4to9,4,9,0.878909100097767,-10.9703206525479,59,59,0,2
150220,9to4,9,4,0.957446649458175,-8.35273758710149,32,32,0,3
150237,4to9,4,9,0.878909100097767,-10.9703206525479,33,33,0,2
150253,9to4,9,4,0.957446649458175,-8.35273758710149,33,33,0,3
150268,4to9,4,9,0.878909100097767,-10.9703206525479,31,31,0,2
150284,9to4,9,4,0.957446649458175,-8.35273758710149,31,31,0,3
150300,4to9,4,9,0.878909100097767,-10.9703206525479,32,32,0,2
150318,9to8,9,8,0.042323306624307,-11.47166966968,221,221,0,3
150335,8to3,8,3,0.227014077405999,-4.11464622477799,161,161,0,4
150351,3to4,3,4,0.976578311614922,-4.3200135082935,67,67,0,3
150366,4to9,4,9,0.878909100097767,-10.9703206525479,66,66,0,2
150381,9to4,9,4,0.957446649458175,-8.35273758710149,30,30,0,3
150396,4to3,4,3,0.121090899902233,-12.952460629608,61,61,0,2
150411,3to2,3,2,0.000679079650815,-11.5910853038632,534,534,0,3
150426,2to3,2,3,0.998311213496016,-3.95697141540815,30,30,0,3
150443,3to4,3,4,0.976578311614922,-4.3200135082935,62,62,0,3
150459,4to9,4,9,0.878909100097767,-10.9703206525479,93,93,0,2
150474,9to4,9,4,0.957446649458175,-8.35273758710149,31,31,0,3
150491,4to9,4,9,0.878909100097767,-10.9703206525479,32,32,0,2
150507,9to4,9,4,0.957446649458175,-8.35273758710149,33,33,0,3
150522,4to9,4,9,0.878909100097767,-10.9703206525479,31,31,0,2
150537,9to4,9,4,0.957446649458175,-8.35273758710149,30,30,0,3
150553,4to3,4,3,0.121090899902233,-12.952460629608,127,127,0,2
150568,3to4,3,4,0.976578311614922,-4.3200135082935,31,31,0,3
150585,4to9,4,9,0.878909100097767,-10.9703206525479,63,63,0,2
150600,9to4,9,4,0.957446649458175,-8.35273758710149,32,32,0,3
150617,4to9,4,9,0.878909100097767,-10.9703206525479,32,32,0,2
150632,9to4,9,4,0.957446649458175,-8.35273758710149,32,32,0,3
150649,4to9,4,9,0.878909100097767,-10.9703206525479,32,32,0,2
150665,9to4,9,4,0.957446649458175,-8.35273758710149,33,33,0,3
150682,4to9,4,9,0.878909100097767,-10.9703206525479,33,33,0,2
150698,9to4,9,4,0.957446649458175,-8.35273758710149,33,33,0,3
150713,4to3,4,3,0.121090899902233,-12.952460629608,160,160,0,2
150728,3to4,3,4,0.976578311614922,-4.3200135082935,30,30,0,3
150744,4to9,4,9,0.878909100097767,-10.9703206525479,62,62,0,2
150760,9to8,9,8,0.042323306624307,-11.47166966968,442,442,0,3
150776,8to9,8,9,0.769052262769502,-2.89449932615566,32,32,0,4
150791,9to4,9,4,0.957446649458175,-8.35273758710149,63,63,0,3
150808,4to9,4,9,0.878909100097767,-10.9703206525479,32,32,0,2
150824,9to4,9,4,0.957446649458175,-8.35273758710149,33,33,0,3
150840,4to9,4,9,0.878909100097767,-10.9703206525479,32,32,0,2
150855,9to4,9,4,0.957446649458175,-8.35273758710149,31,31,0,3
150871,4to3,4,3,0.121090899902233,-12.952460629608,158,158,0,2
150885,3to4,3,4,0.976578311614922,-4.3200135082935,30,30,0,3
150900,4to9,4,9,0.878909100097767,-10.9703206525479,60,60,0,2
150915,9to4,9,4,0.957446649458175,-8.35273758710149,30,30,0,3
150929,4to3,4,3,0.121090899902233,-12.952460629608,58,58,0,2
150945,3to4,3,4,0.976578311614922,-4.3200135082935,30,30,0,3
150961,4to9,4,9,0.878909100097767,-10.9703206525479,61,61,0,2
150978,9to4,9,4,0.957446649458175,-8.35273758710149,33,33,0,3
150994,4to9,4,9,0.878909100097767,-10.9703206525479,33,33,0,2
151011,9to4,9,4,0.957446649458175,-8.35273758710149,33,33,0,3
151028,4to9,4,9,0.878909100097767,-10.9703206525479,34,34,0,2
151043,9to4,9,4,0.957446649458175,-8.35273758710149,32,32,0,3
151059,4to3,4,3,0.121090899902233,-12.952460629608,130,130,0,2
151074,3to4,3,4,0.976578311614922,-4.3200135082935,31,31,0,3
151090,4to9,4,9,0.878909100097767,-10.9703206525479,62,62,0,2
151106,9to4,9,4,0.957446649458175,-8.35273758710149,32,32,0,3
151121,4to9,4,9,0.878909100097767,-10.9703206525479,31,31,0,2
151138,9to8,9,8,0.042323306624307,-11.47166966968,378,378,0,3
151153,8to3,8,3,0.227014077405999,-4.11464622477799,94,94,0,4
151169,3to4,3,4,0.976578311614922,-4.3200135082935,63,63,0,3
151185,4to9,4,9,0.878909100097767,-10.9703206525479,64,64,0,2
151201,9to4,9,4,0.957446649458175,-8.35273758710149,32,32,0,3
151217,4to9,4,9,0.878909100097767,-10.9703206525479,32,32,0,2
151232,9to4,9,4,0.957446649458175,-8.35273758710149,31,31,0,3
151247,4to9,4,9,0.878909100097767,-10.9703206525479,30,30,0,2
151262,9to4,9,4,0.957446649458175,-8.35273758710149,30,30,0,3
151277,4to3,4,3,0.121090899902233,-12.952460629608,124,124,0,2
151291,3to4,3,4,0.976578311614922,-4.3200135082935,29,29,0,3
151307,4to9,4,9,0.878909100097767,-10.9703206525479,60,60,0,2
151322,9to4,9,4,0.957446649458175,-8.35273758710149,31,31,0,3
151337,4to9,4,9,0.878909100097767,-10.9703206525479,30,30,0,2
151353,9to4,9,4,0.957446649458175,-8.35273758710149,31,31,0,3
151369,4to9,4,9,0.878909100097767,-10.9703206525479,32,32,0,2
151385,9to4,9,4,0.957446649458175,-8.35273758710149,32,32,0,3
151401,4to9,4,9,0.878909100097767,-10.9703206525479,32,32,0,2
151417,9to4,9,4,0.957446649458175,-8.35273758710149,32,32,0,3
151433,4to3,4,3,0.121090899902233,-12.952460629608,156,156,0,2
151448,3to4,3,4,0.976578311614922,-4.3200135082935,31,31,0,3
151463,4to9,4,9,0.878909100097767,-10.9703206525479,62,62,0,2
151479,9to8,9,8,0.042323306624307,-11.47166966968,341,341,0,3
151495,8to9,8,9,0.769052262769502,-2.89449932615566,32,32,0,4
151512,9to4,9,4,0.957446649458175,-8.35273758710149,64,64,0,3
151527,4to9,4,9,0.878909100097767,-10.9703206525479,32,32,0,2
151542,9to4,9,4,0.957446649458175,-8.35273758710149,30,30,0,3
151558,4to3,4,3,0.121090899902233,-12.952460629608,125,125,0,2
151575,3to4,3,4,0.976578311614922,-4.3200135082935,33,33,0,3
151590,4to9,4,9,0.878909100097767,-10.9703206525479,63,63,0,2
151605,9to4,9,4,0.957446649458175,-8.35273758710149,30,30,0,3
151620,4to9,4,9,0.878909100097767,-10.9703206525479,30,30,0,2
151637,9to4,9,4,0.957446649458175,-8.35273758710149,32,32,0,3
151654,4to9,4,9,0.878909100097767,-10.9703206525479,34,34,0,2
151670,9to4,9,4,0.957446649458175,-8.35273758710149,33,33,0,3
151684,4to9,4,9,0.878909100097767,-10.9703206525479,30,30,0,2
151700,9to4,9,4,0.957446649458175,-8.35273758710149,30,30,0,3
151716,4to3,4,3,0.121090899902233,-12.952460629608,158,158,0,2
151733,3to4,3,4,0.976578311614922,-4.3200135082935,33,33,0,3
151749,4to9,4,9,0.878909100097767,-10.9703206525479,65,65,0,2
151763,9to4,9,4,0.957446649458175,-8.35273758710149,30,30,0,3
151777,4to9,4,9,0.878909100097767,-10.9703206525479,28,28,0,2
151794,9to4,9,4,0.957446649458175,-8.35273758710149,31,31,0,3
151810,4to9,4,9,0.878909100097767,-10.9703206525479,33,33,0,2
151825,9to4,9,4,0.957446649458175,-8.35273758710149,31,31,0,3
151841,4to3,4,3,0.121090899902233,-12.952460629608,125,125,0,2
151857,3to4,3,4,0.976578311614922,-4.3200135082935,32,32,0,3
151874,4to9,4,9,0.878909100097767,-10.9703206525479,64,64,0,2
151891,9to8,9,8,0.042323306624307,-11.47166966968,412,412,0,3
151907,8to9,8,9,0.769052262769502,-2.89449932615566,33,33,0,4
151922,9to8,9,8,0.042323306624307,-11.47166966968,31,31,0,3
151939,8to3,8,3,0.227014077405999,-4.11464622477799,98,98,0,4
151956,3to4,3,4,0.976578311614922,-4.3200135082935,99,99,0,3
151973,4to9,4,9,0.878909100097767,-10.9703206525479,66,66,0,2
151989,9to4,9,4,0.957446649458175,-8.35273758710149,33,33,0,3
152004,4to9,4,9,0.878909100097767,-10.9703206525479,31,31,0,2
152020,9to4,9,4,0.957446649458175,-8.35273758710149,31,31,0,3
152036,4to9,4,9,0.878909100097767,-10.9703206525479,32,32,0,2
152052,9to4,9,4,0.957446649458175,-8.35273758710149,32,32,0,3
152068,4to9,4,9,0.878909100097767,-10.9703206525479,32,32,0,2
152084,9to4,9,4,0.957446649458175,-8.35273758710149,32,32,0,3
152098,4to3,4,3,0.121090899902233,-12.952460629608,159,159,0,2
152114,3to4,3,4,0.976578311614922,-4.3200135082935,30,30,0,3
152130,4to9,4,9,0.878909100097767,-10.9703206525479,62,62,0,2
152147,9to4,9,4,0.957446649458175,-8.35273758710149,33,33,0,3
152163,4to9,4,9,0.878909100097767,-10.9703206525479,33,33,0,2
152178,9to4,9,4,0.957446649458175,-8.35273758710149,31,31,0,3
152192,4to9,4,9,0.878909100097767,-10.9703206525479,29,29,0,2
152206,9to4,9,4,0.957446649458175,-8.35273758710149,28,28,0,3
152221,4to9,4,9,0.878909100097767,-10.9703206525479,29,29,0,2
152237,9to4,9,4,0.957446649458175,-8.35273758710149,31,31,0,3
152253,4to3,4,3,0.121090899902233,-12.952460629608,155,155,0,2
152269,3to4,3,4,0.976578311614922,-4.3200135082935,32,32,0,3
152286,4to9,4,9,0.878909100097767,-10.9703206525479,65,65,0,2
152301,9to14,9,14,0.000230043917518,-16.6864926305794,2708,2708,0,3
152318,14to19,14,19,1.47395795730993E-05,-16.2368951295904,38939,292,38647,3
152335,19to18,19,18,0.001354759779051,-10.3753038727971,38940,324,38616,3
152351,18to13,18,13,0.995829766189947,-3.74424906738557,2742,2742,0,4
152368,13to8,13,8,0.917295535428803,-7.37455157477482,446,446,0,4
152385,8to9,8,9,0.769052262769502,-2.89449932615566,99,99,0,4
152401,9to4,9,4,0.957446649458175,-8.35273758710149,132,132,0,3
152417,4to3,4,3,0.121090899902233,-12.952460629608,164,164,0,2
152432,3to4,3,4,0.976578311614922,-4.3200135082935,31,31,0,3
152448,4to9,4,9,0.878909100097767,-10.9703206525479,63,63,0,2
152464,9to4,9,4,0.957446649458175,-8.35273758710149,32,32,0,3
152479,4to9,4,9,0.878909100097767,-10.9703206525479,31,31,0,2
152493,9to4,9,4,0.957446649458175,-8.35273758710149,29,29,0,3
152511,4to9,4,9,0.878909100097767,-10.9703206525479,32,32,0,2
152527,9to4,9,4,0.957446649458175,-8.35273758710149,34,34,0,3
152543,4to9,4,9,0.878909100097767,-10.9703206525479,32,32,0,2
152557,9to4,9,4,0.957446649458175,-8.35273758710149,30,30,0,3
152573,4to3,4,3,0.121090899902233,-12.952460629608,156,156,0,2
152587,3to4,3,4,0.976578311614922,-4.3200135082935,30,30,0,3
152604,4to9,4,9,0.878909100097767,-10.9703206525479,61,61,0,2
152621,9to4,9,4,0.957446649458175,-8.35273758710149,34,34,0,3
152637,4to9,4,9,0.878909100097767,-10.9703206525479,33,33,0,2
152652,9to4,9,4,0.957446649458175,-8.35273758710149,31,31,0,3
152668,4to9,4,9,0.878909100097767,-10.9703206525479,31,31,0,2
152683,9to4,9,4,0.957446649458175,-8.35273758710149,31,31,0,3
152699,4to3,4,3,0.121090899902233,-12.952460629608,126,126,0,2
152714,3to4,3,4,0.976578311614922,-4.3200135082935,31,31,0,3
152732,4to9,4,9,0.878909100097767,-10.9703206525479,64,64,0,2
152748,9to4,9,4,0.957446649458175,-8.35273758710149,34,34,0,3
152765,4to9,4,9,0.878909100097767,-10.9703206525479,33,33,0,2
152781,9to8,9,8,0.042323306624307,-11.47166966968,413,413,0,3
152797,8to3,8,3,0.227014077405999,-4.11464622477799,98,98,0,4
152814,3to4,3,4,0.976578311614922,-4.3200135082935,66,66,0,3
152829,4to9,4,9,0.878909100097767,-10.9703206525479,64,64,0,2
152845,9to4,9,4,0.957446649458175,-8.35273758710149,31,31,0,3
152860,4to9,4,9,0.878909100097767,-10.9703206525479,31,31,0,2
152875,9to4,9,4,0.957446649458175,-8.35273758710149,30,30,0,3
152891,4to9,4,9,0.878909100097767,-10.9703206525479,31,31,0,2
152907,9to4,9,4,0.957446649458175,-8.35273758710149,32,32,0,3
152923,4to9,4,9,0.878909100097767,-10.9703206525479,32,32,0,2
152939,9to4,9,4,0.957446649458175,-8.35273758710149,32,32,0,3
152954,4to3,4,3,0.121090899902233,-12.952460629608,157,157,0,2
152971,3to4,3,4,0.976578311614922,-4.3200135082935,32,32,0,3
152987,4to9,4,9,0.878909100097767,-10.9703206525479,64,64,0,2
153001,9to4,9,4,0.957446649458175,-8.35273758710149,30,30,0,3
153018,4to9,4,9,0.878909100097767,-10.9703206525479,31,31,0,2
153034,9to4,9,4,0.957446649458175,-8.35273758710149,33,33,0,3
153050,4to9,4,9,0.878909100097767,-10.9703206525479,32,32,0,2
153066,9to4,9,4,0.957446649458175,-8.35273758710149,32,32,0,3
153082,4to9,4,9,0.878909100097767,-10.9703206525479,32,32,0,2
153096,9to4,9,4,0.957446649458175,-8.35273758710149,30,30,0,3
153112,4to3,4,3,0.121090899902233,-12.952460629608,158,158,0,2
153128,3to4,3,4,0.976578311614922,-4.3200135082935,32,32,0,3
153145,4to9,4,9,0.878909100097767,-10.9703206525479,63,63,0,2
153161,9to4,9,4,0.957446649458175,-8.35273758710149,33,33,0,3
153176,4to9,4,9,0.878909100097767,-10.9703206525479,31,31,0,2
153192,9to8,9,8,0.042323306624307,-11.47166966968,411,411,0,3
153208,8to3,8,3,0.227014077405999,-4.11464622477799,96,96,0,4
153224,3to4,3,4,0.976578311614922,-4.3200135082935,63,63,0,3
153241,4to9,4,9,0.878909100097767,-10.9703206525479,65,65,0,2
153256,9to4,9,4,0.957446649458175,-8.35273758710149,32,32,0,3
153271,4to9,4,9,0.878909100097767,-10.9703206525479,30,30,0,2
153286,9to4,9,4,0.957446649458175,-8.35273758710149,30,30,0,3
153300,4to9,4,9,0.878909100097767,-10.9703206525479,29,29,0,2
153316,9to4,9,4,0.957446649458175,-8.35273758710149,30,30,0,3
153332,4to9,4,9,0.878909100097767,-10.9703206525479,32,32,0,2
153349,9to4,9,4,0.957446649458175,-8.35273758710149,33,33,0,3
153366,4to3,4,3,0.121090899902233,-12.952460629608,158,158,0,2
153381,3to4,3,4,0.976578311614922,-4.3200135082935,32,32,0,3
153397,4to9,4,9,0.878909100097767,-10.9703206525479,65,65,0,2
153412,9to4,9,4,0.957446649458175,-8.35273758710149,31,31,0,3
153429,4to9,4,9,0.878909100097767,-10.9703206525479,32,32,0,2
153444,9to4,9,4,0.957446649458175,-8.35273758710149,32,32,0,3
153460,4to9,4,9,0.878909100097767,-10.9703206525479,31,31,0,2
153475,9to4,9,4,0.957446649458175,-8.35273758710149,31,31,0,3
153490,4to3,4,3,0.121090899902233,-12.952460629608,124,124,0,2
153506,3to4,3,4,0.976578311614922,-4.3200135082935,31,31,0,3
153522,4to9,4,9,0.878909100097767,-10.9703206525479,62,62,0,2
153539,9to4,9,4,0.957446649458175,-8.35273758710149,33,33,0,3
153555,4to9,4,9,0.878909100097767,-10.9703206525479,33,33,0,2
153570,9to8,9,8,0.042323306624307,-11.47166966968,378,378,0,3
153586,8to3,8,3,0.227014077405999,-4.11464622477799,96,96,0,4
153604,3to4,3,4,0.976578311614922,-4.3200135082935,65,65,0,3
153620,4to9,4,9,0.878909100097767,-10.9703206525479,65,65,0,2
153637,9to4,9,4,0.957446649458175,-8.35273758710149,33,33,0,3
153652,4to9,4,9,0.878909100097767,-10.9703206525479,32,32,0,2
153667,9to4,9,4,0.957446649458175,-8.35273758710149,30,30,0,3
153684,4to9,4,9,0.878909100097767,-10.9703206525479,32,32,0,2
153700,9to4,9,4,0.957446649458175,-8.35273758710149,33,33,0,3
153714,4to9,4,9,0.878909100097767,-10.9703206525479,30,30,0,2
153729,9to4,9,4,0.957446649458175,-8.35273758710149,29,29,0,3
153745,4to3,4,3,0.121090899902233,-12.952460629608,159,159,0,2
153761,3to4,3,4,0.976578311614922,-4.3200135082935,32,32,0,3
153777,4to9,4,9,0.878909100097767,-10.9703206525479,63,63,0,2
153792,9to4,9,4,0.957446649458175,-8.35273758710149,31,31,0,3
153808,4to9,4,9,0.878909100097767,-10.9703206525479,31,31,0,2
153825,9to4,9,4,0.957446649458175,-8.35273758710149,33,33,0,3
153842,4to9,4,9,0.878909100097767,-10.9703206525479,34,34,0,2
153857,9to4,9,4,0.957446649458175,-8.35273758710149,32,32,0,3
153873,4to3,4,3,0.121090899902233,-12.952460629608,128,128,0,2
153887,3to4,3,4,0.976578311614922,-4.3200135082935,30,30,0,3
153904,4to9,4,9,0.878909100097767,-10.9703206525479,62,62,0,2
153919,9to4,9,4,0.957446649458175,-8.35273758710149,32,32,0,3
153934,4to9,4,9,0.878909100097767,-10.9703206525479,30,30,0,2
153950,9to14,9,14,0.000230043917518,-16.6864926305794,1649,1649,0,3
153967,14to13,14,13,0.01865206191441,-9.09371951571432,1616,1616,0,3
153983,13to8,13,8,0.917295535428803,-7.37455157477482,413,413,0,4
153999,8to9,8,9,0.769052262769502,-2.89449932615566,65,65,0,4
154014,9to4,9,4,0.957446649458175,-8.35273758710149,95,95,0,3
154030,4to3,4,3,0.121090899902233,-12.952460629608,157,157,0,2
154046,3to4,3,4,0.976578311614922,-4.3200135082935,32,32,0,3
154063,4to9,4,9,0.878909100097767,-10.9703206525479,64,64,0,2
154079,9to4,9,4,0.957446649458175,-8.35273758710149,33,33,0,3
154095,4to9,4,9,0.878909100097767,-10.9703206525479,32,32,0,2
154111,9to4,9,4,0.957446649458175,-8.35273758710149,32,32,0,3
154127,4to9,4,9,0.878909100097767,-10.9703206525479,32,32,0,2
154143,9to4,9,4,0.957446649458175,-8.35273758710149,32,32,0,3
154157,4to9,4,9,0.878909100097767,-10.9703206525479,30,30,0,2
154172,9to4,9,4,0.957446649458175,-8.35273758710149,29,29,0,3
154189,4to3,4,3,0.121090899902233,-12.952460629608,159,159,0,2
154205,3to4,3,4,0.976578311614922,-4.3200135082935,33,33,0,3
154222,4to9,4,9,0.878909100097767,-10.9703206525479,65,65,0,2
154237,9to4,9,4,0.957446649458175,-8.35273758710149,32,32,0,3
154251,4to9,4,9,0.878909100097767,-10.9703206525479,29,29,0,2
154268,9to4,9,4,0.957446649458175,-8.35273758710149,31,31,0,3
154284,4to9,4,9,0.878909100097767,-10.9703206525479,33,33,0,2
154301,9to4,9,4,0.957446649458175,-8.35273758710149,33,33,0,3
154316,4to9,4,9,0.878909100097767,-10.9703206525479,32,32,0,2
154332,9to4,9,4,0.957446649458175,-8.35273758710149,31,31,0,3
154347,4to3,4,3,0.121090899902233,-12.952460629608,158,158,0,2
154364,3to4,3,4,0.976578311614922,-4.3200135082935,32,32,0,3
154380,4to9,4,9,0.878909100097767,-10.9703206525479,64,64,0,2
154396,9to8,9,8,0.042323306624307,-11.47166966968,413,413,0,3
154411,8to9,8,9,0.769052262769502,-2.89449932615566,31,31,0,4
154427,9to4,9,4,0.957446649458175,-8.35273758710149,63,63,0,3
154444,4to9,4,9,0.878909100097767,-10.9703206525479,33,33,0,2
154460,9to4,9,4,0.957446649458175,-8.35273758710149,33,33,0,3
154475,4to9,4,9,0.878909100097767,-10.9703206525479,31,31,0,2
154490,9to4,9,4,0.957446649458175,-8.35273758710149,30,30,0,3
154505,4to3,4,3,0.121090899902233,-12.952460629608,158,158,0,2
154520,3to4,3,4,0.976578311614922,-4.3200135082935,30,30,0,3
154537,4to9,4,9,0.878909100097767,-10.9703206525479,62,62,0,2
154553,9to4,9,4,0.957446649458175,-8.35273758710149,33,33,0,3
154568,4to3,4,3,0.121090899902233,-12.952460629608,63,63,0,2
154583,3to4,3,4,0.976578311614922,-4.3200135082935,30,30,0,3
154598,4to9,4,9,0.878909100097767,-10.9703206525479,61,61,0,2
154614,9to4,9,4,0.957446649458175,-8.35273758710149,31,31,0,3
154629,4to9,4,9,0.878909100097767,-10.9703206525479,31,31,0,2
154644,9to4,9,4,0.957446649458175,-8.35273758710149,30,30,0,3
154660,4to9,4,9,0.878909100097767,-10.9703206525479,31,31,0,2
154675,9to4,9,4,0.957446649458175,-8.35273758710149,31,31,0,3
154691,4to9,4,9,0.878909100097767,-10.9703206525479,31,31,0,2
154708,9to4,9,4,0.957446649458175,-8.35273758710149,33,33,0,3
154724,4to3,4,3,0.121090899902233,-12.952460629608,156,156,0,2
154740,3to4,3,4,0.976578311614922,-4.3200135082935,32,32,0,3
154755,4to9,4,9,0.878909100097767,-10.9703206525479,64,64,0,2
154772,9to8,9,8,0.042323306624307,-11.47166966968,376,376,0,3
154788,8to9,8,9,0.769052262769502,-2.89449932615566,33,33,0,4
154804,9to4,9,4,0.957446649458175,-8.35273758710149,64,64,0,3
154819,4to9,4,9,0.878909100097767,-10.9703206525479,31,31,0,2
154835,9to4,9,4,0.957446649458175,-8.35273758710149,31,31,0,3
154850,4to9,4,9,0.878909100097767,-10.9703206525479,31,31,0,2
154866,9to4,9,4,0.957446649458175,-8.35273758710149,31,31,0,3
154882,4to3,4,3,0.121090899902233,-12.952460629608,158,158,0,2
154897,3to4,3,4,0.976578311614922,-4.3200135082935,31,31,0,3
154912,4to9,4,9,0.878909100097767,-10.9703206525479,62,62,0,2
154927,9to4,9,4,0.957446649458175,-8.35273758710149,30,30,0,3
154942,4to9,4,9,0.878909100097767,-10.9703206525479,30,30,0,2
154957,9to4,9,4,0.957446649458175,-8.35273758710149,30,30,0,3
154972,4to9,4,9,0.878909100097767,-10.9703206525479,30,30,0,2
154988,9to4,9,4,0.957446649458175,-8.35273758710149,31,31,0,3
155003,4to9,4,9,0.878909100097767,-10.9703206525479,31,31,0,2
155018,9to4,9,4,0.957446649458175,-8.35273758710149,30,30,0,3
155033,4to3,4,3,0.121090899902233,-12.952460629608,151,151,0,2
155049,3to4,3,4,0.976578311614922,-4.3200135082935,31,31,0,3
155064,4to9,4,9,0.878909100097767,-10.9703206525479,61,61,0,2
155079,9to4,9,4,0.957446649458175,-8.35273758710149,30,30,0,3
155095,4to9,4,9,0.878909100097767,-10.9703206525479,31,31,0,2
155111,9to4,9,4,0.957446649458175,-8.35273758710149,32,32,0,3
155128,4to9,4,9,0.878909100097767,-10.9703206525479,33,33,0,2
155145,9to4,9,4,0.957446649458175,-8.35273758710149,34,34,0,3
155162,4to9,4,9,0.878909100097767,-10.9703206525479,34,34,0,2
155180,9to8,9,8,0.042323306624307,-11.47166966968,408,408,0,3
155196,8to3,8,3,0.227014077405999,-4.11464622477799,163,163,0,4
155212,3to4,3,4,0.976578311614922,-4.3200135082935,67,67,0,3
155229,4to9,4,9,0.878909100097767,-10.9703206525479,67,67,0,2
155245,9to4,9,4,0.957446649458175,-8.35273758710149,33,33,0,3
155261,4to9,4,9,0.878909100097767,-10.9703206525479,32,32,0,2
155276,9to4,9,4,0.957446649458175,-8.35273758710149,31,31,0,3
155292,4to9,4,9,0.878909100097767,-10.9703206525479,31,31,0,2
155307,9to4,9,4,0.957446649458175,-8.35273758710149,31,31,0,3
155323,4to3,4,3,0.121090899902233,-12.952460629608,127,127,0,2
155340,3to4,3,4,0.976578311614922,-4.3200135082935,33,33,0,3
155355,4to9,4,9,0.878909100097767,-10.9703206525479,63,63,0,2
155371,9to4,9,4,0.957446649458175,-8.35273758710149,31,31,0,3
155387,4to9,4,9,0.878909100097767,-10.9703206525479,32,32,0,2
155402,9to4,9,4,0.957446649458175,-8.35273758710149,31,31,0,3
155417,4to9,4,9,0.878909100097767,-10.9703206525479,30,30,0,2
155432,9to4,9,4,0.957446649458175,-8.35273758710149,30,30,0,3
155447,4to3,4,3,0.121090899902233,-12.952460629608,124,124,0,2
155463,3to4,3,4,0.976578311614922,-4.3200135082935,31,31,0,3
155479,4to9,4,9,0.878909100097767,-10.9703206525479,62,62,0,2
155494,9to4,9,4,0.957446649458175,-8.35273758710149,31,31,0,3
155510,4to9,4,9,0.878909100097767,-10.9703206525479,31,31,0,2
155525,9to4,9,4,0.957446649458175,-8.35273758710149,31,31,0,3
155541,4to9,4,9,0.878909100097767,-10.9703206525479,31,31,0,2
155556,9to4,9,4,0.957446649458175,-8.35273758710149,31,31,0,3
155572,4to3,4,3,0.121090899902233,-12.952460629608,125,125,0,2
155587,3to4,3,4,0.976578311614922,-4.3200135082935,31,31,0,3
155604,4to9,4,9,0.878909100097767,-10.9703206525479,63,63,0,2
155620,9to8,9,8,0.042323306624307,-11.47166966968,440,440,0,3
155635,8to9,8,9,0.769052262769502,-2.89449932615566,31,31,0,4
155652,9to4,9,4,0.957446649458175,-8.35273758710149,65,65,0,3
155668,4to9,4,9,0.878909100097767,-10.9703206525479,33,33,0,2
155682,9to4,9,4,0.957446649458175,-8.35273758710149,30,30,0,3
155697,4to3,4,3,0.121090899902233,-12.952460629608,125,125,0,2
155713,3to4,3,4,0.976578311614922,-4.3200135082935,31,31,0,3
155728,4to9,4,9,0.878909100097767,-10.9703206525479,60,60,0,2
155743,9to4,9,4,0.957446649458175,-8.35273758710149,30,30,0,3
155758,4to9,4,9,0.878909100097767,-10.9703206525479,30,30,0,2
155774,9to4,9,4,0.957446649458175,-8.35273758710149,31,31,0,3
155791,4to9,4,9,0.878909100097767,-10.9703206525479,33,33,0,2
155807,9to4,9,4,0.957446649458175,-8.35273758710149,33,33,0,3
155823,4to9,4,9,0.878909100097767,-10.9703206525479,32,32,0,2
155838,9to4,9,4,0.957446649458175,-8.35273758710149,31,31,0,3
155854,4to3,4,3,0.121090899902233,-12.952460629608,157,157,0,2
155869,3to4,3,4,0.976578311614922,-4.3200135082935,31,31,0,3
155886,4to9,4,9,0.878909100097767,-10.9703206525479,63,63,0,2
155903,9to4,9,4,0.957446649458175,-8.35273758710149,34,34,0,3
155918,4to9,4,9,0.878909100097767,-10.9703206525479,32,32,0,2
155933,9to4,9,4,0.957446649458175,-8.35273758710149,30,30,0,3
155950,4to9,4,9,0.878909100097767,-10.9703206525479,32,32,0,2
155966,9to4,9,4,0.957446649458175,-8.35273758710149,33,33,0,3
155983,4to9,4,9,0.878909100097767,-10.9703206525479,33,33,0,2
155999,9to4,9,4,0.957446649458175,-8.35273758710149,33,33,0,3
156016,4to3,4,3,0.121090899902233,-12.952460629608,162,162,0,2
156032,3to4,3,4,0.976578311614922,-4.3200135082935,33,33,0,3
156048,4to9,4,9,0.878909100097767,-10.9703206525479,65,65,0,2
156064,9to8,9,8,0.042323306624307,-11.47166966968,444,444,0,3
156080,8to9,8,9,0.769052262769502,-2.89449932615566,32,32,0,4
156095,9to4,9,4,0.957446649458175,-8.35273758710149,63,63,0,3
156110,4to9,4,9,0.878909100097767,-10.9703206525479,30,30,0,2
156124,9to4,9,4,0.957446649458175,-8.35273758710149,29,29,0,3
156140,4to3,4,3,0.121090899902233,-12.952460629608,124,124,0,2
156156,3to4,3,4,0.976578311614922,-4.3200135082935,32,32,0,3
156173,4to9,4,9,0.878909100097767,-10.9703206525479,63,63,0,2
156189,9to4,9,4,0.957446649458175,-8.35273758710149,33,33,0,3
156204,4to9,4,9,0.878909100097767,-10.9703206525479,31,31,0,2
156220,9to4,9,4,0.957446649458175,-8.35273758710149,31,31,0,3
156235,4to9,4,9,0.878909100097767,-10.9703206525479,31,31,0,2
156252,9to4,9,4,0.957446649458175,-8.35273758710149,32,32,0,3
156268,4to9,4,9,0.878909100097767,-10.9703206525479,33,33,0,2
156284,9to4,9,4,0.957446649458175,-8.35273758710149,32,32,0,3
156300,4to3,4,3,0.121090899902233,-12.952460629608,160,160,0,2
156316,3to4,3,4,0.976578311614922,-4.3200135082935,32,32,0,3
156331,4to3,4,3,0.121090899902233,-12.952460629608,31,31,0,2
156347,3to4,3,4,0.976578311614922,-4.3200135082935,31,31,0,3
156363,4to9,4,9,0.878909100097767,-10.9703206525479,95,95,0,2
156378,9to4,9,4,0.957446649458175,-8.35273758710149,31,31,0,3
156394,4to9,4,9,0.878909100097767,-10.9703206525479,31,31,0,2
156409,9to4,9,4,0.957446649458175,-8.35273758710149,31,31,0,3
156425,4to9,4,9,0.878909100097767,-10.9703206525479,31,31,0,2
156441,9to4,9,4,0.957446649458175,-8.35273758710149,32,32,0,3
156457,4to9,4,9,0.878909100097767,-10.9703206525479,32,32,0,2
156474,9to8,9,8,0.042323306624307,-11.47166966968,410,410,0,3
156490,8to3,8,3,0.227014077405999,-4.11464622477799,159,159,0,4
156507,3to4,3,4,0.976578311614922,-4.3200135082935,66,66,0,3
156523,4to9,4,9,0.878909100097767,-10.9703206525479,66,66,0,2
156539,9to4,9,4,0.957446649458175,-8.35273758710149,32,32,0,3
156555,4to9,4,9,0.878909100097767,-10.9703206525479,32,32,0,2
156570,9to4,9,4,0.957446649458175,-8.35273758710149,31,31,0,3
156586,4to9,4,9,0.878909100097767,-10.9703206525479,31,31,0,2
156602,9to4,9,4,0.957446649458175,-8.35273758710149,32,32,0,3
156617,4to9,4,9,0.878909100097767,-10.9703206525479,31,31,0,2
156632,9to4,9,4,0.957446649458175,-8.35273758710149,30,30,0,3
156648,4to3,4,3,0.121090899902233,-12.952460629608,158,158,0,2
156663,3to4,3,4,0.976578311614922,-4.3200135082935,31,31,0,3
156678,4to9,4,9,0.878909100097767,-10.9703206525479,61,61,0,2
156693,9to4,9,4,0.957446649458175,-8.35273758710149,30,30,0,3
156710,4to9,4,9,0.878909100097767,-10.9703206525479,32,32,0,2
156724,9to4,9,4,0.957446649458175,-8.35273758710149,31,31,0,3
156739,4to9,4,9,0.878909100097767,-10.9703206525479,29,29,0,2
156754,9to4,9,4,0.957446649458175,-8.35273758710149,30,30,0,3
156768,4to9,4,9,0.878909100097767,-10.9703206525479,29,29,0,2
156785,9to4,9,4,0.957446649458175,-8.35273758710149,31,31,0,3
156802,4to3,4,3,0.121090899902233,-12.952460629608,154,154,0,2
156817,3to4,3,4,0.976578311614922,-4.3200135082935,32,32,0,3
156833,4to9,4,9,0.878909100097767,-10.9703206525479,65,65,0,2
156848,9to4,9,4,0.957446649458175,-8.35273758710149,31,31,0,3
156864,4to9,4,9,0.878909100097767,-10.9703206525479,31,31,0,2
156881,9to8,9,8,0.042323306624307,-11.47166966968,407,407,0,3
156896,8to3,8,3,0.227014077405999,-4.11464622477799,94,94,0,4
156914,3to4,3,4,0.976578311614922,-4.3200135082935,66,66,0,3
156929,4to9,4,9,0.878909100097767,-10.9703206525479,65,65,0,2
156945,9to4,9,4,0.957446649458175,-8.35273758710149,31,31,0,3
156960,4to9,4,9,0.878909100097767,-10.9703206525479,31,31,0,2
156977,9to4,9,4,0.957446649458175,-8.35273758710149,32,32,0,3
156992,4to9,4,9,0.878909100097767,-10.9703206525479,32,32,0,2
157008,9to14,9,14,0.000230043917518,-16.6864926305794,3058,3058,0,3
157023,14to13,14,13,0.01865206191441,-9.09371951571432,3056,3056,0,3
157037,13to8,13,8,0.917295535428803,-7.37455157477482,156,156,0,4
157052,8to9,8,9,0.769052262769502,-2.89449932615566,60,60,0,4
157066,9to4,9,4,0.957446649458175,-8.35273758710149,89,89,0,3
157082,4to3,4,3,0.121090899902233,-12.952460629608,186,186,0,2
157097,3to4,3,4,0.976578311614922,-4.3200135082935,31,31,0,3
157113,4to9,4,9,0.878909100097767,-10.9703206525479,61,61,0,2
157130,9to4,9,4,0.957446649458175,-8.35273758710149,33,33,0,3
157144,4to9,4,9,0.878909100097767,-10.9703206525479,31,31,0,2
157161,9to4,9,4,0.957446649458175,-8.35273758710149,31,31,0,3
157176,4to9,4,9,0.878909100097767,-10.9703206525479,32,32,0,2
157191,9to4,9,4,0.957446649458175,-8.35273758710149,30,30,0,3
157206,4to3,4,3,0.121090899902233,-12.952460629608,124,124,0,2
157222,3to4,3,4,0.976578311614922,-4.3200135082935,31,31,0,3
157237,4to9,4,9,0.878909100097767,-10.9703206525479,61,61,0,2
157252,9to4,9,4,0.957446649458175,-8.35273758710149,30,30,0,3
157268,4to9,4,9,0.878909100097767,-10.9703206525479,31,31,0,2
157284,9to4,9,4,0.957446649458175,-8.35273758710149,32,32,0,3
157298,4to9,4,9,0.878909100097767,-10.9703206525479,30,30,0,2
157314,9to4,9,4,0.957446649458175,-8.35273758710149,30,30,0,3
157330,4to3,4,3,0.121090899902233,-12.952460629608,124,124,0,2
157348,3to4,3,4,0.976578311614922,-4.3200135082935,34,34,0,3
157365,4to9,4,9,0.878909100097767,-10.9703206525479,67,67,0,2
157380,9to4,9,4,0.957446649458175,-8.35273758710149,32,32,0,3
157395,4to9,4,9,0.878909100097767,-10.9703206525479,30,30,0,2
157411,9to4,9,4,0.957446649458175,-8.35273758710149,31,31,0,3
157428,4to9,4,9,0.878909100097767,-10.9703206525479,33,33,0,2
157444,9to8,9,8,0.042323306624307,-11.47166966968,407,407,0,3
157460,8to3,8,3,0.227014077405999,-4.11464622477799,130,130,0,4
157478,3to4,3,4,0.976578311614922,-4.3200135082935,67,67,0,3
157494,4to9,4,9,0.878909100097767,-10.9703206525479,66,66,0,2
157511,9to4,9,4,0.957446649458175,-8.35273758710149,33,33,0,3
157529,4to9,4,9,0.878909100097767,-10.9703206525479,35,35,0,2
157544,9to4,9,4,0.957446649458175,-8.35273758710149,33,33,0,3
157559,4to9,4,9,0.878909100097767,-10.9703206525479,30,30,0,2
157575,9to4,9,4,0.957446649458175,-8.35273758710149,31,31,0,3
157590,4to9,4,9,0.878909100097767,-10.9703206525479,31,31,0,2
157607,9to4,9,4,0.957446649458175,-8.35273758710149,32,32,0,3
157622,4to3,4,3,0.121090899902233,-12.952460629608,162,162,0,2
157637,3to4,3,4,0.976578311614922,-4.3200135082935,30,30,0,3
157653,4to9,4,9,0.878909100097767,-10.9703206525479,63,63,0,2
157670,9to4,9,4,0.957446649458175,-8.35273758710149,33,33,0,3
157685,4to9,4,9,0.878909100097767,-10.9703206525479,32,32,0,2
157701,9to4,9,4,0.957446649458175,-8.35273758710149,31,31,0,3
157717,4to9,4,9,0.878909100097767,-10.9703206525479,32,32,0,2
157732,9to4,9,4,0.957446649458175,-8.35273758710149,31,31,0,3
157748,4to3,4,3,0.121090899902233,-12.952460629608,126,126,0,2
157764,3to4,3,4,0.976578311614922,-4.3200135082935,32,32,0,3
157779,4to9,4,9,0.878909100097767,-10.9703206525479,62,62,0,2
157796,9to14,9,14,0.000230043917518,-16.6864926305794,788,788,0,3
157811,14to9,14,9,0.981333198506017,-5.13076416031772,32,32,0,3
157828,9to4,9,4,0.957446649458175,-8.35273758710149,64,64,0,3
157843,4to9,4,9,0.878909100097767,-10.9703206525479,32,32,0,2
157859,9to8,9,8,0.042323306624307,-11.47166966968,415,415,0,3
157874,8to3,8,3,0.227014077405999,-4.11464622477799,126,126,0,4
157889,3to4,3,4,0.976578311614922,-4.3200135082935,61,61,0,3
157905,4to9,4,9,0.878909100097767,-10.9703206525479,62,62,0,2
157921,9to4,9,4,0.957446649458175,-8.35273758710149,32,32,0,3
157936,4to9,4,9,0.878909100097767,-10.9703206525479,31,31,0,2
157951,9to4,9,4,0.957446649458175,-8.35273758710149,30,30,0,3
157966,4to9,4,9,0.878909100097767,-10.9703206525479,30,30,0,2
157982,9to4,9,4,0.957446649458175,-8.35273758710149,31,31,0,3
157998,4to9,4,9,0.878909100097767,-10.9703206525479,32,32,0,2
158013,9to4,9,4,0.957446649458175,-8.35273758710149,31,31,0,3
158028,4to3,4,3,0.121090899902233,-12.952460629608,154,154,0,2
158044,3to4,3,4,0.976578311614922,-4.3200135082935,31,31,0,3
158059,4to9,4,9,0.878909100097767,-10.9703206525479,61,61,0,2
158074,9to4,9,4,0.957446649458175,-8.35273758710149,30,30,0,3
158089,4to9,4,9,0.878909100097767,-10.9703206525479,30,30,0,2
158103,9to4,9,4,0.957446649458175,-8.35273758710149,29,29,0,3
158119,4to9,4,9,0.878909100097767,-10.9703206525479,30,30,0,2
158134,9to4,9,4,0.957446649458175,-8.35273758710149,31,31,0,3
158150,4to3,4,3,0.121090899902233,-12.952460629608,122,122,0,2
158166,3to8,3,8,0.022742608734262,-8.07982824981408,307,307,0,3
158183,8to9,8,9,0.769052262769502,-2.89449932615566,64,64,0,4
158200,9to4,9,4,0.957446649458175,-8.35273758710149,66,66,0,3
158214,4to9,4,9,0.878909100097767,-10.9703206525479,31,31,0,2
158229,9to4,9,4,0.957446649458175,-8.35273758710149,29,29,0,3
158243,4to9,4,9,0.878909100097767,-10.9703206525479,29,29,0,2
158258,9to4,9,4,0.957446649458175,-8.35273758710149,29,29,0,3
158274,4to9,4,9,0.878909100097767,-10.9703206525479,31,31,0,2
158291,9to4,9,4,0.957446649458175,-8.35273758710149,33,33,0,3
158307,4to3,4,3,0.121090899902233,-12.952460629608,157,157,0,2
158323,3to4,3,4,0.976578311614922,-4.3200135082935,32,32,0,3
158339,4to9,4,9,0.878909100097767,-10.9703206525479,65,65,0,2
158356,9to4,9,4,0.957446649458175,-8.35273758710149,33,33,0,3
158371,4to9,4,9,0.878909100097767,-10.9703206525479,32,32,0,2
158388,9to4,9,4,0.957446649458175,-8.35273758710149,32,32,0,3
158404,4to9,4,9,0.878909100097767,-10.9703206525479,33,33,0,2
158419,9to4,9,4,0.957446649458175,-8.35273758710149,31,31,0,3
158435,4to3,4,3,0.121090899902233,-12.952460629608,128,128,0,2
158452,3to4,3,4,0.976578311614922,-4.3200135082935,33,33,0,3
158469,4to9,4,9,0.878909100097767,-10.9703206525479,65,65,0,2
158486,9to4,9,4,0.957446649458175,-8.35273758710149,34,34,0,3
158500,4to9,4,9,0.878909100097767,-10.9703206525479,31,31,0,2
158516,9to4,9,4,0.957446649458175,-8.35273758710149,30,30,0,3
158533,4to3,4,3,0.121090899902233,-12.952460629608,98,98,0,2
158549,3to4,3,4,0.976578311614922,-4.3200135082935,33,33,0,3
158564,4to9,4,9,0.878909100097767,-10.9703206525479,64,64,0,2
158581,9to8,9,8,0.042323306624307,-11.47166966968,415,415,0,3
158597,8to9,8,9,0.769052262769502,-2.89449932615566,33,33,0,4
158612,9to8,9,8,0.042323306624307,-11.47166966968,31,31,0,3
158627,8to3,8,3,0.227014077405999,-4.11464622477799,94,94,0,4
158646,3to4,3,4,0.976578311614922,-4.3200135082935,97,97,0,3
158663,4to9,4,9,0.878909100097767,-10.9703206525479,66,66,0,2
158680,9to4,9,4,0.957446649458175,-8.35273758710149,34,34,0,3
158696,4to9,4,9,0.878909100097767,-10.9703206525479,33,33,0,2
158710,9to4,9,4,0.957446649458175,-8.35273758710149,30,30,0,3
158725,4to9,4,9,0.878909100097767,-10.9703206525479,29,29,0,2
158741,9to4,9,4,0.957446649458175,-8.35273758710149,31,31,0,3
158756,4to9,4,9,0.878909100097767,-10.9703206525479,31,31,0,2
158772,9to4,9,4,0.957446649458175,-8.35273758710149,31,31,0,3
158787,4to3,4,3,0.121090899902233,-12.952460629608,160,160,0,2
158803,3to4,3,4,0.976578311614922,-4.3200135082935,31,31,0,3
158819,4to9,4,9,0.878909100097767,-10.9703206525479,63,63,0,2
158835,9to4,9,4,0.957446649458175,-8.35273758710149,32,32,0,3
158852,4to9,4,9,0.878909100097767,-10.9703206525479,33,33,0,2
158867,9to4,9,4,0.957446649458175,-8.35273758710149,32,32,0,3
158883,4to9,4,9,0.878909100097767,-10.9703206525479,31,31,0,2
158899,9to4,9,4,0.957446649458175,-8.35273758710149,32,32,0,3
158914,4to9,4,9,0.878909100097767,-10.9703206525479,31,31,0,2
158930,9to8,9,8,0.042323306624307,-11.47166966968,318,318,0,3
158945,8to3,8,3,0.227014077405999,-4.11464622477799,158,158,0,4
158961,3to4,3,4,0.976578311614922,-4.3200135082935,62,62,0,3
158977,4to9,4,9,0.878909100097767,-10.9703206525479,63,63,0,2
158992,9to4,9,4,0.957446649458175,-8.35273758710149,31,31,0,3
159008,4to9,4,9,0.878909100097767,-10.9703206525479,31,31,0,2
159023,9to4,9,4,0.957446649458175,-8.35273758710149,31,31,0,3
159038,4to9,4,9,0.878909100097767,-10.9703206525479,30,30,0,2
159054,9to4,9,4,0.957446649458175,-8.35273758710149,31,31,0,3
159068,4to9,4,9,0.878909100097767,-10.9703206525479,30,30,0,2
159084,9to4,9,4,0.957446649458175,-8.35273758710149,30,30,0,3
159100,4to3,4,3,0.121090899902233,-12.952460629608,155,155,0,2
159116,3to4,3,4,0.976578311614922,-4.3200135082935,32,32,0,3
159131,4to9,4,9,0.878909100097767,-10.9703206525479,63,63,0,2
159147,9to4,9,4,0.957446649458175,-8.35273758710149,31,31,0,3
159162,4to9,4,9,0.878909100097767,-10.9703206525479,31,31,0,2
159176,9to4,9,4,0.957446649458175,-8.35273758710149,29,29,0,3
159191,4to9,4,9,0.878909100097767,-10.9703206525479,29,29,0,2
159207,9to4,9,4,0.957446649458175,-8.35273758710149,31,31,0,3
159223,4to9,4,9,0.878909100097767,-10.9703206525479,32,32,0,2
159239,9to4,9,4,0.957446649458175,-8.35273758710149,32,32,0,3
159253,4to3,4,3,0.121090899902233,-12.952460629608,153,153,0,2
159268,3to4,3,4,0.976578311614922,-4.3200135082935,29,29,0,3
159284,4to9,4,9,0.878909100097767,-10.9703206525479,61,61,0,2
159298,9to4,9,4,0.957446649458175,-8.35273758710149,30,30,0,3
159315,4to9,4,9,0.878909100097767,-10.9703206525479,31,31,0,2
159331,9to8,9,8,0.042323306624307,-11.47166966968,401,401,0,3
159348,8to3,8,3,0.227014077405999,-4.11464622477799,95,95,0,4
159364,3to4,3,4,0.976578311614922,-4.3200135082935,66,66,0,3
159380,4to3,4,3,0.121090899902233,-12.952460629608,32,32,0,2
159395,3to4,3,4,0.976578311614922,-4.3200135082935,31,31,0,3
159411,4to9,4,9,0.878909100097767,-10.9703206525479,96,96,0,2
159428,9to4,9,4,0.957446649458175,-8.35273758710149,33,33,0,3
159443,4to9,4,9,0.878909100097767,-10.9703206525479,32,32,0,2
159459,9to4,9,4,0.957446649458175,-8.35273758710149,31,31,0,3
159475,4to9,4,9,0.878909100097767,-10.9703206525479,32,32,0,2
159490,9to4,9,4,0.957446649458175,-8.35273758710149,31,31,0,3
159505,4to9,4,9,0.878909100097767,-10.9703206525479,30,30,0,2
159521,9to4,9,4,0.957446649458175,-8.35273758710149,31,31,0,3
159538,4to3,4,3,0.121090899902233,-12.952460629608,158,158,0,2
159554,3to4,3,4,0.976578311614922,-4.3200135082935,33,33,0,3
159571,4to9,4,9,0.878909100097767,-10.9703206525479,66,66,0,2
159587,9to4,9,4,0.957446649458175,-8.35273758710149,33,33,0,3
159602,4to9,4,9,0.878909100097767,-10.9703206525479,31,31,0,2
159616,9to4,9,4,0.957446649458175,-8.35273758710149,29,29,0,3
159631,4to9,4,9,0.878909100097767,-10.9703206525479,29,29,0,2
159646,9to4,9,4,0.957446649458175,-8.35273758710149,30,30,0,3
159662,4to9,4,9,0.878909100097767,-10.9703206525479,31,31,0,2
159678,9to4,9,4,0.957446649458175,-8.35273758710149,32,32,0,3
159695,4to3,4,3,0.121090899902233,-12.952460629608,157,157,0,2
159710,3to4,3,4,0.976578311614922,-4.3200135082935,32,32,0,3
159726,4to9,4,9,0.878909100097767,-10.9703206525479,64,64,0,2
159742,9to8,9,8,0.042323306624307,-11.47166966968,411,411,0,3
159757,8to9,8,9,0.769052262769502,-2.89449932615566,31,31,0,4
159774,9to4,9,4,0.957446649458175,-8.35273758710149,64,64,0,3
159789,4to9,4,9,0.878909100097767,-10.9703206525479,32,32,0,2
159804,9to4,9,4,0.957446649458175,-8.35273758710149,30,30,0,3
159821,4to3,4,3,0.121090899902233,-12.952460629608,126,126,0,2
159836,3to4,3,4,0.976578311614922,-4.3200135082935,32,32,0,3
159852,4to9,4,9,0.878909100097767,-10.9703206525479,63,63,0,2
159868,9to4,9,4,0.957446649458175,-8.35273758710149,32,32,0,3
159883,4to9,4,9,0.878909100097767,-10.9703206525479,31,31,0,2
159898,9to4,9,4,0.957446649458175,-8.35273758710149,30,30,0,3
159915,4to9,4,9,0.878909100097767,-10.9703206525479,32,32,0,2
159930,9to4,9,4,0.957446649458175,-8.35273758710149,32,32,0,3
159946,4to3,4,3,0.121090899902233,-12.952460629608,125,125,0,2
159961,3to4,3,4,0.976578311614922,-4.3200135082935,31,31,0,3
159976,4to9,4,9,0.878909100097767,-10.9703206525479,61,61,0,2
159993,9to4,9,4,0.957446649458175,-8.35273758710149,32,32,0,3
160010,4to9,4,9,0.878909100097767,-10.9703206525479,34,34,0,2
160026,9to4,9,4,0.957446649458175,-8.35273758710149,33,33,0,3
160041,4to9,4,9,0.878909100097767,-10.9703206525479,31,31,0,2
160057,9to4,9,4,0.957446649458175,-8.35273758710149,31,31,0,3
160071,4to3,4,3,0.121090899902233,-12.952460629608,125,125,0,2
160086,3to4,3,4,0.976578311614922,-4.3200135082935,29,29,0,3
160102,4to9,4,9,0.878909100097767,-10.9703206525479,61,61,0,2
160118,9to4,9,4,0.957446649458175,-8.35273758710149,32,32,0,3
160134,4to9,4,9,0.878909100097767,-10.9703206525479,32,32,0,2
160150,9to8,9,8,0.042323306624307,-11.47166966968,408,408,0,3
160165,8to3,8,3,0.227014077405999,-4.11464622477799,94,94,0,4
160182,3to4,3,4,0.976578311614922,-4.3200135082935,64,64,0,3
160198,4to9,4,9,0.878909100097767,-10.9703206525479,64,64,0,2
160212,9to4,9,4,0.957446649458175,-8.35273758710149,30,30,0,3
160229,4to9,4,9,0.878909100097767,-10.9703206525479,31,31,0,2
160244,9to4,9,4,0.957446649458175,-8.35273758710149,32,32,0,3
160261,4to9,4,9,0.878909100097767,-10.9703206525479,32,32,0,2
160277,9to4,9,4,0.957446649458175,-8.35273758710149,33,33,0,3
160292,4to9,4,9,0.878909100097767,-10.9703206525479,31,31,0,2
160309,9to4,9,4,0.957446649458175,-8.35273758710149,32,32,0,3
160326,4to9,4,9,0.878909100097767,-10.9703206525479,34,34,0,2
160340,9to4,9,4,0.957446649458175,-8.35273758710149,31,31,0,3
160355,4to3,4,3,0.121090899902233,-12.952460629608,190,190,0,2
160371,3to4,3,4,0.976578311614922,-4.3200135082935,31,31,0,3
160387,4to9,4,9,0.878909100097767,-10.9703206525479,61,61,0,2
160403,9to4,9,4,0.957446649458175,-8.35273758710149,32,32,0,3
160419,4to9,4,9,0.878909100097767,-10.9703206525479,32,32,0,2
160435,9to8,9,8,0.042323306624307,-11.47166966968,285,285,0,3
160453,8to3,8,3,0.227014077405999,-4.11464622477799,98,98,0,4
160470,3to4,3,4,0.976578311614922,-4.3200135082935,67,67,0,3
160486,4to9,4,9,0.878909100097767,-10.9703206525479,67,67,0,2
160503,9to4,9,4,0.957446649458175,-8.35273758710149,33,33,0,3
160519,4to9,4,9,0.878909100097767,-10.9703206525479,33,33,0,2
160536,9to4,9,4,0.957446649458175,-8.35273758710149,33,33,0,3
160552,4to9,4,9,0.878909100097767,-10.9703206525479,33,33,0,2
160567,9to4,9,4,0.957446649458175,-8.35273758710149,31,31,0,3
160582,4to3,4,3,0.121090899902233,-12.952460629608,129,129,0,2
160598,3to4,3,4,0.976578311614922,-4.3200135082935,31,31,0,3
160615,4to9,4,9,0.878909100097767,-10.9703206525479,63,63,0,2
160630,9to4,9,4,0.957446649458175,-8.35273758710149,32,32,0,3
160645,4to9,4,9,0.878909100097767,-10.9703206525479,30,30,0,2
160660,9to4,9,4,0.957446649458175,-8.35273758710149,30,30,0,3
160675,4to9,4,9,0.878909100097767,-10.9703206525479,30,30,0,2
160691,9to4,9,4,0.957446649458175,-8.35273758710149,31,31,0,3
160706,4to9,4,9,0.878909100097767,-10.9703206525479,31,31,0,2
160722,9to4,9,4,0.957446649458175,-8.35273758710149,31,31,0,3
160737,4to3,4,3,0.121090899902233,-12.952460629608,155,155,0,2
160753,3to4,3,4,0.976578311614922,-4.3200135082935,31,31,0,3
160769,4to9,4,9,0.878909100097767,-10.9703206525479,63,63,0,2
160785,9to14,9,14,0.000230043917518,-16.6864926305794,2989,2989,0,3
160802,14to13,14,13,0.01865206191441,-9.09371951571432,3779,3779,0,3
160819,13to18,13,18,3.8196453212678E-05,-17.461054383242,8484,431,8053,4
160835,18to23,18,23,0.000216873376961,-12.1766395459334,60167,4,60163,4
160851,23to22,23,22,0.00995504104962,-8.99025954121595,45853,69,45784,3
160866,22to17,22,17,0.453420152749834,-6.76204886222091,16004,167,15837,3
160881,17to12,17,12,0.955006792211011,-5.20631123779532,12208,12208,0,4
160898,12to7,12,7,0.019195020372649,-10.2907402600302,11257,11257,0,4
160914,7to2,7,2,0.071244276411301,-4.92272997679187,10503,10503,0,4
160929,2to3,2,3,0.998311213496016,-3.95697141540815,192,192,0,3
160946,3to4,3,4,0.976578311614922,-4.3200135082935,193,193,0,3
160961,4to9,4,9,0.878909100097767,-10.9703206525479,192,192,0,2
160977,9to8,9,8,0.042323306624307,-11.47166966968,542,542,0,3
160992,8to9,8,9,0.769052262769502,-2.89449932615566,31,31,0,4
161008,9to8,9,8,0.042323306624307,-11.47166966968,31,31,0,3
161023,8to3,8,3,0.227014077405999,-4.11464622477799,94,94,0,4
161039,3to4,3,4,0.976578311614922,-4.3200135082935,93,93,0,3
161055,4to9,4,9,0.878909100097767,-10.9703206525479,63,63,0,2
161072,9to4,9,4,0.957446649458175,-8.35273758710149,33,33,0,3
161089,4to9,4,9,0.878909100097767,-10.9703206525479,34,34,0,2
161104,9to4,9,4,0.957446649458175,-8.35273758710149,32,32,0,3
161118,4to9,4,9,0.878909100097767,-10.9703206525479,29,29,0,2
161133,9to4,9,4,0.957446649458175,-8.35273758710149,29,29,0,3
161149,4to3,4,3,0.121090899902233,-12.952460629608,126,126,0,2
161165,3to4,3,4,0.976578311614922,-4.3200135082935,32,32,0,3
161181,4to9,4,9,0.878909100097767,-10.9703206525479,63,63,0,2
161196,9to4,9,4,0.957446649458175,-8.35273758710149,31,31,0,3
161211,4to9,4,9,0.878909100097767,-10.9703206525479,30,30,0,2
161226,9to4,9,4,0.957446649458175,-8.35273758710149,30,30,0,3
161243,4to9,4,9,0.878909100097767,-10.9703206525479,32,32,0,2
161258,9to4,9,4,0.957446649458175,-8.35273758710149,32,32,0,3
161273,4to3,4,3,0.121090899902233,-12.952460629608,124,124,0,2
161289,3to4,3,4,0.976578311614922,-4.3200135082935,31,31,0,3
161304,4to9,4,9,0.878909100097767,-10.9703206525479,61,61,0,2
161319,9to4,9,4,0.957446649458175,-8.35273758710149,30,30,0,3
161334,4to9,4,9,0.878909100097767,-10.9703206525479,30,30,0,2
161350,9to4,9,4,0.957446649458175,-8.35273758710149,31,31,0,3
161365,4to9,4,9,0.878909100097767,-10.9703206525479,31,31,0,2
161382,9to8,9,8,0.042323306624307,-11.47166966968,374,374,0,3
161397,8to3,8,3,0.227014077405999,-4.11464622477799,124,124,0,4
161414,3to8,3,8,0.022742608734262,-8.07982824981408,32,32,0,3
161430,8to9,8,9,0.769052262769502,-2.89449932615566,65,65,0,4
161446,9to4,9,4,0.957446649458175,-8.35273758710149,96,96,0,3
161462,4to9,4,9,0.878909100097767,-10.9703206525479,32,32,0,2
161478,9to4,9,4,0.957446649458175,-8.35273758710149,32,32,0,3
161495,4to9,4,9,0.878909100097767,-10.9703206525479,33,33,0,2
161511,9to4,9,4,0.957446649458175,-8.35273758710149,33,33,0,3
161526,4to9,4,9,0.878909100097767,-10.9703206525479,31,31,0,2
161542,9to4,9,4,0.957446649458175,-8.35273758710149,31,31,0,3
161558,4to3,4,3,0.121090899902233,-12.952460629608,161,161,0,2
161575,3to4,3,4,0.976578311614922,-4.3200135082935,33,33,0,3
161591,4to9,4,9,0.878909100097767,-10.9703206525479,65,65,0,2
161606,9to4,9,4,0.957446649458175,-8.35273758710149,31,31,0,3
161623,4to9,4,9,0.878909100097767,-10.9703206525479,32,32,0,2
161638,9to4,9,4,0.957446649458175,-8.35273758710149,32,32,0,3
161652,4to9,4,9,0.878909100097767,-10.9703206525479,29,29,0,2
161669,9to4,9,4,0.957446649458175,-8.35273758710149,31,31,0,3
161685,4to9,4,9,0.878909100097767,-10.9703206525479,33,33,0,2
161699,9to4,9,4,0.957446649458175,-8.35273758710149,30,30,0,3
161715,4to3,4,3,0.121090899902233,-12.952460629608,157,157,0,2
161730,3to4,3,4,0.976578311614922,-4.3200135082935,31,31,0,3
161746,4to9,4,9,0.878909100097767,-10.9703206525479,61,61,0,2
161762,9to4,9,4,0.957446649458175,-8.35273758710149,32,32,0,3
161778,4to9,4,9,0.878909100097767,-10.9703206525479,32,32,0,2
161796,9to14,9,14,0.000230043917518,-16.6864926305794,1011,1011,0,3
161813,14to19,14,19,5.83422646082092E-06,-17.1636987104224,9495,695,8800,3
161830,19to24,19,24,0.00051748030732,-11.3385996061345,61178,44,61134,3
161848,24to23,24,23,0.053188909524942,-7.77474637690827,1013,46,967,2
161864,23to18,23,18,0.969826524402933,-4.41122138755967,1045,1045,0,3
161879,18to19,18,19,0.001882248956514,-10.015730618506,66,66,0,4
161895,19to14,19,14,0.99812655666248,-3.77393571952463,99,99,0,3
161911,14to9,14,9,0.981341937753484,-5.13076416031772,133,133,0,3
161927,9to4,9,4,0.957446649458175,-8.35273758710149,165,165,0,3
161942,4to3,4,3,0.121090899902233,-12.952460629608,227,227,0,2
161958,3to4,3,4,0.976578311614922,-4.3200135082935,31,31,0,3
161973,4to9,4,9,0.878909100097767,-10.9703206525479,62,62,0,2
161990,9to8,9,8,0.042323306624307,-11.47166966968,576,576,0,3
162007,8to7,8,7,0.000908728145689,-9.63536755452497,1109,1109,0,4
162022,7to6,7,6,0.002262044583176,-8.37503752706468,34340,9029,25311,4
162038,6to1,6,1,0.060333809913404,-7.81318714484248,17273,9061,8212,4
162055,1to2,1,2,0.872526730768857,-6.99282488658743,1141,1141,0,3
162071,2to3,2,3,0.998311213496016,-3.95697141540815,129,129,0,3
162087,3to4,3,4,0.976578311614922,-4.3200135082935,129,129,0,3
162104,4to9,4,9,0.878909100097767,-10.9703206525479,131,131,0,2
162119,9to4,9,4,0.957446649458175,-8.35273758710149,32,32,0,3
162134,4to9,4,9,0.878909100097767,-10.9703206525479,30,30,0,2
162149,9to4,9,4,0.957446649458175,-8.35273758710149,30,30,0,3
162165,4to9,4,9,0.878909100097767,-10.9703206525479,31,31,0,2
162181,9to4,9,4,0.957446649458175,-8.35273758710149,32,32,0,3
162196,4to9,4,9,0.878909100097767,-10.9703206525479,31,31,0,2
162212,9to4,9,4,0.957446649458175,-8.35273758710149,31,31,0,3
162228,4to3,4,3,0.121090899902233,-12.952460629608,157,157,0,2
162242,3to4,3,4,0.976578311614922,-4.3200135082935,30,30,0,3
162259,4to9,4,9,0.878909100097767,-10.9703206525479,63,63,0,2
162275,9to4,9,4,0.957446649458175,-8.35273758710149,33,33,0,3
162290,4to9,4,9,0.878909100097767,-10.9703206525479,31,31,0,2
162306,9to4,9,4,0.957446649458175,-8.35273758710149,31,31,0,3
162322,4to9,4,9,0.878909100097767,-10.9703206525479,32,32,0,2
162337,9to4,9,4,0.957446649458175,-8.35273758710149,31,31,0,3
162352,4to3,4,3,0.121090899902233,-12.952460629608,124,124,0,2
162367,3to4,3,4,0.976578311614922,-4.3200135082935,30,30,0,3
162383,4to9,4,9,0.878909100097767,-10.9703206525479,61,61,0,2
162399,9to8,9,8,0.042323306624307,-11.47166966968,409,409,0,3
162416,8to9,8,9,0.769052262769502,-2.89449932615566,33,33,0,4
162431,9to4,9,4,0.957446649458175,-8.35273758710149,64,64,0,3
162447,4to9,4,9,0.878909100097767,-10.9703206525479,31,31,0,2
162463,9to4,9,4,0.957446649458175,-8.35273758710149,32,32,0,3
162479,4to9,4,9,0.878909100097767,-10.9703206525479,32,32,0,2
162495,9to4,9,4,0.957446649458175,-8.35273758710149,32,32,0,3
162510,4to3,4,3,0.121090899902233,-12.952460629608,158,158,0,2
162528,3to4,3,4,0.976578311614922,-4.3200135082935,33,33,0,3
162544,4to9,4,9,0.878909100097767,-10.9703206525479,65,65,0,2
162559,9to4,9,4,0.957446649458175,-8.35273758710149,31,31,0,3
162576,4to9,4,9,0.878909100097767,-10.9703206525479,32,32,0,2
162592,9to4,9,4,0.957446649458175,-8.35273758710149,33,33,0,3
162608,4to3,4,3,0.121090899902233,-12.952460629608,98,98,0,2
162623,3to4,3,4,0.976578311614922,-4.3200135082935,31,31,0,3
162640,4to9,4,9,0.878909100097767,-10.9703206525479,64,64,0,2
162655,9to4,9,4,0.957446649458175,-8.35273758710149,32,32,0,3
162670,4to9,4,9,0.878909100097767,-10.9703206525479,30,30,0,2
162687,9to4,9,4,0.957446649458175,-8.35273758710149,32,32,0,3
162703,4to9,4,9,0.878909100097767,-10.9703206525479,33,33,0,2
162719,9to4,9,4,0.957446649458175,-8.35273758710149,32,32,0,3
162734,4to9,4,9,0.878909100097767,-10.9703206525479,31,31,0,2
162749,9to4,9,4,0.957446649458175,-8.35273758710149,30,30,0,3
162764,4to3,4,3,0.121090899902233,-12.952460629608,156,156,0,2
162780,3to2,3,2,0.000679079650815,-11.5910853038632,725,725,0,3
162796,2to3,2,3,0.998311213496016,-3.95697141540815,32,32,0,3
162811,3to2,3,2,0.000679079650815,-11.5910853038632,31,31,0,3
162827,2to3,2,3,0.998311213496016,-3.95697141540815,31,31,0,3
162843,3to4,3,4,0.976578311614922,-4.3200135082935,94,94,0,3
162859,4to9,4,9,0.878909100097767,-10.9703206525479,125,125,0,2
162874,9to8,9,8,0.042323306624307,-11.47166966968,475,475,0,3
162889,8to9,8,9,0.769052262769502,-2.89449932615566,30,30,0,4
162904,9to4,9,4,0.957446649458175,-8.35273758710149,61,61,0,3
162919,4to9,4,9,0.878909100097767,-10.9703206525479,30,30,0,2
162935,9to4,9,4,0.957446649458175,-8.35273758710149,31,31,0,3
162951,4to9,4,9,0.878909100097767,-10.9703206525479,32,32,0,2
162966,9to4,9,4,0.957446649458175,-8.35273758710149,31,31,0,3
162982,4to3,4,3,0.121090899902233,-12.952460629608,155,155,0,2
162998,3to4,3,4,0.976578311614922,-4.3200135082935,32,32,0,3
163013,4to9,4,9,0.878909100097767,-10.9703206525479,62,62,0,2
163029,9to14,9,14,0.000230043917518,-16.6864926305794,1134,1134,0,3
163046,14to13,14,13,0.018652228020056,-9.09371951571432,2244,2244,0,3
163062,13to8,13,8,0.917351022044606,-7.37455157477482,188,188,0,4
163080,8to9,8,9,0.769052262769502,-2.89449932615566,67,67,0,4
163095,9to4,9,4,0.957446649458175,-8.35273758710149,97,97,0,3
163110,4to3,4,3,0.121090899902233,-12.952460629608,128,128,0,2
163126,3to4,3,4,0.976578311614922,-4.3200135082935,31,31,0,3
163141,4to9,4,9,0.878909100097767,-10.9703206525479,61,61,0,2
163157,9to4,9,4,0.957446649458175,-8.35273758710149,31,31,0,3
163172,4to9,4,9,0.878909100097767,-10.9703206525479,31,31,0,2
163187,9to4,9,4,0.957446649458175,-8.35273758710149,30,30,0,3
163202,4to9,4,9,0.878909100097767,-10.9703206525479,30,30,0,2
163218,9to14,9,14,0.000230043917518,-16.6864926305794,189,189,0,3
163234,14to9,14,9,0.981341937753484,-5.13076416031772,32,32,0,3
163251,9to4,9,4,0.957446649458175,-8.35273758710149,64,64,0,3
163267,4to3,4,3,0.121090899902233,-12.952460629608,157,157,0,2
163282,3to4,3,4,0.976578311614922,-4.3200135082935,31,31,0,3
163298,4to9,4,9,0.878909100097767,-10.9703206525479,64,64,0,2
163313,9to4,9,4,0.957446649458175,-8.35273758710149,31,31,0,3
163328,4to9,4,9,0.878909100097767,-10.9703206525479,30,30,0,2
163344,9to4,9,4,0.957446649458175,-8.35273758710149,31,31,0,3
163361,4to9,4,9,0.878909100097767,-10.9703206525479,33,33,0,2
163376,9to4,9,4,0.957446649458175,-8.35273758710149,32,32,0,3
163393,4to3,4,3,0.121090899902233,-12.952460629608,126,126,0,2
163409,3to4,3,4,0.976578311614922,-4.3200135082935,33,33,0,3
163426,4to9,4,9,0.878909100097767,-10.9703206525479,65,65,0,2
163441,9to4,9,4,0.957446649458175,-8.35273758710149,32,32,0,3
163456,4to9,4,9,0.878909100097767,-10.9703206525479,30,30,0,2
163471,9to14,9,14,0.000230043917518,-16.6864926305794,253,253,0,3
163486,14to9,14,9,0.981341937753484,-5.13076416031772,30,30,0,3
163502,9to4,9,4,0.957446649458175,-8.35273758710149,61,61,0,3
163518,4to9,4,9,0.878909100097767,-10.9703206525479,32,32,0,2
163534,9to8,9,8,0.042323306624307,-11.47166966968,472,472,0,3
163552,8to3,8,3,0.227014077405999,-4.11464622477799,159,159,0,4
163569,3to4,3,4,0.976578311614922,-4.3200135082935,67,67,0,3
163585,4to9,4,9,0.878909100097767,-10.9703206525479,67,67,0,2
163601,9to4,9,4,0.957446649458175,-8.35273758710149,32,32,0,3
163617,4to9,4,9,0.878909100097767,-10.9703206525479,32,32,0,2
163633,9to4,9,4,0.957446649458175,-8.35273758710149,32,32,0,3
163649,4to9,4,9,0.878909100097767,-10.9703206525479,32,32,0,2
163666,9to4,9,4,0.957446649458175,-8.35273758710149,33,33,0,3
163681,4to9,4,9,0.878909100097767,-10.9703206525479,32,32,0,2
163695,9to4,9,4,0.957446649458175,-8.35273758710149,29,29,0,3
163712,4to3,4,3,0.121090899902233,-12.952460629608,160,160,0,2
163727,3to4,3,4,0.976578311614922,-4.3200135082935,32,32,0,3
163742,4to9,4,9,0.878909100097767,-10.9703206525479,61,61,0,2
163757,9to4,9,4,0.957446649458175,-8.35273758710149,30,30,0,3
163774,4to9,4,9,0.878909100097767,-10.9703206525479,32,32,0,2
163791,9to4,9,4,0.957446649458175,-8.35273758710149,34,34,0,3
163806,4to9,4,9,0.878909100097767,-10.9703206525479,32,32,0,2
163822,9to4,9,4,0.957446649458175,-8.35273758710149,31,31,0,3
163838,4to9,4,9,0.878909100097767,-10.9703206525479,32,32,0,2
163854,9to4,9,4,0.957446649458175,-8.35273758710149,32,32,0,3
163870,4to3,4,3,0.121090899902233,-12.952460629608,158,158,0,2
163885,3to4,3,4,0.976578311614922,-4.3200135082935,31,31,0,3
163901,4to9,4,9,0.878909100097767,-10.9703206525479,63,63,0,2
163916,9to8,9,8,0.042323306624307,-11.47166966968,382,382,0,3
163933,8to9,8,9,0.769052262769502,-2.89449932615566,32,32,0,4
163949,9to4,9,4,0.957446649458175,-8.35273758710149,64,64,0,3
163964,4to9,4,9,0.878909100097767,-10.9703206525479,31,31,0,2
163980,9to4,9,4,0.957446649458175,-8.35273758710149,31,31,0,3
163996,4to9,4,9,0.878909100097767,-10.9703206525479,32,32,0,2
164013,9to14,9,14,0.000230043917518,-16.6864926305794,542,542,0,3
164029,14to13,14,13,0.018652228020056,-9.09371951571432,983,983,0,3
164046,13to8,13,8,0.917351022044606,-7.37455157477482,130,130,0,4
164063,8to3,8,3,0.227014077405999,-4.11464622477799,193,193,0,4
164079,3to4,3,4,0.976578311614922,-4.3200135082935,99,99,0,3
164094,4to9,4,9,0.878909100097767,-10.9703206525479,98,98,0,2
164110,9to4,9,4,0.957446649458175,-8.35273758710149,31,31,0,3
164127,4to9,4,9,0.878909100097767,-10.9703206525479,33,33,0,2
164143,9to8,9,8,0.042323306624307,-11.47166966968,97,97,0,3
164159,8to3,8,3,0.227014077405999,-4.11464622477799,96,96,0,4
164176,3to4,3,4,0.976578311614922,-4.3200135082935,66,66,0,3
164192,4to9,4,9,0.878909100097767,-10.9703206525479,65,65,0,2
164207,9to4,9,4,0.957446649458175,-8.35273758710149,31,31,0,3
164223,4to9,4,9,0.878909100097767,-10.9703206525479,31,31,0,2
164239,9to4,9,4,0.957446649458175,-8.35273758710149,32,32,0,3
164254,4to9,4,9,0.878909100097767,-10.9703206525479,31,31,0,2
164268,9to4,9,4,0.957446649458175,-8.35273758710149,29,29,0,3
164285,4to3,4,3,0.121090899902233,-12.952460629608,126,126,0,2
164300,3to4,3,4,0.976578311614922,-4.3200135082935,32,32,0,3
164317,4to9,4,9,0.878909100097767,-10.9703206525479,63,63,0,2
164334,9to4,9,4,0.957446649458175,-8.35273758710149,34,34,0,3
164349,4to9,4,9,0.878909100097767,-10.9703206525479,32,32,0,2
164366,9to4,9,4,0.957446649458175,-8.35273758710149,32,32,0,3
164381,4to9,4,9,0.878909100097767,-10.9703206525479,32,32,0,2
164398,9to4,9,4,0.957446649458175,-8.35273758710149,32,32,0,3
164414,4to9,4,9,0.878909100097767,-10.9703206525479,33,33,0,2
164429,9to4,9,4,0.957446649458175,-8.35273758710149,31,31,0,3
164445,4to3,4,3,0.121090899902233,-12.952460629608,160,160,0,2
164461,3to4,3,4,0.976578311614922,-4.3200135082935,32,32,0,3
164476,4to9,4,9,0.878909100097767,-10.9703206525479,62,62,0,2
164492,9to4,9,4,0.957446649458175,-8.35273758710149,31,31,0,3
164508,4to9,4,9,0.878909100097767,-10.9703206525479,32,32,0,2
164524,9to8,9,8,0.042323306624307,-11.47166966968,381,381,0,3
164540,8to7,8,7,0.000908728145689,-9.63536755452497,2533,2533,0,4
164557,7to2,7,2,0.071419906813599,-4.92272997679187,1746,1746,0,4
164572,2to3,2,3,0.998311213496016,-3.95697141540815,127,127,0,3
164589,3to4,3,4,0.976578311614922,-4.3200135082935,97,97,0,3
164605,4to9,4,9,0.878909100097767,-10.9703206525479,97,97,0,2
164620,9to4,9,4,0.957446649458175,-8.35273758710149,31,31,0,3
164636,4to3,4,3,0.121090899902233,-12.952460629608,64,64,0,2
164653,3to4,3,4,0.976578311614922,-4.3200135082935,33,33,0,3
164669,4to9,4,9,0.878909100097767,-10.9703206525479,64,64,0,2
164684,9to4,9,4,0.957446649458175,-8.35273758710149,31,31,0,3
164698,4to9,4,9,0.878909100097767,-10.9703206525479,29,29,0,2
164713,9to4,9,4,0.957446649458175,-8.35273758710149,29,29,0,3
164729,4to3,4,3,0.121090899902233,-12.952460629608,93,93,0,2
164745,3to4,3,4,0.976578311614922,-4.3200135082935,32,32,0,3
164763,4to9,4,9,0.878909100097767,-10.9703206525479,65,65,0,2
164778,9to4,9,4,0.957446649458175,-8.35273758710149,33,33,0,3
164794,4to9,4,9,0.878909100097767,-10.9703206525479,31,31,0,2
164810,9to4,9,4,0.957446649458175,-8.35273758710149,32,32,0,3
164825,4to9,4,9,0.878909100097767,-10.9703206525479,31,31,0,2
164841,9to4,9,4,0.957446649458175,-8.35273758710149,31,31,0,3
164856,4to9,4,9,0.878909100097767,-10.9703206525479,31,31,0,2
164872,9to4,9,4,0.957446649458175,-8.35273758710149,31,31,0,3
164887,4to3,4,3,0.121090899902233,-12.952460629608,158,158,0,2
164903,3to4,3,4,0.976578311614922,-4.3200135082935,31,31,0,3
164919,4to9,4,9,0.878909100097767,-10.9703206525479,63,63,0,2
164935,9to8,9,8,0.042323306624307,-11.47166966968,411,411,0,3
164950,8to9,8,9,0.769052262769502,-2.89449932615566,31,31,0,4
164967,9to4,9,4,0.957446649458175,-8.35273758710149,64,64,0,3
164983,4to9,4,9,0.878909100097767,-10.9703206525479,33,33,0,2
164998,9to4,9,4,0.957446649458175,-8.35273758710149,31,31,0,3
165015,4to3,4,3,0.121090899902233,-12.952460629608,128,128,0,2
165031,3to4,3,4,0.976578311614922,-4.3200135082935,33,33,0,3
165046,4to3,4,3,0.121090899902233,-12.952460629608,31,31,0,2
165061,3to4,3,4,0.976578311614922,-4.3200135082935,30,30,0,3
165078,4to9,4,9,0.878909100097767,-10.9703206525479,95,95,0,2
165093,9to4,9,4,0.957446649458175,-8.35273758710149,32,32,0,3
165110,4to9,4,9,0.878909100097767,-10.9703206525479,32,32,0,2
165125,9to14,9,14,0.000135583506644,-17.2152696089966,1112,524,588,3
165141,14to13,14,13,0.018652228020056,-9.09371951571432,1112,1112,0,3
165157,13to8,13,8,0.917351022044606,-7.37455157477482,222,222,0,4
165173,8to9,8,9,0.769052262769502,-2.89449932615566,63,63,0,4
165188,9to4,9,4,0.957537111072217,-8.35273758710149,95,95,0,3
165204,4to3,4,3,0.121090899902233,-12.952460629608,158,158,0,2
165219,3to4,3,4,0.976578311614922,-4.3200135082935,31,31,0,3
165235,4to9,4,9,0.878909100097767,-10.9703206525479,62,62,0,2
165250,9to4,9,4,0.957537111072217,-8.35273758710149,31,31,0,3
165265,4to9,4,9,0.878909100097767,-10.9703206525479,30,30,0,2
165281,9to4,9,4,0.957537111072217,-8.35273758710149,31,31,0,3
165296,4to9,4,9,0.878909100097767,-10.9703206525479,31,31,0,2
165311,9to4,9,4,0.957537111072217,-8.35273758710149,30,30,0,3
165325,4to3,4,3,0.121090899902233,-12.952460629608,121,121,0,2
165341,3to4,3,4,0.976578311614922,-4.3200135082935,30,30,0,3
165359,4to9,4,9,0.878909100097767,-10.9703206525479,63,63,0,2
165376,9to4,9,4,0.957537111072217,-8.35273758710149,35,35,0,3
165392,4to9,4,9,0.878909100097767,-10.9703206525479,33,33,0,2
165409,9to4,9,4,0.957537111072217,-8.35273758710149,33,33,0,3
165426,4to9,4,9,0.878909100097767,-10.9703206525479,34,34,0,2
165441,9to4,9,4,0.957537111072217,-8.35273758710149,32,32,0,3
165458,4to3,4,3,0.121090899902233,-12.952460629608,133,133,0,2
165473,3to4,3,4,0.976578311614922,-4.3200135082935,32,32,0,3
165490,4to9,4,9,0.878909100097767,-10.9703206525479,64,64,0,2
165506,9to4,9,4,0.957537111072217,-8.35273758710149,33,33,0,3
165522,4to9,4,9,0.878909100097767,-10.9703206525479,32,32,0,2
165539,9to8,9,8,0.042327305421139,-11.47166966968,382,382,0,3
165555,8to3,8,3,0.227014077405999,-4.11464622477799,97,97,0,4
165572,3to4,3,4,0.976578311614922,-4.3200135082935,66,66,0,3
165589,4to9,4,9,0.878909100097767,-10.9703206525479,67,67,0,2
165606,9to4,9,4,0.957537111072217,-8.35273758710149,34,34,0,3
165622,4to9,4,9,0.878909100097767,-10.9703206525479,33,33,0,2
165637,9to4,9,4,0.957537111072217,-8.35273758710149,31,31,0,3
165653,4to9,4,9,0.878909100097767,-10.9703206525479,31,31,0,2
165669,9to4,9,4,0.957537111072217,-8.35273758710149,32,32,0,3
165686,4to9,4,9,0.878909100097767,-10.9703206525479,33,33,0,2
165701,9to4,9,4,0.957537111072217,-8.35273758710149,32,32,0,3
165716,4to3,4,3,0.121090899902233,-12.952460629608,161,161,0,2
165732,3to4,3,4,0.976578311614922,-4.3200135082935,31,31,0,3
165749,4to9,4,9,0.878909100097767,-10.9703206525479,63,63,0,2
165765,9to4,9,4,0.957537111072217,-8.35273758710149,33,33,0,3
165779,4to9,4,9,0.878909100097767,-10.9703206525479,30,30,0,2
165794,9to4,9,4,0.957537111072217,-8.35273758710149,29,29,0,3
165811,4to9,4,9,0.878909100097767,-10.9703206525479,32,32,0,2
165828,9to4,9,4,0.957537111072217,-8.35273758710149,34,34,0,3
165845,4to3,4,3,0.121090899902233,-12.952460629608,129,129,0,2
165860,3to4,3,4,0.976578311614922,-4.3200135082935,32,32,0,3
165876,4to9,4,9,0.878909100097767,-10.9703206525479,65,65,0,2
165891,9to4,9,4,0.957537111072217,-8.35273758710149,31,31,0,3
165906,4to9,4,9,0.878909100097767,-10.9703206525479,30,30,0,2
165923,9to8,9,8,0.042327305421139,-11.47166966968,384,384,0,3
165939,8to3,8,3,0.227014077405999,-4.11464622477799,94,94,0,4
165955,3to4,3,4,0.976578311614922,-4.3200135082935,64,64,0,3
165971,4to9,4,9,0.878909100097767,-10.9703206525479,65,65,0,2
165987,9to4,9,4,0.957537111072217,-8.35273758710149,32,32,0,3
166003,4to9,4,9,0.878909100097767,-10.9703206525479,32,32,0,2
166019,9to4,9,4,0.957537111072217,-8.35273758710149,32,32,0,3
166034,4to9,4,9,0.878909100097767,-10.9703206525479,31,31,0,2
166049,9to4,9,4,0.957537111072217,-8.35273758710149,30,30,0,3
166064,4to3,4,3,0.121090899902233,-12.952460629608,125,125,0,2
166081,3to4,3,4,0.976578311614922,-4.3200135082935,32,32,0,3
166096,4to9,4,9,0.878909100097767,-10.9703206525479,62,62,0,2
166112,9to4,9,4,0.957537111072217,-8.35273758710149,31,31,0,3
166128,4to9,4,9,0.878909100097767,-10.9703206525479,32,32,0,2
166144,9to4,9,4,0.957537111072217,-8.35273758710149,32,32,0,3
166160,4to9,4,9,0.878909100097767,-10.9703206525479,32,32,0,2
166174,9to4,9,4,0.957537111072217,-8.35273758710149,30,30,0,3
166190,4to3,4,3,0.121090899902233,-12.952460629608,126,126,0,2
166206,3to4,3,4,0.976578311614922,-4.3200135082935,32,32,0,3
166222,4to9,4,9,0.878909100097767,-10.9703206525479,62,62,0,2
166237,9to4,9,4,0.957537111072217,-8.35273758710149,31,31,0,3
166254,4to9,4,9,0.878909100097767,-10.9703206525479,32,32,0,2
166271,9to4,9,4,0.957537111072217,-8.35273758710149,34,34,0,3
166288,4to3,4,3,0.121090899902233,-12.952460629608,98,98,0,2
166304,3to4,3,4,0.976578311614922,-4.3200135082935,33,33,0,3
166320,4to9,4,9,0.878909100097767,-10.9703206525479,66,66,0,2
166336,9to8,9,8,0.042327305421139,-11.47166966968,413,413,0,3
166352,8to9,8,9,0.769052262769502,-2.89449932615566,32,32,0,4
166369,9to4,9,4,0.957537111072217,-8.35273758710149,65,65,0,3
166385,4to9,4,9,0.878909100097767,-10.9703206525479,33,33,0,2
166401,9to4,9,4,0.957537111072217,-8.35273758710149,32,32,0,3
166416,4to9,4,9,0.878909100097767,-10.9703206525479,31,31,0,2
166432,9to4,9,4,0.957537111072217,-8.35273758710149,31,31,0,3
166447,4to3,4,3,0.121090899902233,-12.952460629608,159,159,0,2
166464,3to8,3,8,0.022742608734262,-8.07982824981408,128,128,0,3
166480,8to9,8,9,0.769052262769502,-2.89449932615566,64,64,0,4
166496,9to4,9,4,0.957537111072217,-8.35273758710149,64,64,0,3
166511,4to9,4,9,0.878909100097767,-10.9703206525479,31,31,0,2
166528,9to4,9,4,0.957537111072217,-8.35273758710149,32,32,0,3
166545,4to9,4,9,0.878909100097767,-10.9703206525479,34,34,0,2
166561,9to4,9,4,0.957537111072217,-8.35273758710149,33,33,0,3
166578,4to3,4,3,0.121090899902233,-12.952460629608,131,131,0,2
166592,3to4,3,4,0.976578311614922,-4.3200135082935,31,31,0,3
166607,4to9,4,9,0.878909100097767,-10.9703206525479,62,62,0,2
166623,9to4,9,4,0.957537111072217,-8.35273758710149,31,31,0,3
166638,4to9,4,9,0.878909100097767,-10.9703206525479,31,31,0,2
166655,9to4,9,4,0.957537111072217,-8.35273758710149,32,32,0,3
166670,4to9,4,9,0.878909100097767,-10.9703206525479,32,32,0,2
166686,9to4,9,4,0.957537111072217,-8.35273758710149,31,31,0,3
166701,4to9,4,9,0.878909100097767,-10.9703206525479,31,31,0,2
166716,9to4,9,4,0.957537111072217,-8.35273758710149,30,30,0,3
166731,4to3,4,3,0.121090899902233,-12.952460629608,153,153,0,2
166746,3to4,3,4,0.976578311614922,-4.3200135082935,30,30,0,3
166763,4to9,4,9,0.878909100097767,-10.9703206525479,62,62,0,2
166778,9to4,9,4,0.957537111072217,-8.35273758710149,32,32,0,3
166793,4to9,4,9,0.878909100097767,-10.9703206525479,30,30,0,2
166808,9to4,9,4,0.957537111072217,-8.35273758710149,30,30,0,3
166825,4to9,4,9,0.878909100097767,-10.9703206525479,32,32,0,2
166840,9to4,9,4,0.957537111072217,-8.35273758710149,32,32,0,3
166855,4to3,4,3,0.121090899902233,-12.952460629608,124,124,0,2
166872,3to4,3,4,0.976578311614922,-4.3200135082935,32,32,0,3
166889,4to9,4,9,0.878909100097767,-10.9703206525479,64,64,0,2
166904,9to8,9,8,0.042327305421139,-11.47166966968,440,440,0,3
166920,8to9,8,9,0.769052262769502,-2.89449932615566,31,31,0,4
166936,9to4,9,4,0.957537111072217,-8.35273758710149,64,64,0,3
166951,4to9,4,9,0.878909100097767,-10.9703206525479,31,31,0,2
166967,9to4,9,4,0.957537111072217,-8.35273758710149,31,31,0,3
166982,4to9,4,9,0.878909100097767,-10.9703206525479,31,31,0,2
166997,9to4,9,4,0.957537111072217,-8.35273758710149,30,30,0,3
167013,4to3,4,3,0.121090899902233,-12.952460629608,158,158,0,2
167027,3to4,3,4,0.976578311614922,-4.3200135082935,30,30,0,3
167043,4to9,4,9,0.878909100097767,-10.9703206525479,61,61,0,2
167059,9to4,9,4,0.957537111072217,-8.35273758710149,32,32,0,3
167077,4to9,4,9,0.878909100097767,-10.9703206525479,34,34,0,2
167093,9to4,9,4,0.957537111072217,-8.35273758710149,34,34,0,3
167107,4to9,4,9,0.878909100097767,-10.9703206525479,30,30,0,2
167121,9to4,9,4,0.957537111072217,-8.35273758710149,28,28,0,3
167135,4to3,4,3,0.121090899902233,-12.952460629608,122,122,0,2
167151,3to2,3,2,0.000679079650815,-11.5910853038632,2594,2594,0,3
167167,2to3,2,3,0.998311213496016,-3.95697141540815,32,32,0,3
167185,3to4,3,4,0.976578311614922,-4.3200135082935,64,64,0,3
167203,4to9,4,9,0.878909100097767,-10.9703206525479,96,96,0,2
167218,9to4,9,4,0.957537111072217,-8.35273758710149,33,33,0,3
167232,4to9,4,9,0.878909100097767,-10.9703206525479,29,29,0,2
167248,9to8,9,8,0.042327305421139,-11.47166966968,344,344,0,3
167264,8to3,8,3,0.227014077405999,-4.11464622477799,97,97,0,4
167279,3to4,3,4,0.976578311614922,-4.3200135082935,61,61,0,3
167295,4to9,4,9,0.878909100097767,-10.9703206525479,63,63,0,2
167311,9to4,9,4,0.957537111072217,-8.35273758710149,32,32,0,3
167326,4to9,4,9,0.878909100097767,-10.9703206525479,31,31,0,2
167341,9to4,9,4,0.957537111072217,-8.35273758710149,30,30,0,3
167357,4to9,4,9,0.878909100097767,-10.9703206525479,31,31,0,2
167372,9to4,9,4,0.957537111072217,-8.35273758710149,31,31,0,3
167388,4to9,4,9,0.878909100097767,-10.9703206525479,31,31,0,2
167403,9to4,9,4,0.957537111072217,-8.35273758710149,31,31,0,3
167420,4to3,4,3,0.121090899902233,-12.952460629608,156,156,0,2
167434,3to4,3,4,0.976578311614922,-4.3200135082935,31,31,0,3
167450,4to9,4,9,0.878909100097767,-10.9703206525479,62,62,0,2
167466,9to4,9,4,0.957537111072217,-8.35273758710149,32,32,0,3
167482,4to9,4,9,0.878909100097767,-10.9703206525479,32,32,0,2
167496,9to4,9,4,0.957537111072217,-8.35273758710149,30,30,0,3
167511,4to9,4,9,0.878909100097767,-10.9703206525479,29,29,0,2
167525,9to4,9,4,0.957537111072217,-8.35273758710149,29,29,0,3
167540,4to3,4,3,0.121090899902233,-12.952460629608,120,120,0,2
167556,3to4,3,4,0.976578311614922,-4.3200135082935,31,31,0,3
167573,4to3,4,3,0.121090899902233,-12.952460629608,33,33,0,2
167589,3to4,3,4,0.976578311614922,-4.3200135082935,33,33,0,3
167604,4to3,4,3,0.121090899902233,-12.952460629608,31,31,0,2
167619,3to4,3,4,0.976578311614922,-4.3200135082935,30,30,0,3
167637,4to9,4,9,0.878909100097767,-10.9703206525479,126,126,0,2
167653,9to4,9,4,0.957537111072217,-8.35273758710149,34,34,0,3
167670,4to9,4,9,0.878909100097767,-10.9703206525479,33,33,0,2
167686,9to8,9,8,0.042327305421139,-11.47166966968,438,438,0,3
167701,8to3,8,3,0.227014077405999,-4.11464622477799,97,97,0,4
167718,3to4,3,4,0.976578311614922,-4.3200135082935,65,65,0,3
167735,4to3,4,3,0.121090899902233,-12.952460629608,34,34,0,2
167750,3to8,3,8,0.022742608734262,-8.07982824981408,64,64,0,3
167767,8to9,8,9,0.769052262769502,-2.89449932615566,97,97,0,4
167783,9to4,9,4,0.957537111072217,-8.35273758710149,65,65,0,3
167799,4to9,4,9,0.878909100097767,-10.9703206525479,32,32,0,2
167816,9to4,9,4,0.957537111072217,-8.35273758710149,33,33,0,3
167832,4to9,4,9,0.878909100097767,-10.9703206525479,33,33,0,2
167847,9to4,9,4,0.957537111072217,-8.35273758710149,31,31,0,3
167863,4to3,4,3,0.121090899902233,-12.952460629608,128,128,0,2
167878,3to4,3,4,0.976578311614922,-4.3200135082935,31,31,0,3
167894,4to9,4,9,0.878909100097767,-10.9703206525479,62,62,0,2
167910,9to4,9,4,0.957537111072217,-8.35273758710149,32,32,0,3
167924,4to9,4,9,0.878909100097767,-10.9703206525479,30,30,0,2
167940,9to4,9,4,0.957537111072217,-8.35273758710149,30,30,0,3
167956,4to9,4,9,0.878909100097767,-10.9703206525479,32,32,0,2
167972,9to4,9,4,0.957537111072217,-8.35273758710149,32,32,0,3
167988,4to9,4,9,0.878909100097767,-10.9703206525479,32,32,0,2
168003,9to4,9,4,0.957537111072217,-8.35273758710149,31,31,0,3
168019,4to3,4,3,0.121090899902233,-12.952460629608,156,156,0,2
168036,3to4,3,4,0.976578311614922,-4.3200135082935,33,33,0,3
168052,4to9,4,9,0.878909100097767,-10.9703206525479,64,64,0,2
168068,9to4,9,4,0.957537111072217,-8.35273758710149,32,32,0,3
168085,4to9,4,9,0.878909100097767,-10.9703206525479,33,33,0,2
168100,9to4,9,4,0.957537111072217,-8.35273758710149,32,32,0,3
168116,4to9,4,9,0.878909100097767,-10.9703206525479,31,31,0,2
168133,9to8,9,8,0.042327305421139,-11.47166966968,383,383,0,3
168149,8to3,8,3,0.227014077405999,-4.11464622477799,130,130,0,4
168165,3to4,3,4,0.976578311614922,-4.3200135082935,65,65,0,3
168182,4to9,4,9,0.878909100097767,-10.9703206525479,66,66,0,2
168198,9to4,9,4,0.957537111072217,-8.35273758710149,33,33,0,3
168214,4to9,4,9,0.878909100097767,-10.9703206525479,32,32,0,2
168230,9to4,9,4,0.957537111072217,-8.35273758710149,32,32,0,3
168246,4to9,4,9,0.878909100097767,-10.9703206525479,32,32,0,2
168261,9to4,9,4,0.957537111072217,-8.35273758710149,31,31,0,3
168278,4to3,4,3,0.121090899902233,-12.952460629608,129,129,0,2
168292,3to4,3,4,0.976578311614922,-4.3200135082935,31,31,0,3
168309,4to9,4,9,0.878909100097767,-10.9703206525479,63,63,0,2
168327,9to14,9,14,0.000135583506644,-17.2152696089966,3202,3202,0,3
168343,14to13,14,13,0.018652228020056,-9.09371951571432,3202,3202,0,3
168360,13to8,13,8,0.917351022044606,-7.37455157477482,227,227,0,4
168377,8to9,8,9,0.769052262769502,-2.89449932615566,68,68,0,4
168392,9to4,9,4,0.957537111072217,-8.35273758710149,100,100,0,3
168409,4to3,4,3,0.121090899902233,-12.952460629608,131,131,0,2
168425,3to4,3,4,0.976578311614922,-4.3200135082935,33,33,0,3
168443,4to9,4,9,0.878909100097767,-10.9703206525479,66,66,0,2
168458,9to4,9,4,0.957537111072217,-8.35273758710149,33,33,0,3
168474,4to9,4,9,0.878909100097767,-10.9703206525479,31,31,0,2
168490,9to4,9,4,0.957537111072217,-8.35273758710149,32,32,0,3
168506,4to9,4,9,0.878909100097767,-10.9703206525479,32,32,0,2
168521,9to4,9,4,0.957537111072217,-8.35273758710149,31,31,0,3
168537,4to3,4,3,0.121090899902233,-12.952460629608,128,128,0,2
168553,3to4,3,4,0.976578311614922,-4.3200135082935,32,32,0,3
168570,4to9,4,9,0.878909100097767,-10.9703206525479,64,64,0,2
168585,9to4,9,4,0.957537111072217,-8.35273758710149,32,32,0,3
168602,4to9,4,9,0.878909100097767,-10.9703206525479,32,32,0,2
168619,9to4,9,4,0.957537111072217,-8.35273758710149,34,34,0,3
168635,4to9,4,9,0.878909100097767,-10.9703206525479,33,33,0,2
168652,9to4,9,4,0.957537111072217,-8.35273758710149,33,33,0,3
168668,4to9,4,9,0.878909100097767,-10.9703206525479,33,33,0,2
168682,9to4,9,4,0.957537111072217,-8.35273758710149,30,30,0,3
168698,4to3,4,3,0.121090899902233,-12.952460629608,161,161,0,2
168713,3to4,3,4,0.976578311614922,-4.3200135082935,31,31,0,3
168729,4to9,4,9,0.878909100097767,-10.9703206525479,61,61,0,2
168745,9to8,9,8,0.042327305421139,-11.47166966968,385,385,0,3
168761,8to9,8,9,0.769052262769502,-2.89449932615566,32,32,0,4
168776,9to4,9,4,0.957537111072217,-8.35273758710149,63,63,0,3
168792,4to3,4,3,0.121090899902233,-12.952460629608,94,94,0,2
168808,3to4,3,4,0.976578311614922,-4.3200135082935,32,32,0,3
168823,4to9,4,9,0.878909100097767,-10.9703206525479,62,62,0,2
168838,9to4,9,4,0.957537111072217,-8.35273758710149,30,30,0,3
168853,4to9,4,9,0.878909100097767,-10.9703206525479,30,30,0,2
168867,9to8,9,8,0.042327305421139,-11.47166966968,122,122,0,3
168883,8to3,8,3,0.227014077405999,-4.11464622477799,91,91,0,4
168899,3to4,3,4,0.976578311614922,-4.3200135082935,61,61,0,3
168915,4to9,4,9,0.878909100097767,-10.9703206525479,62,62,0,2
168931,9to4,9,4,0.957537111072217,-8.35273758710149,32,32,0,3
168946,4to9,4,9,0.878909100097767,-10.9703206525479,31,31,0,2
168962,9to4,9,4,0.957537111072217,-8.35273758710149,31,31,0,3
168979,4to9,4,9,0.878909100097767,-10.9703206525479,33,33,0,2
168995,9to4,9,4,0.957537111072217,-8.35273758710149,33,33,0,3
169010,4to9,4,9,0.878909100097767,-10.9703206525479,31,31,0,2
169025,9to4,9,4,0.957537111072217,-8.35273758710149,30,30,0,3
169041,4to3,4,3,0.121090899902233,-12.952460629608,158,158,0,2
169056,3to4,3,4,0.976578311614922,-4.3200135082935,31,31,0,3
169072,4to9,4,9,0.878909100097767,-10.9703206525479,62,62,0,2
169089,9to14,9,14,0.000135583506644,-17.2152696089966,762,762,0,3
169104,14to9,14,9,0.981341937753484,-5.13076416031772,32,32,0,3
169120,9to4,9,4,0.957537111072217,-8.35273758710149,64,64,0,3
169134,4to9,4,9,0.878909100097767,-10.9703206525479,30,30,0,2
169148,9to4,9,4,0.957537111072217,-8.35273758710149,28,28,0,3
169164,4to9,4,9,0.878909100097767,-10.9703206525479,30,30,0,2
169180,9to4,9,4,0.957537111072217,-8.35273758710149,32,32,0,3
169195,4to3,4,3,0.121090899902233,-12.952460629608,154,154,0,2
169210,3to4,3,4,0.976578311614922,-4.3200135082935,30,30,0,3
169226,4to9,4,9,0.878909100097767,-10.9703206525479,62,62,0,2
169243,9to4,9,4,0.957537111072217,-8.35273758710149,33,33,0,3
169260,4to9,4,9,0.878909100097767,-10.9703206525479,34,34,0,2
169277,9to8,9,8,0.042327305421139,-11.47166966968,410,410,0,3
169293,8to3,8,3,0.227014077405999,-4.11464622477799,98,98,0,4
169309,3to4,3,4,0.976578311614922,-4.3200135082935,66,66,0,3
169325,4to9,4,9,0.878909100097767,-10.9703206525479,65,65,0,2
169340,9to4,9,4,0.957537111072217,-8.35273758710149,31,31,0,3
169357,4to9,4,9,0.878909100097767,-10.9703206525479,32,32,0,2
169373,9to4,9,4,0.957537111072217,-8.35273758710149,33,33,0,3
169390,4to9,4,9,0.878909100097767,-10.9703206525479,33,33,0,2
169406,9to4,9,4,0.957537111072217,-8.35273758710149,33,33,0,3
169421,4to9,4,9,0.878909100097767,-10.9703206525479,31,31,0,2
169437,9to4,9,4,0.957537111072217,-8.35273758710149,31,31,0,3
169453,4to3,4,3,0.121090899902233,-12.952460629608,160,160,0,2
169468,3to4,3,4,0.976578311614922,-4.3200135082935,31,31,0,3
169485,4to9,4,9,0.878909100097767,-10.9703206525479,64,64,0,2
169501,9to4,9,4,0.957537111072217,-8.35273758710149,33,33,0,3
169516,4to9,4,9,0.878909100097767,-10.9703206525479,31,31,0,2
169532,9to4,9,4,0.957537111072217,-8.35273758710149,31,31,0,3
169548,4to9,4,9,0.878909100097767,-10.9703206525479,32,32,0,2
169562,9to4,9,4,0.957537111072217,-8.35273758710149,30,30,0,3
169578,4to3,4,3,0.121090899902233,-12.952460629608,125,125,0,2
169593,3to4,3,4,0.976578311614922,-4.3200135082935,31,31,0,3
169607,4to3,4,3,0.121090899902233,-12.952460629608,29,29,0,2
169623,3to4,3,4,0.976578311614922,-4.3200135082935,30,30,0,3
169640,4to3,4,3,0.121090899902233,-12.952460629608,33,33,0,2
169655,3to4,3,4,0.976578311614922,-4.3200135082935,32,32,0,3
169672,4to9,4,9,0.878909100097767,-10.9703206525479,124,124,0,2
169687,9to8,9,8,0.01682610997853,-12.4204501574849,410,21,389,3
169703,8to9,8,9,0.769052262769502,-2.89449932615566,31,31,0,4
169719,9to4,9,4,0.983034696156588,-8.35273758710149,64,64,0,3
169735,4to9,4,9,0.824138229288382,-11.4078206525479,32,18,14,2
169749,9to4,9,4,0.972333434093129,-8.85273758710149,30,15,15,3
169765,4to3,4,3,0.08251622334334,-13.816460629608,125,17,108,2
169781,3to8,3,8,0.020071682343829,-8.20748782428216,94,82,12,3
169799,8to9,8,9,0.769052262769502,-2.89449932615566,64,64,0,4
169816,9to4,9,4,0.972333434093129,-8.85273758710149,67,67,0,3
169831,4to3,4,3,0.08251622334334,-13.816460629608,66,66,0,2
169847,3to4,3,4,0.979247382023731,-4.3200135082935,31,31,0,3
169864,4to9,4,9,0.91748377665666,-11.4078206525479,65,65,0,2
169880,9to4,9,4,0.972333434093129,-8.85273758710149,33,33,0,3
169898,4to9,4,9,0.91748377665666,-11.4078206525479,34,34,0,2
169915,9to4,9,4,0.972333434093129,-8.85273758710149,35,35,0,3
169932,4to9,4,9,0.91748377665666,-11.4078206525479,34,34,0,2
169946,9to4,9,4,0.972333434093129,-8.85273758710149,31,31,0,3
169961,4to9,4,9,0.91748377665666,-11.4078206525479,29,29,0,2
169976,9to4,9,4,0.972333434093129,-8.85273758710149,30,30,0,3
169994,4to9,4,9,0.91748377665666,-11.4078206525479,33,33,0,2
170011,9to4,9,4,0.972333434093129,-8.85273758710149,35,35,0,3
170025,4to9,4,9,0.91748377665666,-11.4078206525479,31,31,0,2
170041,9to4,9,4,0.972333434093129,-8.85273758710149,30,30,0,3
170057,4to3,4,3,0.08251622334334,-13.816460629608,226,226,0,2
170073,3to4,3,4,0.979247382023731,-4.3200135082935,32,32,0,3
170089,4to9,4,9,0.91748377665666,-11.4078206525479,64,64,0,2
170105,9to4,9,4,0.972333434093129,-8.85273758710149,32,32,0,3
170121,4to9,4,9,0.91748377665666,-11.4078206525479,32,32,0,2
170137,9to4,9,4,0.972333434093129,-8.85273758710149,32,32,0,3
170151,4to9,4,9,0.91748377665666,-11.4078206525479,30,30,0,2
170166,9to4,9,4,0.972333434093129,-8.85273758710149,29,29,0,3
170181,4to9,4,9,0.91748377665666,-11.4078206525479,30,30,0,2
170195,9to4,9,4,0.972333434093129,-8.85273758710149,29,29,0,3
170211,4to9,4,9,0.91748377665666,-11.4078206525479,30,30,0,2
170226,9to4,9,4,0.972333434093129,-8.85273758710149,31,31,0,3
170242,4to3,4,3,0.08251622334334,-13.816460629608,185,185,0,2
170257,3to4,3,4,0.979247382023731,-4.3200135082935,31,31,0,3
170274,4to9,4,9,0.91748377665666,-11.4078206525479,63,63,0,2
170288,9to4,9,4,0.972333434093129,-8.85273758710149,31,31,0,3
170303,4to9,4,9,0.91748377665666,-11.4078206525479,29,29,0,2
170318,9to4,9,4,0.972333434093129,-8.85273758710149,30,30,0,3
170334,4to9,4,9,0.91748377665666,-11.4078206525479,31,31,0,2
170350,9to4,9,4,0.972333434093129,-8.85273758710149,32,32,0,3
170365,4to9,4,9,0.91748377665666,-11.4078206525479,31,31,0,2
170381,9to8,9,8,0.027439572257236,-12.4204501574849,600,600,0,3
170398,8to3,8,3,0.227014077405999,-4.11464622477799,156,156,0,4
170414,3to4,3,4,0.979247382023731,-4.3200135082935,64,64,0,3
170431,4to9,4,9,0.91748377665666,-11.4078206525479,66,66,0,2
170446,9to14,9,14,0.000226993649635,-17.2152696089966,1357,1357,0,3
170463,14to13,14,13,0.010156120198875,-9.71022894967659,2120,813,1307,3
170479,13to12,13,12,0.011456026712297,-11.7575258257807,9598,9598,0,4
170495,12to7,12,7,0.008183917437684,-11.1543842566717,5955,812,5143,4
170512,7to2,7,2,0.034140725114518,-5.70017716512867,3361,748,2613,4
170528,2to3,2,3,0.998311213496016,-3.95697141540815,130,130,0,3
170544,3to4,3,4,0.979247382023731,-4.3200135082935,130,130,0,3
170560,4to9,4,9,0.91748377665666,-11.4078206525479,129,129,0,2
170575,9to4,9,4,0.972333434093129,-8.85273758710149,31,31,0,3
170589,4to9,4,9,0.91748377665666,-11.4078206525479,29,29,0,2
170605,9to4,9,4,0.972333434093129,-8.85273758710149,30,30,0,3
170621,4to9,4,9,0.91748377665666,-11.4078206525479,32,32,0,2
170635,9to4,9,4,0.972333434093129,-8.85273758710149,30,30,0,3
170652,4to9,4,9,0.91748377665666,-11.4078206525479,31,31,0,2
170666,9to4,9,4,0.972333434093129,-8.85273758710149,31,31,0,3
170683,4to9,4,9,0.91748377665666,-11.4078206525479,31,31,0,2
170700,9to4,9,4,0.972333434093129,-8.85273758710149,34,34,0,3
170715,4to9,4,9,0.91748377665666,-11.4078206525479,32,32,0,2
170730,9to4,9,4,0.972333434093129,-8.85273758710149,30,30,0,3
170744,4to3,4,3,0.08251622334334,-13.816460629608,216,216,0,2
170760,3to4,3,4,0.979247382023731,-4.3200135082935,30,30,0,3
170775,4to9,4,9,0.91748377665666,-11.4078206525479,60,60,0,2
170790,9to4,9,4,0.972333434093129,-8.85273758710149,30,30,0,3
170806,4to9,4,9,0.91748377665666,-11.4078206525479,31,31,0,2
170820,9to4,9,4,0.972333434093129,-8.85273758710149,30,30,0,3
170836,4to9,4,9,0.91748377665666,-11.4078206525479,30,30,0,2
170851,9to4,9,4,0.972333434093129,-8.85273758710149,31,31,0,3
170867,4to9,4,9,0.91748377665666,-11.4078206525479,31,31,0,2
170882,9to4,9,4,0.972333434093129,-8.85273758710149,31,31,0,3
170896,4to9,4,9,0.91748377665666,-11.4078206525479,29,29,0,2
170914,9to8,9,8,0.027439572257236,-12.4204501574849,533,533,0,3
170930,8to3,8,3,0.227014077405999,-4.11464622477799,186,186,0,4
170947,3to4,3,4,0.979247382023731,-4.3200135082935,65,65,0,3
170963,4to9,4,9,0.91748377665666,-11.4078206525479,67,67,0,2
170977,9to4,9,4,0.972333434093129,-8.85273758710149,30,30,0,3
170993,4to9,4,9,0.91748377665666,-11.4078206525479,30,30,0,2
171009,9to4,9,4,0.972333434093129,-8.85273758710149,32,32,0,3
171026,4to9,4,9,0.91748377665666,-11.4078206525479,33,33,0,2
171042,9to4,9,4,0.972333434093129,-8.85273758710149,33,33,0,3
171058,4to9,4,9,0.91748377665666,-11.4078206525479,32,32,0,2
171074,9to4,9,4,0.972333434093129,-8.85273758710149,32,32,0,3
171090,4to9,4,9,0.91748377665666,-11.4078206525479,32,32,0,2
171105,9to4,9,4,0.972333434093129,-8.85273758710149,31,31,0,3
171121,4to3,4,3,0.08251622334334,-13.816460629608,191,191,0,2
171136,3to4,3,4,0.979247382023731,-4.3200135082935,31,31,0,3
171152,4to9,4,9,0.91748377665666,-11.4078206525479,62,62,0,2
171167,9to4,9,4,0.972333434093129,-8.85273758710149,31,31,0,3
171182,4to9,4,9,0.91748377665666,-11.4078206525479,30,30,0,2
171198,9to4,9,4,0.972333434093129,-8.85273758710149,31,31,0,3
171214,4to9,4,9,0.91748377665666,-11.4078206525479,32,32,0,2
171230,9to4,9,4,0.972333434093129,-8.85273758710149,32,32,0,3
171246,4to9,4,9,0.91748377665666,-11.4078206525479,32,32,0,2
171263,9to4,9,4,0.972333434093129,-8.85273758710149,33,33,0,3
171279,4to9,4,9,0.91748377665666,-11.4078206525479,33,33,0,2
171294,9to4,9,4,0.972333434093129,-8.85273758710149,31,31,0,3
171310,4to3,4,3,0.08251622334334,-13.816460629608,189,189,0,2
171324,3to4,3,4,0.979247382023731,-4.3200135082935,30,30,0,3
171340,4to9,4,9,0.91748377665666,-11.4078206525479,61,61,0,2
171355,9to4,9,4,0.972333434093129,-8.85273758710149,31,31,0,3
171371,4to9,4,9,0.91748377665666,-11.4078206525479,31,31,0,2
171387,9to4,9,4,0.972333434093129,-8.85273758710149,32,32,0,3
171403,4to9,4,9,0.91748377665666,-11.4078206525479,32,32,0,2
171419,9to4,9,4,0.972333434093129,-8.85273758710149,32,32,0,3
171434,4to9,4,9,0.91748377665666,-11.4078206525479,31,31,0,2
171449,9to4,9,4,0.972333434093129,-8.85273758710149,30,30,0,3
171465,4to9,4,9,0.91748377665666,-11.4078206525479,31,31,0,2
171480,9to4,9,4,0.972333434093129,-8.85273758710149,31,31,0,3
171496,4to3,4,3,0.08251622334334,-13.816460629608,186,186,0,2
171511,3to4,3,4,0.979247382023731,-4.3200135082935,31,31,0,3
171526,4to9,4,9,0.91748377665666,-11.4078206525479,61,61,0,2
171543,9to8,9,8,0.027439572257236,-12.4204501574849,629,629,0,3
171560,8to9,8,9,0.769052262769502,-2.89449932615566,34,34,0,4
171576,9to4,9,4,0.972333434093129,-8.85273758710149,65,65,0,3
171593,4to9,4,9,0.91748377665666,-11.4078206525479,33,33,0,2
171607,9to4,9,4,0.972333434093129,-8.85273758710149,31,31,0,3
171624,4to9,4,9,0.91748377665666,-11.4078206525479,31,31,0,2
171640,9to4,9,4,0.972333434093129,-8.85273758710149,33,33,0,3
171657,4to9,4,9,0.91748377665666,-11.4078206525479,33,33,0,2
171672,9to14,9,14,0.000226993649635,-17.2152696089966,1226,1226,0,3
171687,14to9,14,9,0.989837995064316,-5.13076416031772,30,30,0,3
171703,9to4,9,4,0.972333434093129,-8.85273758710149,63,63,0,3
171719,4to3,4,3,0.08251622334334,-13.816460629608,223,223,0,2
171735,3to4,3,4,0.979247382023731,-4.3200135082935,32,32,0,3
171749,4to9,4,9,0.91748377665666,-11.4078206525479,62,62,0,2
171764,9to4,9,4,0.972333434093129,-8.85273758710149,29,29,0,3
171779,4to3,4,3,0.08251622334334,-13.816460629608,60,60,0,2
171794,3to4,3,4,0.979247382023731,-4.3200135082935,30,30,0,3
171812,4to9,4,9,0.91748377665666,-11.4078206525479,63,63,0,2
171827,9to4,9,4,0.972333434093129,-8.85273758710149,33,33,0,3
171842,4to9,4,9,0.91748377665666,-11.4078206525479,30,30,0,2
171858,9to4,9,4,0.972333434093129,-8.85273758710149,31,31,0,3
171874,4to3,4,3,0.08251622334334,-13.816460629608,95,95,0,2
171889,3to4,3,4,0.979247382023731,-4.3200135082935,31,31,0,3
171905,4to9,4,9,0.91748377665666,-11.4078206525479,63,63,0,2
171921,9to4,9,4,0.972333434093129,-8.85273758710149,32,32,0,3
171937,4to9,4,9,0.91748377665666,-11.4078206525479,32,32,0,2
171952,9to4,9,4,0.972333434093129,-8.85273758710149,31,31,0,3
171967,4to9,4,9,0.91748377665666,-11.4078206525479,30,30,0,2
171984,9to4,9,4,0.972333434093129,-8.85273758710149,32,32,0,3
172001,4to9,4,9,0.91748377665666,-11.4078206525479,34,34,0,2
172017,9to4,9,4,0.972333434093129,-8.85273758710149,33,33,0,3
172033,4to9,4,9,0.91748377665666,-11.4078206525479,32,32,0,2
172050,9to4,9,4,0.972333434093129,-8.85273758710149,33,33,0,3
172065,4to9,4,9,0.91748377665666,-11.4078206525479,32,32,0,2
172079,9to4,9,4,0.972333434093129,-8.85273758710149,29,29,0,3
172096,4to3,4,3,0.08251622334334,-13.816460629608,222,222,0,2
172110,3to4,3,4,0.979247382023731,-4.3200135082935,31,31,0,3
172125,4to9,4,9,0.91748377665666,-11.4078206525479,60,60,0,2
172141,9to8,9,8,0.027439572257236,-12.4204501574849,598,598,0,3
172158,8to9,8,9,0.769052262769502,-2.89449932615566,33,33,0,4
172174,9to4,9,4,0.972333434093129,-8.85273758710149,64,64,0,3
172190,4to3,4,3,0.08251622334334,-13.816460629608,94,94,0,2
172206,3to4,3,4,0.979247382023731,-4.3200135082935,32,32,0,3
172222,4to9,4,9,0.91748377665666,-11.4078206525479,64,64,0,2
172238,9to4,9,4,0.972333434093129,-8.85273758710149,32,32,0,3
172254,4to9,4,9,0.91748377665666,-11.4078206525479,32,32,0,2
172270,9to4,9,4,0.972333434093129,-8.85273758710149,32,32,0,3
172286,4to9,4,9,0.91748377665666,-11.4078206525479,32,32,0,2
172301,9to4,9,4,0.972333434093129,-8.85273758710149,31,31,0,3
172316,4to9,4,9,0.91748377665666,-11.4078206525479,30,30,0,2
172331,9to4,9,4,0.972333434093129,-8.85273758710149,30,30,0,3
172348,4to9,4,9,0.91748377665666,-11.4078206525479,32,32,0,2
172363,9to14,9,14,0.000226993649635,-17.2152696089966,691,691,0,3
172380,14to13,14,13,0.005822171594397,-10.2710009893219,1917,842,1075,3
172397,13to8,13,8,0.917351022044606,-7.37455157477482,256,256,0,4
172414,8to3,8,3,0.227014077405999,-4.11464622477799,224,224,0,4
172431,3to4,3,4,0.979247382023731,-4.3200135082935,100,100,0,3
172448,4to9,4,9,0.91748377665666,-11.4078206525479,100,100,0,2
172463,9to4,9,4,0.972333434093129,-8.85273758710149,32,32,0,3
172478,4to9,4,9,0.91748377665666,-11.4078206525479,30,30,0,2
172494,9to4,9,4,0.972333434093129,-8.85273758710149,31,31,0,3
172509,4to9,4,9,0.91748377665666,-11.4078206525479,31,31,0,2
172527,9to4,9,4,0.972333434093129,-8.85273758710149,33,33,0,3
172543,4to9,4,9,0.91748377665666,-11.4078206525479,34,34,0,2
172560,9to14,9,14,0.000226993649635,-17.2152696089966,197,197,0,3
172576,14to9,14,9,0.994171917902967,-5.13076416031772,33,33,0,3
172593,9to4,9,4,0.972333434093129,-8.85273758710149,66,66,0,3
172610,4to9,4,9,0.91748377665666,-11.4078206525479,34,34,0,2
172625,9to4,9,4,0.972333434093129,-8.85273758710149,32,32,0,3
172639,4to3,4,3,0.08251622334334,-13.816460629608,225,225,0,2
172655,3to4,3,4,0.979247382023731,-4.3200135082935,30,30,0,3
172671,4to9,4,9,0.91748377665666,-11.4078206525479,61,61,0,2
172687,9to4,9,4,0.972333434093129,-8.85273758710149,32,32,0,3
172703,4to9,4,9,0.91748377665666,-11.4078206525479,32,32,0,2
172720,9to8,9,8,0.027439572257236,-12.4204501574849,323,323,0,3
172737,8to3,8,3,0.227014077405999,-4.11464622477799,98,98,0,4
172752,3to2,3,2,0.00068093563244,-11.5910853038632,2240,2240,0,3
172769,2to1,2,1,0.000129347470453,-12.9084262237429,10731,2987,7744,3
172784,1to6,1,6,0.047602568284952,-9.95055180143388,10762,2985,7777,3
172801,6to7,6,7,0.811310473476567,-5.21442897770946,2306,2306,0,4
172818,7to12,7,12,0.021860378356319,-6.15866584618918,2339,1264,1075,4
172834,12to13,12,13,0.98625505370986,-6.36264020069652,454,454,0,4
172850,13to8,13,8,0.917351022044606,-7.37455157477482,130,130,0,4
172867,8to9,8,9,0.769052262769502,-2.89449932615566,164,164,0,4
172884,9to4,9,4,0.972333434093129,-8.85273758710149,197,197,0,3
172900,4to3,4,3,0.08251622334334,-13.816460629608,163,163,0,2
172914,3to4,3,4,0.979247382023731,-4.3200135082935,30,30,0,3
172929,4to9,4,9,0.91748377665666,-11.4078206525479,62,62,0,2
172943,9to4,9,4,0.972333434093129,-8.85273758710149,29,29,0,3
172958,4to9,4,9,0.91748377665666,-11.4078206525479,29,29,0,2
172972,9to4,9,4,0.972333434093129,-8.85273758710149,29,29,0,3
172988,4to9,4,9,0.91748377665666,-11.4078206525479,30,30,0,2
173003,9to4,9,4,0.972333434093129,-8.85273758710149,31,31,0,3
173018,4to9,4,9,0.91748377665666,-11.4078206525479,30,30,0,2
173034,9to4,9,4,0.972333434093129,-8.85273758710149,31,31,0,3
173049,4to9,4,9,0.91748377665666,-11.4078206525479,31,31,0,2
173065,9to4,9,4,0.972333434093129,-8.85273758710149,31,31,0,3
173082,4to9,4,9,0.91748377665666,-11.4078206525479,33,33,0,2
173099,9to4,9,4,0.972333434093129,-8.85273758710149,34,34,0,3
173115,4to3,4,3,0.08251622334334,-13.816460629608,215,215,0,2
173131,3to8,3,8,0.020071682343829,-8.20748782428216,281,281,0,3
173147,8to9,8,9,0.769052262769502,-2.89449932615566,65,65,0,4
173161,9to4,9,4,0.972333434093129,-8.85273758710149,62,62,0,3
173176,4to9,4,9,0.91748377665666,-11.4078206525479,29,29,0,2
173193,9to4,9,4,0.972333434093129,-8.85273758710149,32,32,0,3
173210,4to3,4,3,0.08251622334334,-13.816460629608,95,95,0,2
173224,3to4,3,4,0.979247382023731,-4.3200135082935,31,31,0,3
173241,4to9,4,9,0.91748377665666,-11.4078206525479,65,65,0,2
173256,9to4,9,4,0.972333434093129,-8.85273758710149,32,32,0,3
173272,4to9,4,9,0.91748377665666,-11.4078206525479,31,31,0,2
173287,9to4,9,4,0.972333434093129,-8.85273758710149,31,31,0,3
173303,4to9,4,9,0.91748377665666,-11.4078206525479,31,31,0,2
173319,9to4,9,4,0.972333434093129,-8.85273758710149,32,32,0,3
173334,4to9,4,9,0.91748377665666,-11.4078206525479,31,31,0,2
173350,9to4,9,4,0.972333434093129,-8.85273758710149,31,31,0,3
173366,4to9,4,9,0.91748377665666,-11.4078206525479,32,32,0,2
173382,9to4,9,4,0.972333434093129,-8.85273758710149,32,32,0,3
173398,4to9,4,9,0.91748377665666,-11.4078206525479,32,32,0,2
173414,9to4,9,4,0.972333434093129,-8.85273758710149,32,32,0,3
173430,4to3,4,3,0.08251622334334,-13.816460629608,220,220,0,2
173446,3to4,3,4,0.979247382023731,-4.3200135082935,32,32,0,3
173462,4to9,4,9,0.91748377665666,-11.4078206525479,64,64,0,2
173479,9to4,9,4,0.972333434093129,-8.85273758710149,33,33,0,3
173495,4to9,4,9,0.91748377665666,-11.4078206525479,33,33,0,2
173509,9to4,9,4,0.972333434093129,-8.85273758710149,30,30,0,3
173525,4to9,4,9,0.91748377665666,-11.4078206525479,30,30,0,2
173541,9to4,9,4,0.972333434093129,-8.85273758710149,32,32,0,3
173556,4to9,4,9,0.91748377665666,-11.4078206525479,31,31,0,2
173572,9to4,9,4,0.972333434093129,-8.85273758710149,31,31,0,3
173587,4to9,4,9,0.91748377665666,-11.4078206525479,31,31,0,2
173602,9to4,9,4,0.972333434093129,-8.85273758710149,30,30,0,3
173619,4to3,4,3,0.08251622334334,-13.816460629608,189,189,0,2
173635,3to4,3,4,0.979247382023731,-4.3200135082935,33,33,0,3
173652,4to9,4,9,0.91748377665666,-11.4078206525479,65,65,0,2
173668,9to4,9,4,0.972333434093129,-8.85273758710149,33,33,0,3
173682,4to9,4,9,0.91748377665666,-11.4078206525479,30,30,0,2
173698,9to8,9,8,0.027439572257236,-12.4204501574849,567,567,0,3
173714,8to3,8,3,0.227014077405999,-4.11464622477799,95,95,0,4
173729,3to4,3,4,0.979247382023731,-4.3200135082935,61,61,0,3
173745,4to9,4,9,0.91748377665666,-11.4078206525479,63,63,0,2
173759,9to4,9,4,0.972333434093129,-8.85273758710149,30,30,0,3
173777,4to9,4,9,0.91748377665666,-11.4078206525479,32,32,0,2
173792,9to4,9,4,0.972333434093129,-8.85273758710149,33,33,0,3
173807,4to9,4,9,0.91748377665666,-11.4078206525479,30,30,0,2
173823,9to4,9,4,0.972333434093129,-8.85273758710149,31,31,0,3
173837,4to9,4,9,0.91748377665666,-11.4078206525479,30,30,0,2
173852,9to4,9,4,0.972333434093129,-8.85273758710149,29,29,0,3
173867,4to9,4,9,0.91748377665666,-11.4078206525479,30,30,0,2
173883,9to4,9,4,0.972333434093129,-8.85273758710149,31,31,0,3
173897,4to3,4,3,0.08251622334334,-13.816460629608,183,183,0,2
173911,3to4,3,4,0.979247382023731,-4.3200135082935,28,28,0,3
173926,4to9,4,9,0.91748377665666,-11.4078206525479,59,59,0,2
173942,9to4,9,4,0.972333434093129,-8.85273758710149,31,31,0,3
173958,4to9,4,9,0.91748377665666,-11.4078206525479,32,32,0,2
173974,9to4,9,4,0.972333434093129,-8.85273758710149,32,32,0,3
173990,4to9,4,9,0.91748377665666,-11.4078206525479,32,32,0,2
174006,9to4,9,4,0.972333434093129,-8.85273758710149,32,32,0,3
174022,4to9,4,9,0.91748377665666,-11.4078206525479,32,32,0,2
174038,9to4,9,4,0.972333434093129,-8.85273758710149,32,32,0,3
174054,4to9,4,9,0.91748377665666,-11.4078206525479,32,32,0,2
174071,9to4,9,4,0.972333434093129,-8.85273758710149,33,33,0,3
174086,4to9,4,9,0.91748377665666,-11.4078206525479,32,32,0,2
174102,9to4,9,4,0.972333434093129,-8.85273758710149,31,31,0,3
174118,4to3,4,3,0.08251622334334,-13.816460629608,221,221,0,2
174134,3to4,3,4,0.979247382023731,-4.3200135082935,32,32,0,3
174150,4to9,4,9,0.91748377665666,-11.4078206525479,64,64,0,2
174166,9to4,9,4,0.972333434093129,-8.85273758710149,32,32,0,3
174182,4to9,4,9,0.91748377665666,-11.4078206525479,32,32,0,2
174198,9to4,9,4,0.972333434093129,-8.85273758710149,32,32,0,3
174214,4to9,4,9,0.91748377665666,-11.4078206525479,32,32,0,2
174229,9to4,9,4,0.972333434093129,-8.85273758710149,31,31,0,3
174246,4to9,4,9,0.91748377665666,-11.4078206525479,32,32,0,2
174261,9to4,9,4,0.972333434093129,-8.85273758710149,32,32,0,3
174276,4to9,4,9,0.91748377665666,-11.4078206525479,30,30,0,2
174293,9to8,9,8,0.027439572257236,-12.4204501574849,595,595,0,3
174309,8to13,8,13,0.00302493167881,-8.43276974963057,1475,1475,0,4
174325,13to14,13,14,0.071154754789884,-9.93118461773681,1765,1765,0,4
174341,14to9,14,9,0.994171917902967,-5.13076416031772,65,65,0,3
174357,9to4,9,4,0.972333434093129,-8.85273758710149,96,96,0,3
174374,4to3,4,3,0.08251622334334,-13.816460629608,256,256,0,2
174389,3to4,3,4,0.979247382023731,-4.3200135082935,32,32,0,3
174404,4to9,4,9,0.91748377665666,-11.4078206525479,63,63,0,2
174418,9to4,9,4,0.972333434093129,-8.85273758710149,29,29,0,3
174434,4to9,4,9,0.91748377665666,-11.4078206525479,30,30,0,2
174451,9to4,9,4,0.972333434093129,-8.85273758710149,33,33,0,3
174467,4to3,4,3,0.08251622334334,-13.816460629608,93,93,0,2
174482,3to4,3,4,0.979247382023731,-4.3200135082935,31,31,0,3
174498,4to9,4,9,0.91748377665666,-11.4078206525479,64,64,0,2
174512,9to4,9,4,0.972333434093129,-8.85273758710149,30,30,0,3
174526,4to9,4,9,0.91748377665666,-11.4078206525479,28,28,0,2
174542,9to8,9,8,0.027439572257236,-12.4204501574849,249,249,0,3
174558,8to3,8,3,0.227014077405999,-4.11464622477799,91,91,0,4
174576,3to4,3,4,0.979247382023731,-4.3200135082935,64,64,0,3
174593,4to9,4,9,0.91748377665666,-11.4078206525479,67,67,0,2
174609,9to4,9,4,0.972333434093129,-8.85273758710149,33,33,0,3
174624,4to9,4,9,0.91748377665666,-11.4078206525479,31,31,0,2
174641,9to4,9,4,0.972333434093129,-8.85273758710149,32,32,0,3
174656,4to9,4,9,0.91748377665666,-11.4078206525479,32,32,0,2
174671,9to4,9,4,0.972333434093129,-8.85273758710149,30,30,0,3
174687,4to9,4,9,0.91748377665666,-11.4078206525479,31,31,0,2
174701,9to4,9,4,0.972333434093129,-8.85273758710149,30,30,0,3
174715,4to9,4,9,0.91748377665666,-11.4078206525479,28,28,0,2
174731,9to4,9,4,0.972333434093129,-8.85273758710149,30,30,0,3
174748,4to9,4,9,0.91748377665666,-11.4078206525479,33,33,0,2
174765,9to4,9,4,0.972333434093129,-8.85273758710149,34,34,0,3
174779,4to3,4,3,0.08251622334334,-13.816460629608,221,221,0,2
174795,3to4,3,4,0.979247382023731,-4.3200135082935,30,30,0,3
174813,4to9,4,9,0.91748377665666,-11.4078206525479,65,65,0,2
174828,9to8,9,8,0.027439572257236,-12.4204501574849,286,286,0,3
174843,8to9,8,9,0.769052262769502,-2.89449932615566,30,30,0,4
174860,9to14,9,14,0.000226993649635,-17.2152696089966,535,535,0,3
174875,14to9,14,9,0.994171917902967,-5.13076416031772,32,32,0,3
174892,9to4,9,4,0.972333434093129,-8.85273758710149,97,97,0,3
174907,4to9,4,9,0.91748377665666,-11.4078206525479,32,32,0,2
174923,9to4,9,4,0.972333434093129,-8.85273758710149,31,31,0,3
174940,4to9,4,9,0.91748377665666,-11.4078206525479,33,33,0,2
174955,9to4,9,4,0.972333434093129,-8.85273758710149,32,32,0,3
174971,4to3,4,3,0.08251622334334,-13.816460629608,192,192,0,2
174987,3to4,3,4,0.979247382023731,-4.3200135082935,32,32,0,3
175001,4to9,4,9,0.91748377665666,-11.4078206525479,61,61,0,2
175016,9to4,9,4,0.972333434093129,-8.85273758710149,29,29,0,3
175032,4to9,4,9,0.91748377665666,-11.4078206525479,31,31,0,2
175048,9to4,9,4,0.972333434093129,-8.85273758710149,32,32,0,3
175064,4to9,4,9,0.91748377665666,-11.4078206525479,32,32,0,2
175080,9to4,9,4,0.972333434093129,-8.85273758710149,32,32,0,3
175096,4to3,4,3,0.08251622334334,-13.816460629608,125,125,0,2
175111,3to4,3,4,0.979247382023731,-4.3200135082935,31,31,0,3
175129,4to9,4,9,0.91748377665666,-11.4078206525479,65,65,0,2
175145,9to4,9,4,0.972333434093129,-8.85273758710149,34,34,0,3
175160,4to9,4,9,0.91748377665666,-11.4078206525479,31,31,0,2
175176,9to4,9,4,0.972333434093129,-8.85273758710149,31,31,0,3
175192,4to9,4,9,0.91748377665666,-11.4078206525479,32,32,0,2
175208,9to14,9,14,0.000226993649635,-17.2152696089966,348,348,0,3
175224,14to9,14,9,0.994171917902967,-5.13076416031772,32,32,0,3
175239,9to4,9,4,0.972333434093129,-8.85273758710149,63,63,0,3
175254,4to9,4,9,0.91748377665666,-11.4078206525479,30,30,0,2
175270,9to4,9,4,0.972333434093129,-8.85273758710149,31,31,0,3
175286,4to9,4,9,0.91748377665666,-11.4078206525479,32,32,0,2
175303,9to4,9,4,0.972333434093129,-8.85273758710149,33,33,0,3
175318,4to3,4,3,0.08251622334334,-13.816460629608,222,222,0,2
175334,3to4,3,4,0.979247382023731,-4.3200135082935,31,31,0,3
175350,4to9,4,9,0.91748377665666,-11.4078206525479,64,64,0,2
175365,9to4,9,4,0.972333434093129,-8.85273758710149,31,31,0,3
175380,4to9,4,9,0.91748377665666,-11.4078206525479,30,30,0,2
175397,9to8,9,8,0.027439572257236,-12.4204501574849,569,569,0,3
175413,8to3,8,3,0.227014077405999,-4.11464622477799,95,95,0,4
175429,3to4,3,4,0.979247382023731,-4.3200135082935,64,64,0,3
175445,4to9,4,9,0.91748377665666,-11.4078206525479,65,65,0,2
175460,9to14,9,14,0.000226993649635,-17.2152696089966,252,252,0,3
175476,14to9,14,9,0.994171917902967,-5.13076416031772,31,31,0,3
175491,9to4,9,4,0.972333434093129,-8.85273758710149,62,62,0,3
175505,4to9,4,9,0.91748377665666,-11.4078206525479,29,29,0,2
175522,9to4,9,4,0.972333434093129,-8.85273758710149,31,31,0,3
175537,4to9,4,9,0.91748377665666,-11.4078206525479,32,32,0,2
175551,9to4,9,4,0.972333434093129,-8.85273758710149,29,29,0,3
175567,4to9,4,9,0.91748377665666,-11.4078206525479,30,30,0,2
175583,9to4,9,4,0.972333434093129,-8.85273758710149,32,32,0,3
175599,4to9,4,9,0.91748377665666,-11.4078206525479,32,32,0,2
175613,9to4,9,4,0.972333434093129,-8.85273758710149,30,30,0,3
175629,4to3,4,3,0.08251622334334,-13.816460629608,216,216,0,2
175643,3to4,3,4,0.979247382023731,-4.3200135082935,30,30,0,3
175660,4to9,4,9,0.91748377665666,-11.4078206525479,61,61,0,2
175676,9to4,9,4,0.972333434093129,-8.85273758710149,33,33,0,3
175692,4to9,4,9,0.91748377665666,-11.4078206525479,32,32,0,2
175707,9to4,9,4,0.972333434093129,-8.85273758710149,31,31,0,3
175723,4to9,4,9,0.91748377665666,-11.4078206525479,31,31,0,2
175739,9to4,9,4,0.972333434093129,-8.85273758710149,32,32,0,3
175754,4to9,4,9,0.91748377665666,-11.4078206525479,31,31,0,2
175770,9to4,9,4,0.972333434093129,-8.85273758710149,31,31,0,3
175787,4to9,4,9,0.91748377665666,-11.4078206525479,33,33,0,2
175803,9to4,9,4,0.972333434093129,-8.85273758710149,33,33,0,3
175817,4to9,4,9,0.91748377665666,-11.4078206525479,30,30,0,2
175834,9to4,9,4,0.972333434093129,-8.85273758710149,31,31,0,3
175849,4to3,4,3,0.08251622334334,-13.816460629608,220,220,0,2
175864,3to4,3,4,0.979247382023731,-4.3200135082935,30,30,0,3
175881,4to9,4,9,0.91748377665666,-11.4078206525479,64,64,0,2
175897,9to4,9,4,0.972333434093129,-8.85273758710149,33,33,0,3
175913,4to9,4,9,0.91748377665666,-11.4078206525479,32,32,0,2
175929,9to4,9,4,0.972333434093129,-8.85273758710149,32,32,0,3
175945,4to9,4,9,0.91748377665666,-11.4078206525479,32,32,0,2
175961,9to4,9,4,0.972333434093129,-8.85273758710149,32,32,0,3
175975,4to9,4,9,0.91748377665666,-11.4078206525479,30,30,0,2
175991,9to8,9,8,0.027439572257236,-12.4204501574849,594,594,0,3
176007,8to3,8,3,0.227014077405999,-4.11464622477799,158,158,0,4
176022,3to4,3,4,0.979247382023731,-4.3200135082935,61,61,0,3
176038,4to9,4,9,0.91748377665666,-11.4078206525479,63,63,0,2
176054,9to14,9,14,0.000226993649635,-17.2152696089966,594,594,0,3
176069,14to9,14,9,0.994171917902967,-5.13076416031772,31,31,0,3
176085,9to4,9,4,0.972333434093129,-8.85273758710149,63,63,0,3
176101,4to9,4,9,0.91748377665666,-11.4078206525479,32,32,0,2
176117,9to4,9,4,0.972333434093129,-8.85273758710149,32,32,0,3
176131,4to9,4,9,0.91748377665666,-11.4078206525479,30,30,0,2
176148,9to4,9,4,0.972333434093129,-8.85273758710149,31,31,0,3
176163,4to9,4,9,0.91748377665666,-11.4078206525479,32,32,0,2
176179,9to4,9,4,0.972333434093129,-8.85273758710149,31,31,0,3
176194,4to9,4,9,0.91748377665666,-11.4078206525479,31,31,0,2
176209,9to4,9,4,0.972333434093129,-8.85273758710149,30,30,0,3
176224,4to3,4,3,0.08251622334334,-13.816460629608,217,217,0,2
176239,3to4,3,4,0.979247382023731,-4.3200135082935,30,30,0,3
176255,4to9,4,9,0.91748377665666,-11.4078206525479,61,61,0,2
176271,9to4,9,4,0.972333434093129,-8.85273758710149,32,32,0,3
176286,4to9,4,9,0.91748377665666,-11.4078206525479,31,31,0,2
176302,9to4,9,4,0.972333434093129,-8.85273758710149,31,31,0,3
176318,4to9,4,9,0.91748377665666,-11.4078206525479,32,32,0,2
176334,9to4,9,4,0.972333434093129,-8.85273758710149,32,32,0,3
176350,4to9,4,9,0.91748377665666,-11.4078206525479,32,32,0,2
176366,9to4,9,4,0.972333434093129,-8.85273758710149,32,32,0,3
176383,4to9,4,9,0.91748377665666,-11.4078206525479,33,33,0,2
176398,9to4,9,4,0.972333434093129,-8.85273758710149,32,32,0,3
176415,4to3,4,3,0.08251622334334,-13.816460629608,191,191,0,2
176433,3to4,3,4,0.979247382023731,-4.3200135082935,35,35,0,3
176450,4to9,4,9,0.91748377665666,-11.4078206525479,67,67,0,2
176465,9to4,9,4,0.972333434093129,-8.85273758710149,32,32,0,3
176480,4to9,4,9,0.91748377665666,-11.4078206525479,30,30,0,2
176495,9to4,9,4,0.972333434093129,-8.85273758710149,30,30,0,3
176510,4to9,4,9,0.91748377665666,-11.4078206525479,30,30,0,2
176526,9to4,9,4,0.972333434093129,-8.85273758710149,31,31,0,3
176542,4to9,4,9,0.91748377665666,-11.4078206525479,32,32,0,2
176556,9to4,9,4,0.972333434093129,-8.85273758710149,30,30,0,3
176571,4to9,4,9,0.91748377665666,-11.4078206525479,29,29,0,2
176588,9to8,9,8,0.027439572257236,-12.4204501574849,597,597,0,3
176605,8to3,8,3,0.227014077405999,-4.11464622477799,190,190,0,4
176620,3to4,3,4,0.979247382023731,-4.3200135082935,64,64,0,3
176636,4to9,4,9,0.91748377665666,-11.4078206525479,65,65,0,2
176652,9to4,9,4,0.972333434093129,-8.85273758710149,32,32,0,3
176667,4to9,4,9,0.91748377665666,-11.4078206525479,31,31,0,2
176683,9to4,9,4,0.972333434093129,-8.85273758710149,31,31,0,3
176698,4to9,4,9,0.91748377665666,-11.4078206525479,31,31,0,2
176713,9to4,9,4,0.972333434093129,-8.85273758710149,30,30,0,3
176728,4to9,4,9,0.91748377665666,-11.4078206525479,30,30,0,2
176742,9to4,9,4,0.972333434093129,-8.85273758710149,29,29,0,3
176757,4to9,4,9,0.91748377665666,-11.4078206525479,29,29,0,2
176772,9to4,9,4,0.972333434093129,-8.85273758710149,30,30,0,3
176788,4to3,4,3,0.08251622334334,-13.816460629608,183,183,0,2
176802,3to4,3,4,0.979247382023731,-4.3200135082935,30,30,0,3
176818,4to9,4,9,0.91748377665666,-11.4078206525479,61,61,0,2
176835,9to4,9,4,0.972333434093129,-8.85273758710149,33,33,0,3
176851,4to3,4,3,0.08251622334334,-13.816460629608,63,63,0,2
176868,3to4,3,4,0.979247382023731,-4.3200135082935,33,33,0,3
176884,4to9,4,9,0.91748377665666,-11.4078206525479,66,66,0,2
176901,9to4,9,4,0.972333434093129,-8.85273758710149,33,33,0,3
176917,4to9,4,9,0.91748377665666,-11.4078206525479,33,33,0,2
176932,9to4,9,4,0.972333434093129,-8.85273758710149,31,31,0,3
176947,4to9,4,9,0.91748377665666,-11.4078206525479,30,30,0,2
176962,9to4,9,4,0.972333434093129,-8.85273758710149,30,30,0,3
176979,4to9,4,9,0.91748377665666,-11.4078206525479,32,32,0,2
176994,9to4,9,4,0.972333434093129,-8.85273758710149,32,32,0,3
177011,4to9,4,9,0.91748377665666,-11.4078206525479,32,32,0,2
177026,9to4,9,4,0.972333434093129,-8.85273758710149,32,32,0,3
177042,4to9,4,9,0.91748377665666,-11.4078206525479,31,31,0,2
177059,9to4,9,4,0.972333434093129,-8.85273758710149,33,33,0,3
177074,4to3,4,3,0.08251622334334,-13.816460629608,223,223,0,2
177090,3to4,3,4,0.979247382023731,-4.3200135082935,31,31,0,3
177105,4to9,4,9,0.91748377665666,-11.4078206525479,63,63,0,2
177120,9to4,9,4,0.972333434093129,-8.85273758710149,30,30,0,3
177135,4to9,4,9,0.91748377665666,-11.4078206525479,30,30,0,2
177152,9to14,9,14,0.000226993649635,-17.2152696089966,1098,1098,0,3
177167,14to9,14,9,0.994171917902967,-5.13076416031772,32,32,0,3
177183,9to4,9,4,0.972333434093129,-8.85273758710149,63,63,0,3
177199,4to9,4,9,0.91748377665666,-11.4078206525479,32,32,0,2
177216,9to8,9,8,0.027439572257236,-12.4204501574849,628,628,0,3
177231,8to3,8,3,0.227014077405999,-4.11464622477799,157,157,0,4
177247,3to4,3,4,0.979247382023731,-4.3200135082935,64,64,0,3
177263,4to9,4,9,0.91748377665666,-11.4078206525479,64,64,0,2
177279,9to4,9,4,0.972333434093129,-8.85273758710149,32,32,0,3
177295,4to9,4,9,0.91748377665666,-11.4078206525479,32,32,0,2
177311,9to4,9,4,0.972333434093129,-8.85273758710149,32,32,0,3
177326,4to9,4,9,0.91748377665666,-11.4078206525479,31,31,0,2
177344,9to4,9,4,0.972333434093129,-8.85273758710149,33,33,0,3
177360,4to3,4,3,0.08251622334334,-13.816460629608,129,129,0,2
177375,3to4,3,4,0.979247382023731,-4.3200135082935,31,31,0,3
177390,4to9,4,9,0.91748377665666,-11.4078206525479,64,64,0,2
177406,9to4,9,4,0.972333434093129,-8.85273758710149,31,31,0,3
177422,4to9,4,9,0.91748377665666,-11.4078206525479,32,32,0,2
177438,9to4,9,4,0.972333434093129,-8.85273758710149,32,32,0,3
177454,4to9,4,9,0.91748377665666,-11.4078206525479,32,32,0,2
177470,9to4,9,4,0.972333434093129,-8.85273758710149,32,32,0,3
177485,4to9,4,9,0.91748377665666,-11.4078206525479,31,31,0,2
177501,9to4,9,4,0.972333434093129,-8.85273758710149,31,31,0,3
177516,4to9,4,9,0.91748377665666,-11.4078206525479,31,31,0,2
177532,9to4,9,4,0.972333434093129,-8.85273758710149,31,31,0,3
177547,4to9,4,9,0.91748377665666,-11.4078206525479,31,31,0,2
177561,9to4,9,4,0.972333434093129,-8.85273758710149,29,29,0,3
177576,4to3,4,3,0.08251622334334,-13.816460629608,216,216,0,2
177593,3to4,3,4,0.979247382023731,-4.3200135082935,32,32,0,3
177609,4to9,4,9,0.91748377665666,-11.4078206525479,62,62,0,2
177624,9to4,9,4,0.972333434093129,-8.85273758710149,31,31,0,3
177640,4to9,4,9,0.91748377665666,-11.4078206525479,31,31,0,2
177655,9to4,9,4,0.972333434093129,-8.85273758710149,31,31,0,3
177672,4to3,4,3,0.08251622334334,-13.816460629608,96,96,0,2
177688,3to4,3,4,0.979247382023731,-4.3200135082935,33,33,0,3
177704,4to9,4,9,0.91748377665666,-11.4078206525479,64,64,0,2
177722,9to14,9,14,0.000226993649635,-17.2152696089966,570,570,0,3
177738,14to13,14,13,0.005822171594397,-10.2710009893219,3429,3429,0,3
177755,13to8,13,8,0.917351022044606,-7.37455157477482,539,539,0,4
177771,8to3,8,3,0.227014077405999,-4.11464622477799,99,99,0,4
177787,3to4,3,4,0.979247382023731,-4.3200135082935,99,99,0,3
177803,4to9,4,9,0.91748377665666,-11.4078206525479,99,99,0,2
177819,9to4,9,4,0.972333434093129,-8.85273758710149,32,32,0,3
177835,4to9,4,9,0.91748377665666,-11.4078206525479,32,32,0,2
177850,9to4,9,4,0.972333434093129,-8.85273758710149,31,31,0,3
177865,4to9,4,9,0.91748377665666,-11.4078206525479,30,30,0,2
177880,9to4,9,4,0.972333434093129,-8.85273758710149,30,30,0,3
177896,4to9,4,9,0.91748377665666,-11.4078206525479,31,31,0,2
177912,9to4,9,4,0.972333434093129,-8.85273758710149,32,32,0,3
177928,4to9,4,9,0.91748377665666,-11.4078206525479,32,32,0,2
177943,9to14,9,14,0.000226993649635,-17.2152696089966,221,221,0,3
177958,14to9,14,9,0.994171917902967,-5.13076416031772,30,30,0,3
177975,9to4,9,4,0.972333434093129,-8.85273758710149,63,63,0,3
177990,4to3,4,3,0.08251622334334,-13.816460629608,219,219,0,2
178005,3to2,3,2,0.00068093563244,-11.5910853038632,5253,5253,0,3
178020,2to3,2,3,0.998447808871189,-3.95697141540815,30,30,0,3
178037,3to4,3,4,0.979247382023731,-4.3200135082935,62,62,0,3
178053,4to3,4,3,0.08251622334334,-13.816460629608,33,33,0,2
178068,3to4,3,4,0.979247382023731,-4.3200135082935,31,31,0,3
178084,4to9,4,9,0.91748377665666,-11.4078206525479,126,126,0,2
178100,9to4,9,4,0.972333434093129,-8.85273758710149,32,32,0,3
178116,4to9,4,9,0.91748377665666,-11.4078206525479,32,32,0,2
178133,9to14,9,14,0.000226993649635,-17.2152696089966,190,190,0,3
178149,14to9,14,9,0.994171917902967,-5.13076416031772,33,33,0,3
178164,9to4,9,4,0.972333434093129,-8.85273758710149,64,64,0,3
178179,4to9,4,9,0.91748377665666,-11.4078206525479,30,30,0,2
178195,9to4,9,4,0.972333434093129,-8.85273758710149,31,31,0,3
178210,4to9,4,9,0.91748377665666,-11.4078206525479,31,31,0,2
178225,9to4,9,4,0.972333434093129,-8.85273758710149,30,30,0,3
178241,4to3,4,3,0.08251622334334,-13.816460629608,188,188,0,2
178256,3to4,3,4,0.979247382023731,-4.3200135082935,31,31,0,3
178272,4to9,4,9,0.91748377665666,-11.4078206525479,62,62,0,2
178287,9to4,9,4,0.972333434093129,-8.85273758710149,31,31,0,3
178303,4to9,4,9,0.91748377665666,-11.4078206525479,31,31,0,2
178319,9to4,9,4,0.972333434093129,-8.85273758710149,32,32,0,3
178336,4to9,4,9,0.91748377665666,-11.4078206525479,33,33,0,2
178352,9to4,9,4,0.972333434093129,-8.85273758710149,33,33,0,3
178367,4to3,4,3,0.08251622334334,-13.816460629608,126,126,0,2
178382,3to4,3,4,0.979247382023731,-4.3200135082935,30,30,0,3
178399,4to9,4,9,0.91748377665666,-11.4078206525479,63,63,0,2
178416,9to8,9,8,0.027439572257236,-12.4204501574849,661,661,0,3
178431,8to9,8,9,0.769052262769502,-2.89449932615566,32,32,0,4
178446,9to4,9,4,0.972333434093129,-8.85273758710149,64,64,0,3
178461,4to9,4,9,0.91748377665666,-11.4078206525479,30,30,0,2
178477,9to4,9,4,0.972333434093129,-8.85273758710149,31,31,0,3
178492,4to9,4,9,0.91748377665666,-11.4078206525479,31,31,0,2
178509,9to4,9,4,0.972333434093129,-8.85273758710149,32,32,0,3
178524,4to9,4,9,0.91748377665666,-11.4078206525479,32,32,0,2
178540,9to8,9,8,0.027439572257236,-12.4204501574849,124,124,0,3
178557,8to3,8,3,0.227014077405999,-4.11464622477799,190,190,0,4
178575,3to4,3,4,0.979247382023731,-4.3200135082935,66,66,0,3
178591,4to9,4,9,0.91748377665666,-11.4078206525479,67,67,0,2
178606,9to4,9,4,0.972333434093129,-8.85273758710149,31,31,0,3
178621,4to9,4,9,0.91748377665666,-11.4078206525479,30,30,0,2
178637,9to14,9,14,0.000226993649635,-17.2152696089966,504,504,0,3
178653,14to19,14,19,2.27067104141089E-06,-18.1203578257199,16774,727,16047,3
178669,19to18,19,18,0.000514328762145,-11.3455508231095,16805,500,16305,3
178686,18to13,18,13,0.99620082270906,-3.74424906738557,948,948,0,4
178702,13to8,13,8,0.917351022044606,-7.37455157477482,162,162,0,4
178717,8to9,8,9,0.769052262769502,-2.89449932615566,96,96,0,4
178732,9to14,9,14,0.000226993649635,-17.2152696089966,95,95,0,3
178747,14to9,14,9,0.994175536542712,-5.13076416031772,30,30,0,3
178763,9to14,9,14,0.000226993649635,-17.2152696089966,31,31,0,3
178779,14to9,14,9,0.994175536542712,-5.13076416031772,32,32,0,3
178795,9to4,9,4,0.972333434093129,-8.85273758710149,189,189,0,3
178812,4to3,4,3,0.08251622334334,-13.816460629608,255,255,0,2
178828,3to4,3,4,0.979247382023731,-4.3200135082935,33,33,0,3
178844,4to9,4,9,0.91748377665666,-11.4078206525479,65,65,0,2
178859,9to4,9,4,0.972333434093129,-8.85273758710149,31,31,0,3
178874,4to9,4,9,0.91748377665666,-11.4078206525479,30,30,0,2
178888,9to4,9,4,0.972333434093129,-8.85273758710149,29,29,0,3
178904,4to9,4,9,0.91748377665666,-11.4078206525479,30,30,0,2
178919,9to4,9,4,0.972333434093129,-8.85273758710149,31,31,0,3
178936,4to9,4,9,0.91748377665666,-11.4078206525479,32,32,0,2
178952,9to4,9,4,0.972333434093129,-8.85273758710149,33,33,0,3
178968,4to9,4,9,0.91748377665666,-11.4078206525479,32,32,0,2
178983,9to4,9,4,0.972333434093129,-8.85273758710149,31,31,0,3
178997,4to3,4,3,0.08251622334334,-13.816460629608,185,185,0,2
179011,3to4,3,4,0.979247382023731,-4.3200135082935,28,28,0,3
179028,4to9,4,9,0.91748377665666,-11.4078206525479,60,60,0,2
179044,9to4,9,4,0.972333434093129,-8.85273758710149,33,33,0,3
179060,4to9,4,9,0.91748377665666,-11.4078206525479,32,32,0,2
179077,9to4,9,4,0.972333434093129,-8.85273758710149,33,33,0,3
179092,4to9,4,9,0.91748377665666,-11.4078206525479,32,32,0,2
179108,9to8,9,8,0.027439572257236,-12.4204501574849,406,406,0,3
179123,8to3,8,3,0.227014077405999,-4.11464622477799,126,126,0,4
179140,3to4,3,4,0.979247382023731,-4.3200135082935,63,63,0,3
179155,4to9,4,9,0.91748377665666,-11.4078206525479,63,63,0,2
179171,9to4,9,4,0.972333434093129,-8.85273758710149,31,31,0,3
179187,4to9,4,9,0.91748377665666,-11.4078206525479,32,32,0,2
179203,9to4,9,4,0.972333434093129,-8.85273758710149,32,32,0,3
179219,4to9,4,9,0.91748377665666,-11.4078206525479,32,32,0,2
179235,9to4,9,4,0.972333434093129,-8.85273758710149,32,32,0,3
179250,4to9,4,9,0.91748377665666,-11.4078206525479,31,31,0,2
179266,9to4,9,4,0.972333434093129,-8.85273758710149,31,31,0,3
179282,4to9,4,9,0.91748377665666,-11.4078206525479,32,32,0,2
179297,9to4,9,4,0.972333434093129,-8.85273758710149,31,31,0,3
179313,4to3,4,3,0.08251622334334,-13.816460629608,190,190,0,2
179327,3to4,3,4,0.979247382023731,-4.3200135082935,30,30,0,3
179343,4to9,4,9,0.91748377665666,-11.4078206525479,61,61,0,2
179359,9to4,9,4,0.972333434093129,-8.85273758710149,32,32,0,3
179375,4to9,4,9,0.91748377665666,-11.4078206525479,32,32,0,2
179391,9to4,9,4,0.972333434093129,-8.85273758710149,32,32,0,3
179406,4to9,4,9,0.91748377665666,-11.4078206525479,31,31,0,2
179421,9to4,9,4,0.972333434093129,-8.85273758710149,30,30,0,3
179436,4to9,4,9,0.91748377665666,-11.4078206525479,30,30,0,2
179452,9to4,9,4,0.972333434093129,-8.85273758710149,31,31,0,3
179468,4to9,4,9,0.91748377665666,-11.4078206525479,32,32,0,2
179484,9to4,9,4,0.972333434093129,-8.85273758710149,32,32,0,3
179501,4to9,4,9,0.91748377665666,-11.4078206525479,33,33,0,2
179516,9to4,9,4,0.972333434093129,-8.85273758710149,32,32,0,3
179533,4to3,4,3,0.08251622334334,-13.816460629608,220,220,0,2
179549,3to4,3,4,0.979247382023731,-4.3200135082935,33,33,0,3
179564,4to9,4,9,0.91748377665666,-11.4078206525479,63,63,0,2
179580,9to14,9,14,0.000226993649635,-17.2152696089966,817,817,0,3
179595,14to9,14,9,0.994175536542712,-5.13076416031772,31,31,0,3
179609,9to4,9,4,0.972333434093129,-8.85273758710149,60,60,0,3
179625,4to9,4,9,0.91748377665666,-11.4078206525479,30,30,0,2
179640,9to4,9,4,0.972333434093129,-8.85273758710149,31,31,0,3
179654,4to9,4,9,0.91748377665666,-11.4078206525479,29,29,0,2
179672,9to8,9,8,0.027439572257236,-12.4204501574849,564,564,0,3
179689,8to3,8,3,0.227014077405999,-4.11464622477799,156,156,0,4
179705,3to2,3,2,0.00068093563244,-11.5910853038632,1700,1700,0,3
179722,2to7,2,7,0.001422843658358,-10.5105158519261,6921,6921,0,3
179738,7to12,7,12,0.021860378356319,-6.15866584618918,6920,6920,0,4
179754,12to13,12,13,0.98625505370986,-6.36264020069652,1068,1068,0,4
179771,13to8,13,8,0.917351022044606,-7.37455157477482,99,99,0,4
179785,8to9,8,9,0.769052262769502,-2.89449932615566,131,131,0,4
179801,9to4,9,4,0.972333434093129,-8.85273758710149,161,161,0,3
179816,4to9,4,9,0.91748377665666,-11.4078206525479,31,31,0,2
179833,9to8,9,8,0.027439572257236,-12.4204501574849,62,62,0,3
179849,8to3,8,3,0.227014077405999,-4.11464622477799,160,160,0,4
179865,3to4,3,4,0.979247382023731,-4.3200135082935,64,64,0,3
179880,4to9,4,9,0.91748377665666,-11.4078206525479,64,64,0,2
179896,9to4,9,4,0.972333434093129,-8.85273758710149,31,31,0,3
179911,4to3,4,3,0.08251622334334,-13.816460629608,62,62,0,2
179926,3to4,3,4,0.979247382023731,-4.3200135082935,30,30,0,3
179942,4to9,4,9,0.91748377665666,-11.4078206525479,62,62,0,2
179957,9to4,9,4,0.972333434093129,-8.85273758710149,31,31,0,3
179972,4to9,4,9,0.91748377665666,-11.4078206525479,30,30,0,2
179987,9to4,9,4,0.972333434093129,-8.85273758710149,30,30,0,3
180003,4to9,4,9,0.91748377665666,-11.4078206525479,31,31,0,2
180019,9to4,9,4,0.972333434093129,-8.85273758710149,32,32,0,3
180035,4to9,4,9,0.91748377665666,-11.4078206525479,32,32,0,2
180050,9to4,9,4,0.972333434093129,-8.85273758710149,31,31,0,3
180065,4to9,4,9,0.91748377665666,-11.4078206525479,30,30,0,2
180080,9to4,9,4,0.972333434093129,-8.85273758710149,30,30,0,3
180096,4to3,4,3,0.08251622334334,-13.816460629608,185,185,0,2
180112,3to4,3,4,0.979247382023731,-4.3200135082935,32,32,0,3
180130,4to9,4,9,0.91748377665666,-11.4078206525479,65,65,0,2
180146,9to4,9,4,0.972333434093129,-8.85273758710149,34,34,0,3
180162,4to9,4,9,0.91748377665666,-11.4078206525479,32,32,0,2
180179,9to4,9,4,0.972333434093129,-8.85273758710149,33,33,0,3
180195,4to9,4,9,0.91748377665666,-11.4078206525479,33,33,0,2
180212,9to4,9,4,0.972333434093129,-8.85273758710149,33,33,0,3
180227,4to9,4,9,0.91748377665666,-11.4078206525479,32,32,0,2
180242,9to4,9,4,0.972333434093129,-8.85273758710149,30,30,0,3
180257,4to9,4,9,0.91748377665666,-11.4078206525479,30,30,0,2
180272,9to4,9,4,0.972333434093129,-8.85273758710149,30,30,0,3
180287,4to3,4,3,0.08251622334334,-13.816460629608,191,191,0,2
180304,3to8,3,8,0.020071682343829,-8.20748782428216,471,471,0,3
180320,8to9,8,9,0.769052262769502,-2.89449932615566,63,63,0,4
180335,9to4,9,4,0.972333434093129,-8.85273758710149,63,63,0,3
180350,4to9,4,9,0.91748377665666,-11.4078206525479,30,30,0,2
180366,9to4,9,4,0.972333434093129,-8.85273758710149,31,31,0,3
180382,4to9,4,9,0.91748377665666,-11.4078206525479,32,32,0,2
180398,9to4,9,4,0.972333434093129,-8.85273758710149,32,32,0,3
180414,4to9,4,9,0.91748377665666,-11.4078206525479,32,32,0,2
180430,9to4,9,4,0.972333434093129,-8.85273758710149,32,32,0,3
180445,4to9,4,9,0.91748377665666,-11.4078206525479,31,31,0,2
180460,9to4,9,4,0.972333434093129,-8.85273758710149,30,30,0,3
180475,4to3,4,3,0.08251622334334,-13.816460629608,188,188,0,2
180491,3to4,3,4,0.979247382023731,-4.3200135082935,31,31,0,3
180507,4to9,4,9,0.91748377665666,-11.4078206525479,62,62,0,2
180523,9to4,9,4,0.972333434093129,-8.85273758710149,32,32,0,3
180538,4to9,4,9,0.91748377665666,-11.4078206525479,31,31,0,2
180555,9to4,9,4,0.972333434093129,-8.85273758710149,32,32,0,3
180571,4to9,4,9,0.91748377665666,-11.4078206525479,33,33,0,2
180587,9to4,9,4,0.972333434093129,-8.85273758710149,32,32,0,3
180602,4to9,4,9,0.91748377665666,-11.4078206525479,31,31,0,2
180616,9to4,9,4,0.972333434093129,-8.85273758710149,29,29,0,3
180632,4to9,4,9,0.91748377665666,-11.4078206525479,30,30,0,2
180647,9to4,9,4,0.972333434093129,-8.85273758710149,31,31,0,3
180663,4to3,4,3,0.08251622334334,-13.816460629608,188,188,0,2
180680,3to4,3,4,0.979247382023731,-4.3200135082935,33,33,0,3
180697,4to9,4,9,0.91748377665666,-11.4078206525479,65,65,0,2
180712,9to4,9,4,0.972333434093129,-8.85273758710149,32,32,0,3
180729,4to9,4,9,0.91748377665666,-11.4078206525479,32,32,0,2
180746,9to4,9,4,0.972333434093129,-8.85273758710149,34,34,0,3
180762,4to9,4,9,0.91748377665666,-11.4078206525479,33,33,0,2
180779,9to4,9,4,0.972333434093129,-8.85273758710149,33,33,0,3
180793,4to9,4,9,0.91748377665666,-11.4078206525479,31,31,0,2
180808,9to4,9,4,0.972333434093129,-8.85273758710149,29,29,0,3
180823,4to9,4,9,0.91748377665666,-11.4078206525479,30,30,0,2
180839,9to4,9,4,0.972333434093129,-8.85273758710149,31,31,0,3
180855,4to9,4,9,0.91748377665666,-11.4078206525479,32,32,0,2
180869,9to4,9,4,0.972333434093129,-8.85273758710149,30,30,0,3
180884,4to3,4,3,0.08251622334334,-13.816460629608,221,221,0,2
180901,3to4,3,4,0.979247382023731,-4.3200135082935,32,32,0,3
180916,4to9,4,9,0.91748377665666,-11.4078206525479,61,61,0,2
180932,9to8,9,8,0.027439572257236,-12.4204501574849,628,628,0,3
180949,8to9,8,9,0.769052262769502,-2.89449932615566,33,33,0,4
180965,9to4,9,4,0.972333434093129,-8.85273758710149,64,64,0,3
180981,4to9,4,9,0.91748377665666,-11.4078206525479,32,32,0,2
180999,9to4,9,4,0.972333434093129,-8.85273758710149,34,34,0,3
181014,4to9,4,9,0.91748377665666,-11.4078206525479,33,33,0,2
181031,9to4,9,4,0.972333434093129,-8.85273758710149,32,32,0,3
181046,4to9,4,9,0.91748377665666,-11.4078206525479,32,32,0,2
181062,9to4,9,4,0.972333434093129,-8.85273758710149,31,31,0,3
181076,4to3,4,3,0.08251622334334,-13.816460629608,192,192,0,2
181092,3to4,3,4,0.979247382023731,-4.3200135082935,30,30,0,3
181107,4to9,4,9,0.91748377665666,-11.4078206525479,61,61,0,2
181122,9to4,9,4,0.972333434093129,-8.85273758710149,30,30,0,3
181140,4to9,4,9,0.91748377665666,-11.4078206525479,33,33,0,2
181157,9to4,9,4,0.972333434093129,-8.85273758710149,35,35,0,3
181172,4to9,4,9,0.91748377665666,-11.4078206525479,32,32,0,2
181188,9to4,9,4,0.972333434093129,-8.85273758710149,31,31,0,3
181203,4to9,4,9,0.91748377665666,-11.4078206525479,31,31,0,2
181218,9to4,9,4,0.972333434093129,-8.85273758710149,30,30,0,3
181233,4to3,4,3,0.08251622334334,-13.816460629608,157,157,0,2
181248,3to4,3,4,0.979247382023731,-4.3200135082935,30,30,0,3
181264,4to9,4,9,0.91748377665666,-11.4078206525479,61,61,0,2
181279,9to4,9,4,0.972333434093129,-8.85273758710149,31,31,0,3
181296,4to9,4,9,0.91748377665666,-11.4078206525479,32,32,0,2
181310,9to4,9,4,0.972333434093129,-8.85273758710149,31,31,0,3
181327,4to9,4,9,0.91748377665666,-11.4078206525479,31,31,0,2
181343,9to4,9,4,0.972333434093129,-8.85273758710149,33,33,0,3
181359,4to9,4,9,0.91748377665666,-11.4078206525479,32,32,0,2
181375,9to4,9,4,0.972333434093129,-8.85273758710149,32,32,0,3
181390,4to9,4,9,0.91748377665666,-11.4078206525479,31,31,0,2
181405,9to4,9,4,0.972333434093129,-8.85273758710149,30,30,0,3
181420,4to3,4,3,0.08251622334334,-13.816460629608,187,187,0,2
181436,3to4,3,4,0.979247382023731,-4.3200135082935,31,31,0,3
181451,4to9,4,9,0.91748377665666,-11.4078206525479,61,61,0,2
181467,9to4,9,4,0.972333434093129,-8.85273758710149,31,31,0,3
181484,4to9,4,9,0.91748377665666,-11.4078206525479,33,33,0,2
181499,9to14,9,14,0.000226993649635,-17.2152696089966,1919,1919,0,3
181514,14to9,14,9,0.994175536542712,-5.13076416031772,30,30,0,3
181530,9to4,9,4,0.972333434093129,-8.85273758710149,63,63,0,3
181547,4to9,4,9,0.91748377665666,-11.4078206525479,33,33,0,2
181564,9to8,9,8,0.027439572257236,-12.4204501574849,632,632,0,3
181582,8to3,8,3,0.227014077405999,-4.11464622477799,162,162,0,4
181598,3to4,3,4,0.979247382023731,-4.3200135082935,68,68,0,3
181615,4to9,4,9,0.91748377665666,-11.4078206525479,68,68,0,2
181630,9to4,9,4,0.972333434093129,-8.85273758710149,32,32,0,3
181644,4to9,4,9,0.91748377665666,-11.4078206525479,29,29,0,2
181660,9to4,9,4,0.972333434093129,-8.85273758710149,30,30,0,3
181675,4to9,4,9,0.91748377665666,-11.4078206525479,31,31,0,2
181690,9to4,9,4,0.972333434093129,-8.85273758710149,30,30,0,3
181705,4to9,4,9,0.91748377665666,-11.4078206525479,30,30,0,2
181721,9to4,9,4,0.972333434093129,-8.85273758710149,31,31,0,3
181737,4to9,4,9,0.91748377665666,-11.4078206525479,32,32,0,2
181752,9to4,9,4,0.972333434093129,-8.85273758710149,31,31,0,3
181768,4to3,4,3,0.08251622334334,-13.816460629608,186,186,0,2
181783,3to4,3,4,0.979247382023731,-4.3200135082935,31,31,0,3
181798,4to3,4,3,0.08251622334334,-13.816460629608,30,30,0,2
181814,3to4,3,4,0.979247382023731,-4.3200135082935,31,31,0,3
181830,4to9,4,9,0.91748377665666,-11.4078206525479,93,93,0,2
181846,9to14,9,14,0.000226993649635,-17.2152696089966,347,347,0,3
181862,14to9,14,9,0.994175536542712,-5.13076416031772,32,32,0,3
181879,9to4,9,4,0.972333434093129,-8.85273758710149,65,65,0,3
181895,4to9,4,9,0.91748377665666,-11.4078206525479,33,33,0,2
181911,9to4,9,4,0.972333434093129,-8.85273758710149,32,32,0,3
181927,4to9,4,9,0.91748377665666,-11.4078206525479,32,32,0,2
181943,9to4,9,4,0.972333434093129,-8.85273758710149,32,32,0,3
181960,4to9,4,9,0.91748377665666,-11.4078206525479,33,33,0,2
181976,9to4,9,4,0.972333434093129,-8.85273758710149,33,33,0,3
181992,4to3,4,3,0.08251622334334,-13.816460629608,194,194,0,2
182007,3to4,3,4,0.979247382023731,-4.3200135082935,31,31,0,3
182024,4to9,4,9,0.91748377665666,-11.4078206525479,64,64,0,2
182039,9to4,9,4,0.972333434093129,-8.85273758710149,32,32,0,3
182055,4to9,4,9,0.91748377665666,-11.4078206525479,31,31,0,2
182072,9to4,9,4,0.972333434093129,-8.85273758710149,33,33,0,3
182087,4to9,4,9,0.91748377665666,-11.4078206525479,32,32,0,2
182102,9to4,9,4,0.972333434093129,-8.85273758710149,30,30,0,3
182117,4to9,4,9,0.91748377665666,-11.4078206525479,30,30,0,2
182132,9to8,9,8,0.027439572257236,-12.4204501574849,568,568,0,3
182148,8to3,8,3,0.227014077405999,-4.11464622477799,156,156,0,4
182164,3to4,3,4,0.979247382023731,-4.3200135082935,62,62,0,3
182180,4to9,4,9,0.91748377665666,-11.4078206525479,63,63,0,2
182196,9to4,9,4,0.972333434093129,-8.85273758710149,32,32,0,3
182210,4to9,4,9,0.91748377665666,-11.4078206525479,30,30,0,2
182225,9to8,9,8,0.027439572257236,-12.4204501574849,93,93,0,3
182242,8to3,8,3,0.227014077405999,-4.11464622477799,94,94,0,4
182259,3to4,3,4,0.979247382023731,-4.3200135082935,63,63,0,3
182274,4to9,4,9,0.91748377665666,-11.4078206525479,64,64,0,2
182289,9to4,9,4,0.972333434093129,-8.85273758710149,30,30,0,3
182306,4to9,4,9,0.91748377665666,-11.4078206525479,32,32,0,2
182321,9to4,9,4,0.972333434093129,-8.85273758710149,32,32,0,3
182336,4to9,4,9,0.91748377665666,-11.4078206525479,30,30,0,2
182352,9to4,9,4,0.972333434093129,-8.85273758710149,31,31,0,3
182367,4to9,4,9,0.91748377665666,-11.4078206525479,31,31,0,2
182382,9to4,9,4,0.972333434093129,-8.85273758710149,30,30,0,3
182398,4to9,4,9,0.91748377665666,-11.4078206525479,31,31,0,2
182413,9to4,9,4,0.972333434093129,-8.85273758710149,31,31,0,3
182430,4to3,4,3,0.08251622334334,-13.816460629608,188,188,0,2
182445,3to4,3,4,0.979247382023731,-4.3200135082935,32,32,0,3
182460,4to9,4,9,0.91748377665666,-11.4078206525479,62,62,0,2
182475,9to4,9,4,0.972333434093129,-8.85273758710149,30,30,0,3
182490,4to9,4,9,0.91748377665666,-11.4078206525479,30,30,0,2
182506,9to4,9,4,0.972333434093129,-8.85273758710149,31,31,0,3
182521,4to9,4,9,0.91748377665666,-11.4078206525479,31,31,0,2
182537,9to4,9,4,0.972333434093129,-8.85273758710149,31,31,0,3
182551,4to9,4,9,0.91748377665666,-11.4078206525479,30,30,0,2
182566,9to4,9,4,0.972333434093129,-8.85273758710149,29,29,0,3
182580,4to9,4,9,0.91748377665666,-11.4078206525479,29,29,0,2
182596,9to4,9,4,0.972333434093129,-8.85273758710149,30,30,0,3
182611,4to9,4,9,0.91748377665666,-11.4078206525479,31,31,0,2
182628,9to4,9,4,0.972333434093129,-8.85273758710149,32,32,0,3
182643,4to3,4,3,0.08251622334334,-13.816460629608,213,213,0,2
182659,3to4,3,4,0.979247382023731,-4.3200135082935,31,31,0,3
182674,4to3,4,3,0.08251622334334,-13.816460629608,31,31,0,2
182690,3to4,3,4,0.979247382023731,-4.3200135082935,31,31,0,3
182706,4to9,4,9,0.91748377665666,-11.4078206525479,95,95,0,2
182722,9to4,9,4,0.972333434093129,-8.85273758710149,32,32,0,3
182737,4to9,4,9,0.91748377665666,-11.4078206525479,31,31,0,2
182752,9to4,9,4,0.972333434093129,-8.85273758710149,30,30,0,3
182769,4to9,4,9,0.91748377665666,-11.4078206525479,32,32,0,2
182784,9to4,9,4,0.972333434093129,-8.85273758710149,32,32,0,3
182800,4to9,4,9,0.91748377665666,-11.4078206525479,31,31,0,2
182815,9to8,9,8,0.027439572257236,-12.4204501574849,590,590,0,3
182832,8to3,8,3,0.227014077405999,-4.11464622477799,158,158,0,4
182847,3to2,3,2,0.00068093563244,-11.5910853038632,3142,3142,0,3
182863,2to3,2,3,0.998447808871189,-3.95697141540815,31,31,0,3
182878,3to4,3,4,0.979247382023731,-4.3200135082935,94,94,0,3
182895,4to9,4,9,0.91748377665666,-11.4078206525479,95,95,0,2
182910,9to4,9,4,0.972333434093129,-8.85273758710149,32,32,0,3
182926,4to9,4,9,0.91748377665666,-11.4078206525479,31,31,0,2
182942,9to14,9,14,0.000226993649635,-17.2152696089966,1096,1096,0,3
182957,14to13,14,13,0.005822192786246,-10.2710009893219,3203,3203,0,3
182972,13to8,13,8,0.917351022044606,-7.37455157477482,157,157,0,4
182988,8to9,8,9,0.769052262769502,-2.89449932615566,62,62,0,4
183005,9to4,9,4,0.972333434093129,-8.85273758710149,95,95,0,3
183021,4to9,4,9,0.91748377665666,-11.4078206525479,33,33,0,2
183037,9to4,9,4,0.972333434093129,-8.85273758710149,32,32,0,3
183051,4to9,4,9,0.91748377665666,-11.4078206525479,30,30,0,2
183065,9to4,9,4,0.972333434093129,-8.85273758710149,28,28,0,3
183081,4to3,4,3,0.08251622334334,-13.816460629608,218,218,0,2
183098,3to4,3,4,0.979247382023731,-4.3200135082935,33,33,0,3
183114,4to9,4,9,0.91748377665666,-11.4078206525479,63,63,0,2
183130,9to4,9,4,0.972333434093129,-8.85273758710149,32,32,0,3
183146,4to9,4,9,0.91748377665666,-11.4078206525479,32,32,0,2
183164,9to4,9,4,0.972333434093129,-8.85273758710149,34,34,0,3
183180,4to9,4,9,0.91748377665666,-11.4078206525479,34,34,0,2
183196,9to4,9,4,0.972333434093129,-8.85273758710149,32,32,0,3
183210,4to9,4,9,0.91748377665666,-11.4078206525479,30,30,0,2
183227,9to4,9,4,0.972333434093129,-8.85273758710149,31,31,0,3
183242,4to9,4,9,0.91748377665666,-11.4078206525479,32,32,0,2
183258,9to4,9,4,0.972333434093129,-8.85273758710149,31,31,0,3
183273,4to9,4,9,0.91748377665666,-11.4078206525479,31,31,0,2
183290,9to4,9,4,0.972333434093129,-8.85273758710149,32,32,0,3
183307,4to3,4,3,0.08251622334334,-13.816460629608,226,226,0,2
183323,3to4,3,4,0.979247382023731,-4.3200135082935,33,33,0,3
183340,4to9,4,9,0.91748377665666,-11.4078206525479,67,67,0,2
183356,9to14,9,14,0.000226993649635,-17.2152696089966,414,414,0,3
183371,14to9,14,9,0.994175536542712,-5.13076416031772,31,31,0,3
183387,9to4,9,4,0.972333434093129,-8.85273758710149,64,64,0,3
183402,4to9,4,9,0.91748377665666,-11.4078206525479,31,31,0,2
183418,9to4,9,4,0.972333434093129,-8.85273758710149,31,31,0,3
183433,4to3,4,3,0.08251622334334,-13.816460629608,126,126,0,2
183449,3to4,3,4,0.979247382023731,-4.3200135082935,31,31,0,3
183465,4to9,4,9,0.91748377665666,-11.4078206525479,63,63,0,2
183480,9to4,9,4,0.972333434093129,-8.85273758710149,31,31,0,3
183495,4to3,4,3,0.08251622334334,-13.816460629608,62,62,0,2
183511,3to4,3,4,0.979247382023731,-4.3200135082935,31,31,0,3
183527,4to9,4,9,0.91748377665666,-11.4078206525479,62,62,0,2
183542,9to4,9,4,0.972333434093129,-8.85273758710149,31,31,0,3
183559,4to9,4,9,0.91748377665666,-11.4078206525479,32,32,0,2
183575,9to4,9,4,0.972333434093129,-8.85273758710149,33,33,0,3
183592,4to9,4,9,0.91748377665666,-11.4078206525479,33,33,0,2
183608,9to8,9,8,0.027439572257236,-12.4204501574849,636,636,0,3
183624,8to3,8,3,0.227014077405999,-4.11464622477799,129,129,0,4
183641,3to4,3,4,0.979247382023731,-4.3200135082935,66,66,0,3
183657,4to9,4,9,0.91748377665666,-11.4078206525479,65,65,0,2
183671,9to4,9,4,0.972333434093129,-8.85273758710149,30,30,0,3
183686,4to9,4,9,0.91748377665666,-11.4078206525479,29,29,0,2
183702,9to4,9,4,0.972333434093129,-8.85273758710149,31,31,0,3
183718,4to3,4,3,0.08251622334334,-13.816460629608,94,94,0,2
183733,3to4,3,4,0.979247382023731,-4.3200135082935,31,31,0,3
183748,4to9,4,9,0.91748377665666,-11.4078206525479,62,62,0,2
183762,9to4,9,4,0.972333434093129,-8.85273758710149,29,29,0,3
183776,4to9,4,9,0.91748377665666,-11.4078206525479,28,28,0,2
183791,9to4,9,4,0.972333434093129,-8.85273758710149,29,29,0,3
183808,4to9,4,9,0.91748377665666,-11.4078206525479,32,32,0,2
183824,9to4,9,4,0.972333434093129,-8.85273758710149,33,33,0,3
183839,4to9,4,9,0.91748377665666,-11.4078206525479,31,31,0,2
183855,9to4,9,4,0.972333434093129,-8.85273758710149,31,31,0,3
183869,4to9,4,9,0.91748377665666,-11.4078206525479,30,30,0,2
183884,9to4,9,4,0.972333434093129,-8.85273758710149,29,29,0,3
183901,4to3,4,3,0.08251622334334,-13.816460629608,183,183,0,2
183918,3to4,3,4,0.979247382023731,-4.3200135082935,34,34,0,3
183933,4to9,4,9,0.91748377665666,-11.4078206525479,64,64,0,2
183948,9to4,9,4,0.972333434093129,-8.85273758710149,30,30,0,3
183963,4to9,4,9,0.91748377665666,-11.4078206525479,30,30,0,2
183978,9to4,9,4,0.972333434093129,-8.85273758710149,30,30,0,3
183994,4to9,4,9,0.91748377665666,-11.4078206525479,31,31,0,2
184009,9to4,9,4,0.972333434093129,-8.85273758710149,31,31,0,3
184026,4to9,4,9,0.91748377665666,-11.4078206525479,32,32,0,2
184043,9to4,9,4,0.972333434093129,-8.85273758710149,34,34,0,3
184058,4to9,4,9,0.91748377665666,-11.4078206525479,32,32,0,2
184073,9to4,9,4,0.972333434093129,-8.85273758710149,30,30,0,3
184088,4to9,4,9,0.91748377665666,-11.4078206525479,30,30,0,2
184104,9to4,9,4,0.972333434093129,-8.85273758710149,31,31,0,3
184119,4to3,4,3,0.08251622334334,-13.816460629608,218,218,0,2
184136,3to4,3,4,0.979247382023731,-4.3200135082935,32,32,0,3
184153,4to9,4,9,0.91748377665666,-11.4078206525479,65,65,0,2
184168,9to4,9,4,0.972333434093129,-8.85273758710149,32,32,0,3
184183,4to9,4,9,0.91748377665666,-11.4078206525479,30,30,0,2
184200,9to8,9,8,0.027439572257236,-12.4204501574849,592,592,0,3
184216,8to3,8,3,0.227014077405999,-4.11464622477799,97,97,0,4
184233,3to4,3,4,0.979247382023731,-4.3200135082935,65,65,0,3
184250,4to9,4,9,0.91748377665666,-11.4078206525479,67,67,0,2
184265,9to4,9,4,0.972333434093129,-8.85273758710149,32,32,0,3
184281,4to9,4,9,0.91748377665666,-11.4078206525479,31,31,0,2
184297,9to4,9,4,0.972333434093129,-8.85273758710149,32,32,0,3
184312,4to3,4,3,0.08251622334334,-13.816460629608,96,96,0,2
184329,3to8,3,8,0.020071682343829,-8.20748782428216,129,129,0,3
184345,8to9,8,9,0.769052262769502,-2.89449932615566,64,64,0,4
184362,9to4,9,4,0.972333434093129,-8.85273758710149,65,65,0,3
184377,4to9,4,9,0.91748377665666,-11.4078206525479,32,32,0,2
184393,9to4,9,4,0.972333434093129,-8.85273758710149,31,31,0,3
184408,4to9,4,9,0.91748377665666,-11.4078206525479,31,31,0,2
184424,9to4,9,4,0.972333434093129,-8.85273758710149,31,31,0,3
184441,4to9,4,9,0.91748377665666,-11.4078206525479,33,33,0,2
184455,9to4,9,4,0.972333434093129,-8.85273758710149,31,31,0,3
184472,4to9,4,9,0.91748377665666,-11.4078206525479,31,31,0,2
184487,9to4,9,4,0.972333434093129,-8.85273758710149,32,32,0,3
184504,4to3,4,3,0.08251622334334,-13.816460629608,192,192,0,2
184519,3to4,3,4,0.979247382023731,-4.3200135082935,32,32,0,3
184534,4to9,4,9,0.91748377665666,-11.4078206525479,62,62,0,2
184550,9to4,9,4,0.972333434093129,-8.85273758710149,31,31,0,3
184566,4to9,4,9,0.91748377665666,-11.4078206525479,32,32,0,2
184581,9to4,9,4,0.972333434093129,-8.85273758710149,31,31,0,3
184596,4to9,4,9,0.91748377665666,-11.4078206525479,30,30,0,2
184611,9to4,9,4,0.972333434093129,-8.85273758710149,30,30,0,3
184626,4to9,4,9,0.91748377665666,-11.4078206525479,30,30,0,2
184640,9to4,9,4,0.972333434093129,-8.85273758710149,29,29,0,3
184656,4to9,4,9,0.91748377665666,-11.4078206525479,30,30,0,2
184671,9to4,9,4,0.972333434093129,-8.85273758710149,31,31,0,3
184686,4to3,4,3,0.08251622334334,-13.816460629608,182,182,0,2
184702,3to4,3,4,0.979247382023731,-4.3200135082935,31,31,0,3
184718,4to9,4,9,0.91748377665666,-11.4078206525479,62,62,0,2
184734,9to4,9,4,0.972333434093129,-8.85273758710149,32,32,0,3
184750,4to9,4,9,0.91748377665666,-11.4078206525479,32,32,0,2
184767,9to4,9,4,0.972333434093129,-8.85273758710149,33,33,0,3
184782,4to9,4,9,0.91748377665666,-11.4078206525479,32,32,0,2
184797,9to4,9,4,0.972333434093129,-8.85273758710149,30,30,0,3
184813,4to9,4,9,0.91748377665666,-11.4078206525479,31,31,0,2
184830,9to14,9,14,0.000226993649635,-17.2152696089966,1474,1474,0,3
184845,14to9,14,9,0.994175536542712,-5.13076416031772,32,32,0,3
184861,9to4,9,4,0.972333434093129,-8.85273758710149,64,64,0,3
184875,4to9,4,9,0.91748377665666,-11.4078206525479,30,30,0,2
184892,9to8,9,8,0.027439572257236,-12.4204501574849,563,563,0,3
184909,8to3,8,3,0.227014077405999,-4.11464622477799,223,223,0,4
184925,3to4,3,4,0.979247382023731,-4.3200135082935,64,64,0,3
184941,4to9,4,9,0.91748377665666,-11.4078206525479,66,66,0,2
184957,9to4,9,4,0.972333434093129,-8.85273758710149,32,32,0,3
184972,4to9,4,9,0.91748377665666,-11.4078206525479,31,31,0,2
184989,9to4,9,4,0.972333434093129,-8.85273758710149,32,32,0,3
185006,4to9,4,9,0.91748377665666,-11.4078206525479,34,34,0,2
185021,9to14,9,14,0.000226993649635,-17.2152696089966,191,191,0,3
185038,14to9,14,9,0.994175536542712,-5.13076416031772,32,32,0,3
185055,9to4,9,4,0.972333434093129,-8.85273758710149,66,66,0,3
185071,4to9,4,9,0.91748377665666,-11.4078206525479,33,33,0,2
185087,9to4,9,4,0.972333434093129,-8.85273758710149,32,32,0,3
185103,4to3,4,3,0.08251622334334,-13.816460629608,194,194,0,2
185118,3to4,3,4,0.979247382023731,-4.3200135082935,31,31,0,3
185135,4to9,4,9,0.91748377665666,-11.4078206525479,64,64,0,2
185150,9to4,9,4,0.972333434093129,-8.85273758710149,32,32,0,3
185166,4to9,4,9,0.91748377665666,-11.4078206525479,31,31,0,2
185182,9to4,9,4,0.972333434093129,-8.85273758710149,32,32,0,3
185197,4to9,4,9,0.91748377665666,-11.4078206525479,31,31,0,2
185213,9to4,9,4,0.972333434093129,-8.85273758710149,31,31,0,3
185230,4to9,4,9,0.91748377665666,-11.4078206525479,33,33,0,2
185246,9to4,9,4,0.972333434093129,-8.85273758710149,33,33,0,3
185261,4to9,4,9,0.91748377665666,-11.4078206525479,31,31,0,2
185276,9to4,9,4,0.972333434093129,-8.85273758710149,30,30,0,3
185291,4to3,4,3,0.08251622334334,-13.816460629608,188,188,0,2
185307,3to4,3,4,0.979247382023731,-4.3200135082935,31,31,0,3
185323,4to9,4,9,0.91748377665666,-11.4078206525479,62,62,0,2
185338,9to4,9,4,0.972333434093129,-8.85273758710149,31,31,0,3
185354,4to9,4,9,0.91748377665666,-11.4078206525479,31,31,0,2
185370,9to4,9,4,0.972333434093129,-8.85273758710149,32,32,0,3
185385,4to9,4,9,0.91748377665666,-11.4078206525479,31,31,0,2
185401,9to4,9,4,0.972333434093129,-8.85273758710149,31,31,0,3
185416,4to9,4,9,0.91748377665666,-11.4078206525479,31,31,0,2
185432,9to14,9,14,0.000226993649635,-17.2152696089966,411,411,0,3
185448,14to9,14,9,0.994175536542712,-5.13076416031772,32,32,0,3
185465,9to4,9,4,0.972333434093129,-8.85273758710149,64,64,0,3
185481,4to9,4,9,0.91748377665666,-11.4078206525479,33,33,0,2
185498,9to8,9,8,0.027439572257236,-12.4204501574849,606,606,0,3
185514,8to3,8,3,0.227014077405999,-4.11464622477799,223,223,0,4
185531,3to4,3,4,0.979247382023731,-4.3200135082935,66,66,0,3
185547,4to9,4,9,0.91748377665666,-11.4078206525479,66,66,0,2
185562,9to4,9,4,0.972333434093129,-8.85273758710149,31,31,0,3
185577,4to9,4,9,0.91748377665666,-11.4078206525479,30,30,0,2
185593,9to4,9,4,0.972333434093129,-8.85273758710149,31,31,0,3
185609,4to3,4,3,0.08251622334334,-13.816460629608,95,95,0,2
185624,3to4,3,4,0.979247382023731,-4.3200135082935,31,31,0,3
185641,4to9,4,9,0.91748377665666,-11.4078206525479,64,64,0,2
185656,9to4,9,4,0.972333434093129,-8.85273758710149,32,32,0,3
185672,4to9,4,9,0.91748377665666,-11.4078206525479,31,31,0,2
185687,9to4,9,4,0.972333434093129,-8.85273758710149,31,31,0,3
185703,4to9,4,9,0.91748377665666,-11.4078206525479,31,31,0,2
185719,9to14,9,14,0.000226993649635,-17.2152696089966,287,287,0,3
185736,14to13,14,13,0.002155961101337,-11.2681222559645,2779,8,2771,3
185752,13to8,13,8,0.917351022044606,-7.37455157477482,254,254,0,4
185767,8to9,8,9,0.769052262769502,-2.89449932615566,64,64,0,4
185784,9to14,9,14,0.000152169781338,-17.6152696089966,65,39,26,3
185800,14to9,14,9,0.997841759854063,-5.13076416031772,33,33,0,3
185818,9to4,9,4,0.972406204360331,-8.85273758710149,131,131,0,3
185834,4to3,4,3,0.08251622334334,-13.816460629608,225,225,0,2
185850,3to4,3,4,0.979247382023731,-4.3200135082935,32,32,0,3
185866,4to9,4,9,0.91748377665666,-11.4078206525479,66,66,0,2
185881,9to4,9,4,0.972406204360331,-8.85273758710149,31,31,0,3
185897,4to9,4,9,0.91748377665666,-11.4078206525479,31,31,0,2
185913,9to4,9,4,0.972406204360331,-8.85273758710149,32,32,0,3
185929,4to9,4,9,0.91748377665666,-11.4078206525479,32,32,0,2
185943,9to4,9,4,0.972406204360331,-8.85273758710149,30,30,0,3
185958,4to9,4,9,0.91748377665666,-11.4078206525479,29,29,0,2
185975,9to14,9,14,0.000152169781338,-17.6152696089966,191,191,0,3
185993,14to9,14,9,0.997841759854063,-5.13076416031772,35,35,0,3
186010,9to4,9,4,0.972406204360331,-8.85273758710149,67,67,0,3
186026,4to9,4,9,0.91748377665666,-11.4078206525479,33,33,0,2
186043,9to4,9,4,0.972406204360331,-8.85273758710149,33,33,0,3
186058,4to3,4,3,0.08251622334334,-13.816460629608,224,224,0,2
186072,3to4,3,4,0.979247382023731,-4.3200135082935,29,29,0,3
186089,4to9,4,9,0.91748377665666,-11.4078206525479,63,63,0,2
186106,9to14,9,14,0.000152169781338,-17.6152696089966,131,131,0,3
186122,14to9,14,9,0.997841759854063,-5.13076416031772,33,33,0,3
186138,9to4,9,4,0.972406204360331,-8.85273758710149,66,66,0,3
186152,4to9,4,9,0.91748377665666,-11.4078206525479,30,30,0,2
186166,9to4,9,4,0.972406204360331,-8.85273758710149,28,28,0,3
186182,4to9,4,9,0.91748377665666,-11.4078206525479,30,30,0,2
186197,9to4,9,4,0.972406204360331,-8.85273758710149,31,31,0,3
186213,4to9,4,9,0.91748377665666,-11.4078206525479,31,31,0,2
186229,9to4,9,4,0.972406204360331,-8.85273758710149,32,32,0,3
186244,4to9,4,9,0.91748377665666,-11.4078206525479,31,31,0,2
186260,9to4,9,4,0.972406204360331,-8.85273758710149,31,31,0,3
186276,4to3,4,3,0.08251622334334,-13.816460629608,218,218,0,2
186292,3to4,3,4,0.979247382023731,-4.3200135082935,32,32,0,3
186308,4to9,4,9,0.91748377665666,-11.4078206525479,64,64,0,2
186325,9to8,9,8,0.027441625858331,-12.4204501574849,573,573,0,3
186340,8to9,8,9,0.769052262769502,-2.89449932615566,32,32,0,4
186356,9to4,9,4,0.972406204360331,-8.85273758710149,64,64,0,3
186373,4to9,4,9,0.91748377665666,-11.4078206525479,33,33,0,2
186388,9to4,9,4,0.972406204360331,-8.85273758710149,32,32,0,3
186403,4to9,4,9,0.91748377665666,-11.4078206525479,30,30,0,2
186420,9to4,9,4,0.972406204360331,-8.85273758710149,32,32,0,3
186435,4to9,4,9,0.91748377665666,-11.4078206525479,32,32,0,2
186450,9to4,9,4,0.972406204360331,-8.85273758710149,30,30,0,3
186466,4to3,4,3,0.08251622334334,-13.816460629608,190,190,0,2
186481,3to4,3,4,0.979247382023731,-4.3200135082935,31,31,0,3
186497,4to9,4,9,0.91748377665666,-11.4078206525479,62,62,0,2
186512,9to4,9,4,0.972406204360331,-8.85273758710149,31,31,0,3
186527,4to9,4,9,0.91748377665666,-11.4078206525479,30,30,0,2
186542,9to4,9,4,0.972406204360331,-8.85273758710149,30,30,0,3
186557,4to9,4,9,0.91748377665666,-11.4078206525479,30,30,0,2
186572,9to4,9,4,0.972406204360331,-8.85273758710149,30,30,0,3
186587,4to9,4,9,0.91748377665666,-11.4078206525479,30,30,0,2
186602,9to4,9,4,0.972406204360331,-8.85273758710149,30,30,0,3
186617,4to9,4,9,0.91748377665666,-11.4078206525479,30,30,0,2
186633,9to4,9,4,0.972406204360331,-8.85273758710149,31,31,0,3
186648,4to9,4,9,0.91748377665666,-11.4078206525479,31,31,0,2
186664,9to4,9,4,0.972406204360331,-8.85273758710149,31,31,0,3
186680,4to3,4,3,0.08251622334334,-13.816460629608,214,214,0,2
186697,3to4,3,4,0.979247382023731,-4.3200135082935,33,33,0,3
186713,4to9,4,9,0.91748377665666,-11.4078206525479,65,65,0,2
186731,9to4,9,4,0.972406204360331,-8.85273758710149,34,34,0,3
186747,4to9,4,9,0.91748377665666,-11.4078206525479,34,34,0,2
186762,9to4,9,4,0.972406204360331,-8.85273758710149,31,31,0,3
186779,4to9,4,9,0.91748377665666,-11.4078206525479,32,32,0,2
186795,9to4,9,4,0.972406204360331,-8.85273758710149,33,33,0,3
186810,4to9,4,9,0.91748377665666,-11.4078206525479,31,31,0,2
186826,9to4,9,4,0.972406204360331,-8.85273758710149,31,31,0,3
186840,4to3,4,3,0.08251622334334,-13.816460629608,160,160,0,2
186856,3to4,3,4,0.979247382023731,-4.3200135082935,30,30,0,3
186872,4to9,4,9,0.91748377665666,-11.4078206525479,62,62,0,2
186887,9to4,9,4,0.972406204360331,-8.85273758710149,31,31,0,3
186904,4to9,4,9,0.91748377665666,-11.4078206525479,32,32,0,2
186919,9to4,9,4,0.972406204360331,-8.85273758710149,32,32,0,3
186933,4to9,4,9,0.91748377665666,-11.4078206525479,29,29,0,2
186948,9to8,9,8,0.027441625858331,-12.4204501574849,623,623,0,3
186964,8to3,8,3,0.227014077405999,-4.11464622477799,124,124,0,4
186979,3to4,3,4,0.979247382023731,-4.3200135082935,60,60,0,3
186997,4to9,4,9,0.91748377665666,-11.4078206525479,64,64,0,2
187013,9to14,9,14,0.000152169781338,-17.6152696089966,907,907,0,3
187029,14to9,14,9,0.997841759854063,-5.13076416031772,32,32,0,3
187045,9to4,9,4,0.972406204360331,-8.85273758710149,66,66,0,3
187061,4to9,4,9,0.91748377665666,-11.4078206525479,32,32,0,2
187078,9to4,9,4,0.972406204360331,-8.85273758710149,33,33,0,3
187093,4to9,4,9,0.91748377665666,-11.4078206525479,32,32,0,2
187109,9to4,9,4,0.972406204360331,-8.85273758710149,31,31,0,3
187124,4to9,4,9,0.91748377665666,-11.4078206525479,31,31,0,2
187139,9to4,9,4,0.972406204360331,-8.85273758710149,30,30,0,3
187154,4to3,4,3,0.08251622334334,-13.816460629608,190,190,0,2
187169,3to4,3,4,0.979247382023731,-4.3200135082935,30,30,0,3
187184,4to9,4,9,0.91748377665666,-11.4078206525479,60,60,0,2
187200,9to14,9,14,0.000152169781338,-17.6152696089966,187,187,0,3
187216,14to9,14,9,0.997841759854063,-5.13076416031772,32,32,0,3
187230,9to4,9,4,0.972406204360331,-8.85273758710149,61,61,0,3
187246,4to9,4,9,0.91748377665666,-11.4078206525479,30,30,0,2
187261,9to4,9,4,0.972406204360331,-8.85273758710149,31,31,0,3
187277,4to9,4,9,0.91748377665666,-11.4078206525479,31,31,0,2
187293,9to4,9,4,0.972406204360331,-8.85273758710149,32,32,0,3
187309,4to3,4,3,0.08251622334334,-13.816460629608,155,155,0,2
187325,3to4,3,4,0.979247382023731,-4.3200135082935,32,32,0,3
187342,4to3,4,3,0.08251622334334,-13.816460629608,33,33,0,2
187358,3to4,3,4,0.979247382023731,-4.3200135082935,33,33,0,3
187374,4to9,4,9,0.91748377665666,-11.4078206525479,97,97,0,2
187389,9to4,9,4,0.972406204360331,-8.85273758710149,31,31,0,3
187406,4to9,4,9,0.91748377665666,-11.4078206525479,32,32,0,2
187421,9to4,9,4,0.972406204360331,-8.85273758710149,32,32,0,3
187437,4to9,4,9,0.91748377665666,-11.4078206525479,31,31,0,2
187452,9to4,9,4,0.972406204360331,-8.85273758710149,31,31,0,3
187467,4to9,4,9,0.91748377665666,-11.4078206525479,30,30,0,2
187482,9to4,9,4,0.972406204360331,-8.85273758710149,30,30,0,3
187498,4to9,4,9,0.91748377665666,-11.4078206525479,31,31,0,2
187514,9to4,9,4,0.972406204360331,-8.85273758710149,32,32,0,3
187530,4to9,4,9,0.91748377665666,-11.4078206525479,32,32,0,2
187546,9to8,9,8,0.027441625858331,-12.4204501574849,598,598,0,3
187561,8to3,8,3,0.227014077405999,-4.11464622477799,219,219,0,4
187579,3to4,3,4,0.979247382023731,-4.3200135082935,65,65,0,3
187594,4to9,4,9,0.91748377665666,-11.4078206525479,64,64,0,2
187611,9to4,9,4,0.972406204360331,-8.85273758710149,32,32,0,3
187628,4to9,4,9,0.91748377665666,-11.4078206525479,34,34,0,2
187645,9to4,9,4,0.972406204360331,-8.85273758710149,34,34,0,3
187661,4to9,4,9,0.91748377665666,-11.4078206525479,33,33,0,2
187676,9to4,9,4,0.972406204360331,-8.85273758710149,31,31,0,3
187691,4to9,4,9,0.91748377665666,-11.4078206525479,30,30,0,2
187707,9to8,9,8,0.027441625858331,-12.4204501574849,161,161,0,3
187722,8to3,8,3,0.227014077405999,-4.11464622477799,161,161,0,4
187739,3to4,3,4,0.979247382023731,-4.3200135082935,63,63,0,3
187756,4to9,4,9,0.91748377665666,-11.4078206525479,65,65,0,2
187772,9to4,9,4,0.972406204360331,-8.85273758710149,33,33,0,3
187788,4to9,4,9,0.91748377665666,-11.4078206525479,32,32,0,2
187803,9to4,9,4,0.972406204360331,-8.85273758710149,31,31,0,3
187818,4to9,4,9,0.91748377665666,-11.4078206525479,30,30,0,2
187833,9to4,9,4,0.972406204360331,-8.85273758710149,30,30,0,3
187848,4to9,4,9,0.91748377665666,-11.4078206525479,30,30,0,2
187863,9to4,9,4,0.972406204360331,-8.85273758710149,30,30,0,3
187879,4to9,4,9,0.91748377665666,-11.4078206525479,31,31,0,2
187894,9to4,9,4,0.972406204360331,-8.85273758710149,31,31,0,3
187911,4to3,4,3,0.08251622334334,-13.816460629608,189,189,0,2
187925,3to4,3,4,0.979247382023731,-4.3200135082935,31,31,0,3
187942,4to9,4,9,0.91748377665666,-11.4078206525479,63,63,0,2
187958,9to4,9,4,0.972406204360331,-8.85273758710149,33,33,0,3
187974,4to9,4,9,0.91748377665666,-11.4078206525479,32,32,0,2
187988,9to4,9,4,0.972406204360331,-8.85273758710149,30,30,0,3
188003,4to9,4,9,0.91748377665666,-11.4078206525479,29,29,0,2
188017,9to4,9,4,0.972406204360331,-8.85273758710149,29,29,0,3
188034,4to9,4,9,0.91748377665666,-11.4078206525479,31,31,0,2
188048,9to4,9,4,0.972406204360331,-8.85273758710149,31,31,0,3
188064,4to9,4,9,0.91748377665666,-11.4078206525479,30,30,0,2
188081,9to8,9,8,0.027441625858331,-12.4204501574849,374,374,0,3
188097,8to3,8,3,0.227014077405999,-4.11464622477799,186,186,0,4
188113,3to4,3,4,0.979247382023731,-4.3200135082935,65,65,0,3
188129,4to9,4,9,0.91748377665666,-11.4078206525479,65,65,0,2
188144,9to4,9,4,0.972406204360331,-8.85273758710149,31,31,0,3
188161,4to9,4,9,0.91748377665666,-11.4078206525479,32,32,0,2
188177,9to4,9,4,0.972406204360331,-8.85273758710149,33,33,0,3
188192,4to9,4,9,0.91748377665666,-11.4078206525479,31,31,0,2
188208,9to4,9,4,0.972406204360331,-8.85273758710149,31,31,0,3
188225,4to9,4,9,0.91748377665666,-11.4078206525479,33,33,0,2
188241,9to4,9,4,0.972406204360331,-8.85273758710149,33,33,0,3
188255,4to9,4,9,0.91748377665666,-11.4078206525479,30,30,0,2
188269,9to4,9,4,0.972406204360331,-8.85273758710149,28,28,0,3
188284,4to3,4,3,0.08251622334334,-13.816460629608,187,187,0,2
188300,3to4,3,4,0.979247382023731,-4.3200135082935,31,31,0,3
188315,4to9,4,9,0.91748377665666,-11.4078206525479,60,60,0,2
188329,9to4,9,4,0.972406204360331,-8.85273758710149,29,29,0,3
188344,4to9,4,9,0.91748377665666,-11.4078206525479,29,29,0,2
188361,9to14,9,14,0.000152169781338,-17.6152696089966,1161,1161,0,3
188375,14to9,14,9,0.997841759854063,-5.13076416031772,31,31,0,3
188391,9to4,9,4,0.972406204360331,-8.85273758710149,62,62,0,3
188407,4to9,4,9,0.91748377665666,-11.4078206525479,32,32,0,2
188423,9to4,9,4,0.972406204360331,-8.85273758710149,32,32,0,3
188438,4to9,4,9,0.91748377665666,-11.4078206525479,31,31,0,2
188453,9to14,9,14,0.000152169781338,-17.6152696089966,92,92,0,3
188469,14to9,14,9,0.997841759854063,-5.13076416031772,31,31,0,3
188484,9to4,9,4,0.972406204360331,-8.85273758710149,61,61,0,3
188500,4to3,4,3,0.08251622334334,-13.816460629608,216,216,0,2
188515,3to4,3,4,0.979247382023731,-4.3200135082935,31,31,0,3
188530,4to9,4,9,0.91748377665666,-11.4078206525479,61,61,0,2
188545,9to4,9,4,0.972406204360331,-8.85273758710149,30,30,0,3
188560,4to9,4,9,0.91748377665666,-11.4078206525479,30,30,0,2
188576,9to4,9,4,0.972406204360331,-8.85273758710149,31,31,0,3
188593,4to9,4,9,0.91748377665666,-11.4078206525479,33,33,0,2
188608,9to4,9,4,0.972406204360331,-8.85273758710149,32,32,0,3
188624,4to3,4,3,0.08251622334334,-13.816460629608,124,124,0,2
188639,3to4,3,4,0.979247382023731,-4.3200135082935,31,31,0,3
188654,4to9,4,9,0.91748377665666,-11.4078206525479,61,61,0,2
188672,9to8,9,8,0.027441625858331,-12.4204501574849,591,591,0,3
188689,8to9,8,9,0.769052262769502,-2.89449932615566,35,35,0,4
188704,9to4,9,4,0.972406204360331,-8.85273758710149,65,65,0,3
188719,4to9,4,9,0.91748377665666,-11.4078206525479,30,30,0,2
188735,9to4,9,4,0.972406204360331,-8.85273758710149,31,31,0,3
188751,4to9,4,9,0.91748377665666,-11.4078206525479,32,32,0,2
188767,9to8,9,8,0.027441625858331,-12.4204501574849,95,95,0,3
188782,8to3,8,3,0.227014077405999,-4.11464622477799,158,158,0,4
188798,3to4,3,4,0.979247382023731,-4.3200135082935,63,63,0,3
188816,4to9,4,9,0.91748377665666,-11.4078206525479,65,65,0,2
188830,9to4,9,4,0.972406204360331,-8.85273758710149,32,32,0,3
188847,4to9,4,9,0.91748377665666,-11.4078206525479,31,31,0,2
188864,9to4,9,4,0.972406204360331,-8.85273758710149,34,34,0,3
188879,4to3,4,3,0.08251622334334,-13.816460629608,97,97,0,2
188895,3to4,3,4,0.979247382023731,-4.3200135082935,31,31,0,3
188912,4to9,4,9,0.91748377665666,-11.4078206525479,65,65,0,2
188926,9to4,9,4,0.972406204360331,-8.85273758710149,31,31,0,3
188942,4to9,4,9,0.91748377665666,-11.4078206525479,30,30,0,2
188958,9to4,9,4,0.972406204360331,-8.85273758710149,32,32,0,3
188975,4to9,4,9,0.91748377665666,-11.4078206525479,33,33,0,2
188989,9to4,9,4,0.972406204360331,-8.85273758710149,31,31,0,3
189004,4to9,4,9,0.91748377665666,-11.4078206525479,29,29,0,2
189019,9to4,9,4,0.972406204360331,-8.85273758710149,30,30,0,3
189034,4to9,4,9,0.91748377665666,-11.4078206525479,30,30,0,2
189051,9to14,9,14,0.000152169781338,-17.6152696089966,598,598,0,3
189066,14to9,14,9,0.997841759854063,-5.13076416031772,32,32,0,3
189082,9to8,9,8,0.027441625858331,-12.4204501574849,315,315,0,3
189098,8to3,8,3,0.227014077405999,-4.11464622477799,219,219,0,4
189115,3to4,3,4,0.979247382023731,-4.3200135082935,96,96,0,3
189131,4to9,4,9,0.91748377665666,-11.4078206525479,65,65,0,2
189147,9to4,9,4,0.972406204360331,-8.85273758710149,32,32,0,3
189164,4to9,4,9,0.91748377665666,-11.4078206525479,33,33,0,2
189178,9to4,9,4,0.972406204360331,-8.85273758710149,31,31,0,3
189193,4to9,4,9,0.91748377665666,-11.4078206525479,29,29,0,2
189207,9to4,9,4,0.972406204360331,-8.85273758710149,29,29,0,3
189223,4to9,4,9,0.91748377665666,-11.4078206525479,30,30,0,2
189239,9to4,9,4,0.972406204360331,-8.85273758710149,32,32,0,3
189255,4to9,4,9,0.91748377665666,-11.4078206525479,32,32,0,2
189270,9to14,9,14,0.000152169781338,-17.6152696089966,219,219,0,3
189287,14to9,14,9,0.997841759854063,-5.13076416031772,32,32,0,3
189302,9to4,9,4,0.972406204360331,-8.85273758710149,63,63,0,3
189318,4to9,4,9,0.91748377665666,-11.4078206525479,31,31,0,2
189334,9to4,9,4,0.972406204360331,-8.85273758710149,32,32,0,3
189349,4to3,4,3,0.08251622334334,-13.816460629608,251,251,0,2
189365,3to4,3,4,0.979247382023731,-4.3200135082935,31,31,0,3
189380,4to9,4,9,0.91748377665666,-11.4078206525479,62,62,0,2
189395,9to4,9,4,0.972406204360331,-8.85273758710149,30,30,0,3
189410,4to9,4,9,0.91748377665666,-11.4078206525479,30,30,0,2
189425,9to4,9,4,0.972406204360331,-8.85273758710149,30,30,0,3
189441,4to9,4,9,0.91748377665666,-11.4078206525479,31,31,0,2
189456,9to4,9,4,0.972406204360331,-8.85273758710149,31,31,0,3
189473,4to9,4,9,0.91748377665666,-11.4078206525479,32,32,0,2
189487,9to4,9,4,0.972406204360331,-8.85273758710149,31,31,0,3
189502,4to9,4,9,0.91748377665666,-11.4078206525479,29,29,0,2
189517,9to4,9,4,0.972406204360331,-8.85273758710149,30,30,0,3
189535,4to3,4,3,0.08251622334334,-13.816460629608,186,186,0,2
189550,3to4,3,4,0.979247382023731,-4.3200135082935,33,33,0,3
189567,4to9,4,9,0.91748377665666,-11.4078206525479,65,65,0,2
189583,9to8,9,8,0.027441625858331,-12.4204501574849,501,501,0,3
189601,8to9,8,9,0.769052262769502,-2.89449932615566,34,34,0,4
189618,9to4,9,4,0.972406204360331,-8.85273758710149,68,68,0,3
189634,4to9,4,9,0.91748377665666,-11.4078206525479,33,33,0,2
189649,9to4,9,4,0.972406204360331,-8.85273758710149,31,31,0,3
189665,4to9,4,9,0.91748377665666,-11.4078206525479,31,31,0,2
189681,9to4,9,4,0.972406204360331,-8.85273758710149,32,32,0,3
189697,4to9,4,9,0.91748377665666,-11.4078206525479,32,32,0,2
189712,9to4,9,4,0.972406204360331,-8.85273758710149,31,31,0,3
189729,4to3,4,3,0.08251622334334,-13.816460629608,194,194,0,2
189746,3to4,3,4,0.979247382023731,-4.3200135082935,34,34,0,3
189763,4to9,4,9,0.91748377665666,-11.4078206525479,66,66,0,2
189778,9to4,9,4,0.972406204360331,-8.85273758710149,32,32,0,3
189795,4to9,4,9,0.91748377665666,-11.4078206525479,32,32,0,2
189811,9to4,9,4,0.972406204360331,-8.85273758710149,33,33,0,3
189826,4to9,4,9,0.91748377665666,-11.4078206525479,31,31,0,2
189842,9to4,9,4,0.972406204360331,-8.85273758710149,31,31,0,3
189856,4to9,4,9,0.91748377665666,-11.4078206525479,30,30,0,2
189873,9to4,9,4,0.972406204360331,-8.85273758710149,31,31,0,3
189890,4to9,4,9,0.91748377665666,-11.4078206525479,34,34,0,2
189906,9to4,9,4,0.972406204360331,-8.85273758710149,33,33,0,3
189922,4to9,4,9,0.91748377665666,-11.4078206525479,32,32,0,2
189938,9to4,9,4,0.972406204360331,-8.85273758710149,32,32,0,3
189953,4to3,4,3,0.08251622334334,-13.816460629608,224,224,0,2
189969,3to4,3,4,0.979247382023731,-4.3200135082935,31,31,0,3
189985,4to9,4,9,0.91748377665666,-11.4078206525479,63,63,0,2
189999,9to4,9,4,0.972406204360331,-8.85273758710149,30,30,0,3
190015,4to9,4,9,0.91748377665666,-11.4078206525479,30,30,0,2
190031,9to4,9,4,0.972406204360331,-8.85273758710149,32,32,0,3
190046,4to9,4,9,0.91748377665666,-11.4078206525479,31,31,0,2
190061,9to4,9,4,0.972406204360331,-8.85273758710149,30,30,0,3
190077,4to9,4,9,0.91748377665666,-11.4078206525479,31,31,0,2
190093,9to4,9,4,0.972406204360331,-8.85273758710149,32,32,0,3
190108,4to9,4,9,0.91748377665666,-11.4078206525479,31,31,0,2
190123,9to4,9,4,0.972406204360331,-8.85273758710149,30,30,0,3
190140,4to3,4,3,0.08251622334334,-13.816460629608,187,187,0,2
190156,3to2,3,2,0.00068093563244,-11.5910853038632,7309,7309,0,3
190171,2to3,2,3,0.998447808871189,-3.95697141540815,31,31,0,3
190189,3to4,3,4,0.979247382023731,-4.3200135082935,66,66,0,3
190206,4to9,4,9,0.91748377665666,-11.4078206525479,98,98,0,2
190221,9to8,9,8,0.027441625858331,-12.4204501574849,638,638,0,3
190236,8to13,8,13,0.00302493167881,-8.43276974963057,4500,4500,0,4
190252,13to12,13,12,0.011456026712297,-11.7575258257807,10514,10514,0,4
190267,12to11,12,11,0.001677031235818,-12.7412150705627,45438,13816,31622,4
190283,11to10,11,10,0.030548025221593,-9.37556909559743,45471,13815,31656,4
190299,10to15,10,15,0.081305507589252,-12.8290559988267,75252,257,74995,3
190315,15to16,15,16,0.182832810607757,-7.09249623594953,45469,290,45179,3
190331,16to21,16,21,0.046064058614599,-7.2161372712236,75316,257,75059,4
190347,21to20,21,20,0.036432018702776,-8.30153731479455,75316,288,75028,3
190364,20to15,20,15,0.730084995864726,-5.70723130816389,65,65,0,2
190379,15to10,15,10,0.787732147236061,-5.63191025056611,96,96,0,3
190394,10to5,10,5,0.256468655250573,-11.8259762105261,45597,23836,21761,3
190410,5to6,5,6,0.597447209344852,-7.51594327220401,17626,17626,0,3
190427,6to11,6,11,0.065699446910766,-7.72798927947644,160,160,0,4
190444,11to6,11,6,0.075550079501197,-8.47007339724403,34,34,0,4
190461,6to7,6,7,0.811310473476567,-5.21442897770946,10739,10739,0,4
190478,7to8,7,8,0.941180593756955,-2.39620659892225,257,257,0,4
190496,8to9,8,9,0.769052262769502,-2.89449932615566,290,290,0,4
190512,9to4,9,4,0.972406204360331,-8.85273758710149,323,323,0,3
190528,4to3,4,3,0.08251622334334,-13.816460629608,357,357,0,2
190544,3to4,3,4,0.979247382023731,-4.3200135082935,32,32,0,3
190559,4to9,4,9,0.91748377665666,-11.4078206525479,63,63,0,2
190574,9to4,9,4,0.972406204360331,-8.85273758710149,30,30,0,3
190590,4to9,4,9,0.91748377665666,-11.4078206525479,31,31,0,2
190606,9to4,9,4,0.972406204360331,-8.85273758710149,32,32,0,3
190621,4to9,4,9,0.91748377665666,-11.4078206525479,31,31,0,2
190636,9to4,9,4,0.972406204360331,-8.85273758710149,30,30,0,3
190652,4to9,4,9,0.91748377665666,-11.4078206525479,31,31,0,2
190668,9to4,9,4,0.972406204360331,-8.85273758710149,32,32,0,3
190683,4to9,4,9,0.91748377665666,-11.4078206525479,31,31,0,2
190697,9to4,9,4,0.972406204360331,-8.85273758710149,29,29,0,3
190713,4to3,4,3,0.08251622334334,-13.816460629608,185,185,0,2
190729,3to4,3,4,0.979247382023731,-4.3200135082935,32,32,0,3
190745,4to9,4,9,0.91748377665666,-11.4078206525479,62,62,0,2
190762,9to4,9,4,0.972406204360331,-8.85273758710149,33,33,0,3
190778,4to3,4,3,0.08251622334334,-13.816460629608,65,65,0,2
190793,3to4,3,4,0.979247382023731,-4.3200135082935,31,31,0,3
190810,4to9,4,9,0.91748377665666,-11.4078206525479,65,65,0,2
190825,9to4,9,4,0.972406204360331,-8.85273758710149,32,32,0,3
190841,4to9,4,9,0.91748377665666,-11.4078206525479,31,31,0,2
190858,9to4,9,4,0.972406204360331,-8.85273758710149,33,33,0,3
190873,4to3,4,3,0.08251622334334,-13.816460629608,95,95,0,2
190890,3to4,3,4,0.979247382023731,-4.3200135082935,32,32,0,3
190905,4to3,4,3,0.08251622334334,-13.816460629608,32,32,0,2
190921,3to4,3,4,0.979247382023731,-4.3200135082935,31,31,0,3
190937,4to9,4,9,0.91748377665666,-11.4078206525479,96,96,0,2
190955,9to14,9,14,0.000152169781338,-17.6152696089966,1685,1685,0,3
190971,14to9,14,9,0.997841759854063,-5.13076416031772,34,34,0,3
190988,9to4,9,4,0.972406204360331,-8.85273758710149,67,67,0,3
191004,4to9,4,9,0.91748377665666,-11.4078206525479,33,33,0,2
191019,9to4,9,4,0.972406204360331,-8.85273758710149,31,31,0,3
191035,4to9,4,9,0.91748377665666,-11.4078206525479,31,31,0,2
191051,9to4,9,4,0.972406204360331,-8.85273758710149,32,32,0,3
191067,4to9,4,9,0.91748377665666,-11.4078206525479,32,32,0,2
191082,9to8,9,8,0.027441625858331,-12.4204501574849,604,604,0,3
191098,8to3,8,3,0.227014077405999,-4.11464622477799,193,193,0,4
191115,3to4,3,4,0.979247382023731,-4.3200135082935,64,64,0,3
191131,4to9,4,9,0.91748377665666,-11.4078206525479,64,64,0,2
191147,9to4,9,4,0.972406204360331,-8.85273758710149,32,32,0,3
191162,4to9,4,9,0.91748377665666,-11.4078206525479,31,31,0,2
191177,9to4,9,4,0.972406204360331,-8.85273758710149,30,30,0,3
191193,4to9,4,9,0.91748377665666,-11.4078206525479,31,31,0,2
191209,9to4,9,4,0.972406204360331,-8.85273758710149,32,32,0,3
191224,4to9,4,9,0.91748377665666,-11.4078206525479,31,31,0,2
191239,9to4,9,4,0.972406204360331,-8.85273758710149,30,30,0,3
191256,4to9,4,9,0.91748377665666,-11.4078206525479,32,32,0,2
191271,9to4,9,4,0.972406204360331,-8.85273758710149,32,32,0,3
191287,4to3,4,3,0.08251622334334,-13.816460629608,189,189,0,2
191302,3to4,3,4,0.979247382023731,-4.3200135082935,31,31,0,3
191318,4to9,4,9,0.91748377665666,-11.4078206525479,62,62,0,2
191333,9to4,9,4,0.972406204360331,-8.85273758710149,31,31,0,3
191349,4to9,4,9,0.91748377665666,-11.4078206525479,31,31,0,2
191364,9to4,9,4,0.972406204360331,-8.85273758710149,31,31,0,3
191379,4to9,4,9,0.91748377665666,-11.4078206525479,30,30,0,2
191395,9to4,9,4,0.972406204360331,-8.85273758710149,31,31,0,3
191411,4to9,4,9,0.91748377665666,-11.4078206525479,32,32,0,2
191427,9to4,9,4,0.972406204360331,-8.85273758710149,32,32,0,3
191442,4to9,4,9,0.91748377665666,-11.4078206525479,31,31,0,2
191457,9to4,9,4,0.972406204360331,-8.85273758710149,30,30,0,3
191473,4to3,4,3,0.08251622334334,-13.816460629608,186,186,0,2
191490,3to4,3,4,0.979247382023731,-4.3200135082935,33,33,0,3
191506,4to9,4,9,0.91748377665666,-11.4078206525479,64,64,0,2
191522,9to4,9,4,0.972406204360331,-8.85273758710149,32,32,0,3
191538,4to9,4,9,0.91748377665666,-11.4078206525479,32,32,0,2
191554,9to4,9,4,0.972406204360331,-8.85273758710149,32,32,0,3
191570,4to3,4,3,0.08251622334334,-13.816460629608,97,97,0,2
191585,3to4,3,4,0.979247382023731,-4.3200135082935,31,31,0,3
191600,4to9,4,9,0.91748377665666,-11.4078206525479,62,62,0,2
191616,9to8,9,8,0.027441625858331,-12.4204501574849,534,534,0,3
191631,8to7,8,7,0.000908728145689,-9.63536755452497,1170,1170,0,4
191647,7to2,7,2,0.034576161541244,-5.70017716512867,1491,1491,0,4
191662,2to1,2,1,0.000129347470453,-12.9084262237429,18893,18893,0,3
191679,1to0,1,0,0.022844220136493,-10.6981397613491,46898,25135,21763,3
191696,0to5,0,5,0.773820929474193,-5.98773230551033,1302,1302,0,2
191711,5to6,5,6,0.597447209344852,-7.51594327220401,1267,1267,0,3
191729,6to11,6,11,0.065699446910766,-7.72798927947644,1302,1302,0,4
191746,11to12,11,12,0.872223806884507,-6.02382308801248,1494,1494,0,4
191762,12to13,12,13,0.987918276805993,-6.36264020069652,1526,1526,0,4
191780,13to8,13,8,0.917351022044606,-7.37455157477482,164,164,0,4
191796,8to9,8,9,0.769052262769502,-2.89449932615566,196,196,0,4
191812,9to4,9,4,0.972406204360331,-8.85273758710149,227,227,0,3
191828,4to3,4,3,0.08251622334334,-13.816460629608,258,258,0,2
191844,3to4,3,4,0.979247382023731,-4.3200135082935,32,32,0,3
191861,4to9,4,9,0.91748377665666,-11.4078206525479,65,65,0,2
191878,9to4,9,4,0.972406204360331,-8.85273758710149,34,34,0,3
191895,4to9,4,9,0.91748377665666,-11.4078206525479,34,34,0,2
191911,9to4,9,4,0.972406204360331,-8.85273758710149,33,33,0,3
191928,4to9,4,9,0.91748377665666,-11.4078206525479,33,33,0,2
191944,9to4,9,4,0.972406204360331,-8.85273758710149,33,33,0,3
191960,4to9,4,9,0.91748377665666,-11.4078206525479,32,32,0,2
191974,9to4,9,4,0.972406204360331,-8.85273758710149,30,30,0,3
191991,4to3,4,3,0.08251622334334,-13.816460629608,163,163,0,2
192006,3to4,3,4,0.979247382023731,-4.3200135082935,32,32,0,3
192021,4to9,4,9,0.91748377665666,-11.4078206525479,61,61,0,2
192037,9to4,9,4,0.972406204360331,-8.85273758710149,31,31,0,3
192052,4to9,4,9,0.91748377665666,-11.4078206525479,31,31,0,2
192068,9to4,9,4,0.972406204360331,-8.85273758710149,31,31,0,3
192085,4to9,4,9,0.91748377665666,-11.4078206525479,33,33,0,2
192100,9to4,9,4,0.972406204360331,-8.85273758710149,32,32,0,3
192115,4to9,4,9,0.91748377665666,-11.4078206525479,30,30,0,2
192131,9to4,9,4,0.972406204360331,-8.85273758710149,31,31,0,3
192145,4to9,4,9,0.91748377665666,-11.4078206525479,30,30,0,2
192161,9to4,9,4,0.972406204360331,-8.85273758710149,30,30,0,3
192178,4to9,4,9,0.91748377665666,-11.4078206525479,33,33,0,2
192192,9to4,9,4,0.972406204360331,-8.85273758710149,31,31,0,3
192207,4to3,4,3,0.08251622334334,-13.816460629608,216,216,0,2
192222,3to4,3,4,0.979247382023731,-4.3200135082935,30,30,0,3
192237,4to3,4,3,0.08251622334334,-13.816460629608,30,30,0,2
192252,3to4,3,4,0.979247382023731,-4.3200135082935,30,30,0,3
192269,4to9,4,9,0.91748377665666,-11.4078206525479,91,91,0,2
192284,9to4,9,4,0.972406204360331,-8.85273758710149,32,32,0,3
192301,4to9,4,9,0.91748377665666,-11.4078206525479,32,32,0,2
192317,9to4,9,4,0.972406204360331,-8.85273758710149,33,33,0,3
192333,4to9,4,9,0.91748377665666,-11.4078206525479,32,32,0,2
192348,9to4,9,4,0.972406204360331,-8.85273758710149,31,31,0,3
192363,4to9,4,9,0.91748377665666,-11.4078206525479,30,30,0,2
192379,9to8,9,8,0.027441625858331,-12.4204501574849,599,599,0,3
192395,8to3,8,3,0.227014077405999,-4.11464622477799,158,158,0,4
192412,3to4,3,4,0.979247382023731,-4.3200135082935,64,64,0,3
192429,4to9,4,9,0.91748377665666,-11.4078206525479,66,66,0,2
192445,9to4,9,4,0.972406204360331,-8.85273758710149,33,33,0,3
192462,4to9,4,9,0.91748377665666,-11.4078206525479,33,33,0,2
192477,9to4,9,4,0.972406204360331,-8.85273758710149,32,32,0,3
192493,4to9,4,9,0.91748377665666,-11.4078206525479,31,31,0,2
192507,9to4,9,4,0.972406204360331,-8.85273758710149,30,30,0,3
192521,4to9,4,9,0.91748377665666,-11.4078206525479,28,28,0,2
192536,9to4,9,4,0.972406204360331,-8.85273758710149,29,29,0,3
192552,4to9,4,9,0.91748377665666,-11.4078206525479,31,31,0,2
192569,9to14,9,14,0.000152169781338,-17.6152696089966,1614,1614,0,3
192585,14to9,14,9,0.997841759854063,-5.13076416031772,33,33,0,3
192602,9to4,9,4,0.972406204360331,-8.85273758710149,66,66,0,3
192617,4to3,4,3,0.08251622334334,-13.816460629608,222,222,0,2
192632,3to4,3,4,0.979247382023731,-4.3200135082935,30,30,0,3
192648,4to3,4,3,0.08251622334334,-13.816460629608,31,31,0,2
192663,3to4,3,4,0.979247382023731,-4.3200135082935,31,31,0,3
192680,4to9,4,9,0.91748377665666,-11.4078206525479,95,95,0,2
192695,9to4,9,4,0.972406204360331,-8.85273758710149,32,32,0,3
192710,4to9,4,9,0.91748377665666,-11.4078206525479,30,30,0,2
192725,9to4,9,4,0.972406204360331,-8.85273758710149,30,30,0,3
192739,4to9,4,9,0.91748377665666,-11.4078206525479,29,29,0,2
192754,9to4,9,4,0.972406204360331,-8.85273758710149,29,29,0,3
192770,4to9,4,9,0.91748377665666,-11.4078206525479,31,31,0,2
192786,9to4,9,4,0.972406204360331,-8.85273758710149,32,32,0,3
192802,4to9,4,9,0.91748377665666,-11.4078206525479,32,32,0,2
192816,9to4,9,4,0.972406204360331,-8.85273758710149,30,30,0,3
192831,4to3,4,3,0.08251622334334,-13.816460629608,183,183,0,2
192846,3to4,3,4,0.979247382023731,-4.3200135082935,30,30,0,3
192863,4to9,4,9,0.91748377665666,-11.4078206525479,61,61,0,2
192878,9to4,9,4,0.972406204360331,-8.85273758710149,32,32,0,3
192894,4to9,4,9,0.91748377665666,-11.4078206525479,31,31,0,2
192909,9to4,9,4,0.972406204360331,-8.85273758710149,31,31,0,3
192925,4to9,4,9,0.91748377665666,-11.4078206525479,31,31,0,2
192940,9to4,9,4,0.972406204360331,-8.85273758710149,31,31,0,3
192957,4to9,4,9,0.91748377665666,-11.4078206525479,32,32,0,2
192973,9to4,9,4,0.972406204360331,-8.85273758710149,33,33,0,3
192990,4to3,4,3,0.08251622334334,-13.816460629608,159,159,0,2
193005,3to4,3,4,0.979247382023731,-4.3200135082935,32,32,0,3
193021,4to9,4,9,0.91748377665666,-11.4078206525479,64,64,0,2
193037,9to8,9,8,0.027441625858331,-12.4204501574849,658,658,0,3
193053,8to9,8,9,0.769052262769502,-2.89449932615566,32,32,0,4
193070,9to8,9,8,0.027441625858331,-12.4204501574849,33,33,0,3
193086,8to7,8,7,0.000556123231152,-10.1267764892329,1455,740,715,4
193103,7to2,7,2,0.021913480198722,-6.16927057172208,1456,773,683,4
193119,2to3,2,3,0.998447808871189,-3.95697141540815,129,129,0,3
193136,3to4,3,4,0.979247382023731,-4.3200135082935,131,131,0,3
193152,4to9,4,9,0.91748377665666,-11.4078206525479,99,99,0,2
193168,9to4,9,4,0.972406204360331,-8.85273758710149,32,32,0,3
193184,4to9,4,9,0.91748377665666,-11.4078206525479,32,32,0,2
193199,9to4,9,4,0.972406204360331,-8.85273758710149,31,31,0,3
193215,4to9,4,9,0.91748377665666,-11.4078206525479,31,31,0,2
193232,9to4,9,4,0.972406204360331,-8.85273758710149,33,33,0,3
193247,4to9,4,9,0.91748377665666,-11.4078206525479,32,32,0,2
193263,9to4,9,4,0.972406204360331,-8.85273758710149,31,31,0,3
193279,4to9,4,9,0.91748377665666,-11.4078206525479,32,32,0,2
193295,9to4,9,4,0.972406204360331,-8.85273758710149,32,32,0,3
193309,4to9,4,9,0.91748377665666,-11.4078206525479,30,30,0,2
193324,9to4,9,4,0.972406204360331,-8.85273758710149,29,29,0,3
193339,4to3,4,3,0.08251622334334,-13.816460629608,220,220,0,2
193354,3to4,3,4,0.979247382023731,-4.3200135082935,30,30,0,3
193372,4to9,4,9,0.91748377665666,-11.4078206525479,63,63,0,2
193387,9to4,9,4,0.972406204360331,-8.85273758710149,33,33,0,3
193404,4to9,4,9,0.91748377665666,-11.4078206525479,32,32,0,2
193419,9to4,9,4,0.972406204360331,-8.85273758710149,32,32,0,3
193435,4to9,4,9,0.91748377665666,-11.4078206525479,31,31,0,2
193451,9to4,9,4,0.972406204360331,-8.85273758710149,32,32,0,3
193467,4to9,4,9,0.91748377665666,-11.4078206525479,32,32,0,2
193483,9to4,9,4,0.972406204360331,-8.85273758710149,32,32,0,3
193499,4to9,4,9,0.91748377665666,-11.4078206525479,32,32,0,2
193515,9to4,9,4,0.972406204360331,-8.85273758710149,32,32,0,3
193530,4to9,4,9,0.91748377665666,-11.4078206525479,31,31,0,2
193546,9to4,9,4,0.972406204360331,-8.85273758710149,31,31,0,3
193563,4to3,4,3,0.08251622334334,-13.816460629608,224,224,0,2
193579,3to4,3,4,0.979247382023731,-4.3200135082935,33,33,0,3
193595,4to9,4,9,0.91748377665666,-11.4078206525479,65,65,0,2
193609,9to4,9,4,0.972406204360331,-8.85273758710149,30,30,0,3
193625,4to9,4,9,0.91748377665666,-11.4078206525479,30,30,0,2
193640,9to4,9,4,0.972406204360331,-8.85273758710149,31,31,0,3
193655,4to9,4,9,0.91748377665666,-11.4078206525479,30,30,0,2
193671,9to8,9,8,0.027441625858331,-12.4204501574849,601,601,0,3
193687,8to3,8,3,0.22709419649183,-4.11464622477799,124,124,0,4
193703,3to2,3,2,0.00068093563244,-11.5910853038632,600,600,0,3
193719,2to7,2,7,0.001422843658358,-10.5105158519261,633,633,0,3
193736,7to8,7,8,0.953525296124711,-2.39620659892225,65,65,0,4
193753,8to9,8,9,0.769323681022296,-2.89449932615566,98,98,0,4
193769,9to4,9,4,0.972406204360331,-8.85273758710149,129,129,0,3
193785,4to9,4,9,0.91748377665666,-11.4078206525479,32,32,0,2
193800,9to4,9,4,0.972406204360331,-8.85273758710149,31,31,0,3
193815,4to9,4,9,0.91748377665666,-11.4078206525479,30,30,0,2
193831,9to4,9,4,0.972406204360331,-8.85273758710149,31,31,0,3
193848,4to9,4,9,0.91748377665666,-11.4078206525479,33,33,0,2
193864,9to8,9,8,0.027441625858331,-12.4204501574849,128,128,0,3
193880,8to3,8,3,0.22709419649183,-4.11464622477799,193,193,0,4
193897,3to4,3,4,0.979247382023731,-4.3200135082935,66,66,0,3
193915,4to9,4,9,0.91748377665666,-11.4078206525479,67,67,0,2
193931,9to4,9,4,0.972406204360331,-8.85273758710149,34,34,0,3
193947,4to9,4,9,0.91748377665666,-11.4078206525479,32,32,0,2
193963,9to4,9,4,0.972406204360331,-8.85273758710149,32,32,0,3
193978,4to9,4,9,0.91748377665666,-11.4078206525479,31,31,0,2
193993,9to4,9,4,0.972406204360331,-8.85273758710149,30,30,0,3
194009,4to9,4,9,0.91748377665666,-11.4078206525479,31,31,0,2
194024,9to4,9,4,0.972406204360331,-8.85273758710149,31,31,0,3
194041,4to3,4,3,0.08251622334334,-13.816460629608,161,161,0,2
194057,3to4,3,4,0.979247382023731,-4.3200135082935,33,33,0,3
194073,4to9,4,9,0.91748377665666,-11.4078206525479,64,64,0,2
194089,9to4,9,4,0.972406204360331,-8.85273758710149,32,32,0,3
194104,4to9,4,9,0.91748377665666,-11.4078206525479,31,31,0,2
194120,9to4,9,4,0.972406204360331,-8.85273758710149,31,31,0,3
194135,4to9,4,9,0.91748377665666,-11.4078206525479,31,31,0,2
194151,9to4,9,4,0.972406204360331,-8.85273758710149,31,31,0,3
194168,4to9,4,9,0.91748377665666,-11.4078206525479,33,33,0,2
194183,9to4,9,4,0.972406204360331,-8.85273758710149,32,32,0,3
194199,4to9,4,9,0.91748377665666,-11.4078206525479,31,31,0,2
194214,9to4,9,4,0.972406204360331,-8.85273758710149,31,31,0,3
194231,4to3,4,3,0.08251622334334,-13.816460629608,190,190,0,2
194246,3to4,3,4,0.979247382023731,-4.3200135082935,32,32,0,3
194262,4to9,4,9,0.91748377665666,-11.4078206525479,63,63,0,2
194278,9to4,9,4,0.972406204360331,-8.85273758710149,32,32,0,3
194294,4to9,4,9,0.91748377665666,-11.4078206525479,32,32,0,2
194309,9to4,9,4,0.972406204360331,-8.85273758710149,31,31,0,3
194325,4to9,4,9,0.91748377665666,-11.4078206525479,31,31,0,2
194340,9to4,9,4,0.972406204360331,-8.85273758710149,31,31,0,3
194355,4to9,4,9,0.91748377665666,-11.4078206525479,30,30,0,2
194371,9to4,9,4,0.972406204360331,-8.85273758710149,31,31,0,3
194387,4to3,4,3,0.08251622334334,-13.816460629608,156,156,0,2
194402,3to4,3,4,0.979247382023731,-4.3200135082935,31,31,0,3
194417,4to9,4,9,0.91748377665666,-11.4078206525479,62,62,0,2
194432,9to8,9,8,0.027441625858331,-12.4204501574849,568,568,0,3
194447,8to9,8,9,0.769323681022296,-2.89449932615566,30,30,0,4
194462,9to4,9,4,0.972406204360331,-8.85273758710149,60,60,0,3
194477,4to9,4,9,0.91748377665666,-11.4078206525479,30,30,0,2
194492,9to4,9,4,0.972406204360331,-8.85273758710149,30,30,0,3
194508,4to9,4,9,0.91748377665666,-11.4078206525479,31,31,0,2
194523,9to4,9,4,0.972406204360331,-8.85273758710149,31,31,0,3
194539,4to9,4,9,0.91748377665666,-11.4078206525479,31,31,0,2
194555,9to4,9,4,0.972406204360331,-8.85273758710149,32,32,0,3
194571,4to9,4,9,0.91748377665666,-11.4078206525479,32,32,0,2
194586,9to4,9,4,0.972406204360331,-8.85273758710149,31,31,0,3
194602,4to3,4,3,0.08251622334334,-13.816460629608,215,215,0,2
194617,3to4,3,4,0.979247382023731,-4.3200135082935,31,31,0,3
194634,4to9,4,9,0.91748377665666,-11.4078206525479,63,63,0,2
194649,9to4,9,4,0.972406204360331,-8.85273758710149,32,32,0,3
194663,4to3,4,3,0.08251622334334,-13.816460629608,61,61,0,2
194678,3to4,3,4,0.979247382023731,-4.3200135082935,29,29,0,3
194694,4to9,4,9,0.91748377665666,-11.4078206525479,60,60,0,2
194708,9to4,9,4,0.972406204360331,-8.85273758710149,30,30,0,3
194724,4to9,4,9,0.91748377665666,-11.4078206525479,30,30,0,2
194739,9to4,9,4,0.972406204360331,-8.85273758710149,31,31,0,3
194756,4to9,4,9,0.91748377665666,-11.4078206525479,32,32,0,2
194772,9to4,9,4,0.972406204360331,-8.85273758710149,33,33,0,3
194788,4to9,4,9,0.91748377665666,-11.4078206525479,32,32,0,2
194804,9to8,9,8,0.027441625858331,-12.4204501574849,372,372,0,3
194819,8to3,8,3,0.22709419649183,-4.11464622477799,156,156,0,4
194836,3to4,3,4,0.979247382023731,-4.3200135082935,64,64,0,3
194852,4to9,4,9,0.91748377665666,-11.4078206525479,64,64,0,2
194868,9to4,9,4,0.972406204360331,-8.85273758710149,32,32,0,3
194883,4to9,4,9,0.91748377665666,-11.4078206525479,31,31,0,2
194899,9to4,9,4,0.972406204360331,-8.85273758710149,31,31,0,3
194915,4to9,4,9,0.91748377665666,-11.4078206525479,32,32,0,2
194932,9to4,9,4,0.972406204360331,-8.85273758710149,33,33,0,3
194947,4to9,4,9,0.91748377665666,-11.4078206525479,32,32,0,2
194963,9to4,9,4,0.972406204360331,-8.85273758710149,31,31,0,3
194979,4to9,4,9,0.91748377665666,-11.4078206525479,32,32,0,2
194993,9to4,9,4,0.972406204360331,-8.85273758710149,30,30,0,3
195009,4to3,4,3,0.08251622334334,-13.816460629608,190,190,0,2
195024,3to4,3,4,0.979247382023731,-4.3200135082935,31,31,0,3
195040,4to9,4,9,0.91748377665666,-11.4078206525479,61,61,0,2
195057,9to4,9,4,0.972406204360331,-8.85273758710149,33,33,0,3
195072,4to9,4,9,0.91748377665666,-11.4078206525479,32,32,0,2
195087,9to4,9,4,0.972406204360331,-8.85273758710149,30,30,0,3
195103,4to9,4,9,0.91748377665666,-11.4078206525479,31,31,0,2
195119,9to4,9,4,0.972406204360331,-8.85273758710149,32,32,0,3
195135,4to9,4,9,0.91748377665666,-11.4078206525479,32,32,0,2
195151,9to4,9,4,0.972406204360331,-8.85273758710149,32,32,0,3
195166,4to9,4,9,0.91748377665666,-11.4078206525479,31,31,0,2
195183,9to4,9,4,0.972406204360331,-8.85273758710149,32,32,0,3
195199,4to3,4,3,0.08251622334334,-13.816460629608,190,190,0,2
195215,3to4,3,4,0.979247382023731,-4.3200135082935,32,32,0,3
195230,4to9,4,9,0.91748377665666,-11.4078206525479,64,64,0,2
195246,9to4,9,4,0.972406204360331,-8.85273758710149,31,31,0,3
195261,4to9,4,9,0.91748377665666,-11.4078206525479,31,31,0,2
195276,9to4,9,4,0.972406204360331,-8.85273758710149,30,30,0,3
195292,4to9,4,9,0.91748377665666,-11.4078206525479,31,31,0,2
195308,9to8,9,8,0.027441625858331,-12.4204501574849,504,504,0,3
195324,8to3,8,3,0.22709419649183,-4.11464622477799,125,125,0,4
195341,3to4,3,4,0.979247382023731,-4.3200135082935,65,65,0,3
195358,4to9,4,9,0.91748377665666,-11.4078206525479,66,66,0,2
195373,9to4,9,4,0.972406204360331,-8.85273758710149,32,32,0,3
195389,4to9,4,9,0.91748377665666,-11.4078206525479,31,31,0,2
195405,9to4,9,4,0.972406204360331,-8.85273758710149,32,32,0,3
195421,4to9,4,9,0.91748377665666,-11.4078206525479,32,32,0,2
195437,9to4,9,4,0.972406204360331,-8.85273758710149,32,32,0,3
195452,4to9,4,9,0.91748377665666,-11.4078206525479,31,31,0,2
195467,9to4,9,4,0.972406204360331,-8.85273758710149,30,30,0,3
195483,4to9,4,9,0.91748377665666,-11.4078206525479,31,31,0,2
195498,9to4,9,4,0.972406204360331,-8.85273758710149,31,31,0,3
195514,4to3,4,3,0.08251622334334,-13.816460629608,190,190,0,2
195530,3to4,3,4,0.979247382023731,-4.3200135082935,32,32,0,3
195546,4to9,4,9,0.91748377665666,-11.4078206525479,63,63,0,2
195562,9to4,9,4,0.972406204360331,-8.85273758710149,32,32,0,3
195577,4to9,4,9,0.91748377665666,-11.4078206525479,31,31,0,2
195592,9to4,9,4,0.972406204360331,-8.85273758710149,30,30,0,3
195608,4to9,4,9,0.91748377665666,-11.4078206525479,31,31,0,2
195626,9to14,9,14,5.72073076475422E-05,-18.593679815081,3057,66,2991,3
195642,14to9,14,9,0.997841759854063,-5.13076416031772,34,34,0,3
195658,9to4,9,4,0.972498560512744,-8.85273758710149,66,66,0,3
195673,4to9,4,9,0.91748377665666,-11.4078206525479,31,31,0,2
195688,9to4,9,4,0.972498560512744,-8.85273758710149,30,30,0,3
195705,4to9,4,9,0.91748377665666,-11.4078206525479,32,32,0,2
195722,9to4,9,4,0.972498560512744,-8.85273758710149,34,34,0,3
195737,4to3,4,3,0.08251622334334,-13.816460629608,223,223,0,2
195751,3to4,3,4,0.979247382023731,-4.3200135082935,29,29,0,3
195767,4to9,4,9,0.91748377665666,-11.4078206525479,62,62,0,2
195782,9to4,9,4,0.972498560512744,-8.85273758710149,31,31,0,3
195798,4to9,4,9,0.91748377665666,-11.4078206525479,31,31,0,2
195814,9to4,9,4,0.972498560512744,-8.85273758710149,32,32,0,3
195830,4to9,4,9,0.91748377665666,-11.4078206525479,32,32,0,2
195845,9to4,9,4,0.972498560512744,-8.85273758710149,31,31,0,3
195861,4to9,4,9,0.91748377665666,-11.4078206525479,31,31,0,2
195877,9to4,9,4,0.972498560512744,-8.85273758710149,32,32,0,3
195894,4to9,4,9,0.91748377665666,-11.4078206525479,33,33,0,2
195909,9to4,9,4,0.972498560512744,-8.85273758710149,32,32,0,3
195924,4to3,4,3,0.08251622334334,-13.816460629608,187,187,0,2
195939,3to4,3,4,0.979247382023731,-4.3200135082935,30,30,0,3
195955,4to9,4,9,0.91748377665666,-11.4078206525479,61,61,0,2
195972,9to8,9,8,0.027444232179608,-12.4204501574849,664,664,0,3
195989,8to9,8,9,0.769323681022296,-2.89449932615566,34,34,0,4
196005,9to4,9,4,0.972498560512744,-8.85273758710149,66,66,0,3
196020,4to9,4,9,0.91748377665666,-11.4078206525479,31,31,0,2
196038,9to4,9,4,0.972498560512744,-8.85273758710149,33,33,0,3
196053,4to9,4,9,0.91748377665666,-11.4078206525479,33,33,0,2
196068,9to4,9,4,0.972498560512744,-8.85273758710149,30,30,0,3
196084,4to9,4,9,0.91748377665666,-11.4078206525479,31,31,0,2
196098,9to4,9,4,0.972498560512744,-8.85273758710149,30,30,0,3
196114,4to3,4,3,0.08251622334334,-13.816460629608,190,190,0,2
196129,3to4,3,4,0.979247382023731,-4.3200135082935,31,31,0,3
196144,4to9,4,9,0.91748377665666,-11.4078206525479,60,60,0,2
196160,9to4,9,4,0.972498560512744,-8.85273758710149,31,31,0,3
196175,4to9,4,9,0.91748377665666,-11.4078206525479,31,31,0,2
196190,9to4,9,4,0.972498560512744,-8.85273758710149,30,30,0,3
196205,4to9,4,9,0.91748377665666,-11.4078206525479,30,30,0,2
196221,9to4,9,4,0.972498560512744,-8.85273758710149,31,31,0,3
196235,4to9,4,9,0.91748377665666,-11.4078206525479,30,30,0,2
196251,9to4,9,4,0.972498560512744,-8.85273758710149,30,30,0,3
196267,4to9,4,9,0.91748377665666,-11.4078206525479,32,32,0,2
196282,9to4,9,4,0.972498560512744,-8.85273758710149,31,31,0,3
196297,4to3,4,3,0.08251622334334,-13.816460629608,183,183,0,2
196313,3to2,3,2,0.00068093563244,-11.5910853038632,2610,2610,0,3
196329,2to3,2,3,0.998447808871189,-3.95697141540815,32,32,0,3
196345,3to4,3,4,0.979247382023731,-4.3200135082935,63,63,0,3
196361,4to9,4,9,0.91748377665666,-11.4078206525479,94,94,0,2
196376,9to4,9,4,0.972498560512744,-8.85273758710149,31,31,0,3
196392,4to9,4,9,0.91748377665666,-11.4078206525479,31,31,0,2
196408,9to4,9,4,0.972498560512744,-8.85273758710149,32,32,0,3
196425,4to9,4,9,0.91748377665666,-11.4078206525479,33,33,0,2
196440,9to4,9,4,0.972498560512744,-8.85273758710149,32,32,0,3
196456,4to9,4,9,0.91748377665666,-11.4078206525479,31,31,0,2
196474,9to4,9,4,0.972498560512744,-8.85273758710149,34,34,0,3
196489,4to9,4,9,0.91748377665666,-11.4078206525479,33,33,0,2
196503,9to4,9,4,0.972498560512744,-8.85273758710149,29,29,0,3
196518,4to3,4,3,0.08251622334334,-13.816460629608,189,189,0,2
196534,3to4,3,4,0.979247382023731,-4.3200135082935,31,31,0,3
196550,4to9,4,9,0.91748377665666,-11.4078206525479,61,61,0,2
196566,9to8,9,8,0.027444232179608,-12.4204501574849,594,594,0,3
196583,8to13,8,13,0.001383204967471,-9.2172542964051,4821,1039,3782,4
196599,13to14,13,14,0.071154754789884,-9.93118461773681,973,973,0,4
196616,14to9,14,9,0.997841759854063,-5.13076416031772,66,66,0,3
196633,9to4,9,4,0.972498560512744,-8.85273758710149,99,99,0,3
196649,4to9,4,9,0.91748377665666,-11.4078206525479,33,33,0,2
196665,9to4,9,4,0.972498560512744,-8.85273758710149,32,32,0,3
196680,4to9,4,9,0.91748377665666,-11.4078206525479,31,31,0,2
196698,9to4,9,4,0.972498560512744,-8.85273758710149,33,33,0,3
196713,4to9,4,9,0.91748377665666,-11.4078206525479,33,33,0,2
196728,9to4,9,4,0.972498560512744,-8.85273758710149,30,30,0,3
196745,4to3,4,3,0.08251622334334,-13.816460629608,227,227,0,2
196760,3to4,3,4,0.979247382023731,-4.3200135082935,32,32,0,3
196776,4to9,4,9,0.91748377665666,-11.4078206525479,63,63,0,2
196791,9to4,9,4,0.972498560512744,-8.85273758710149,31,31,0,3
196807,4to9,4,9,0.91748377665666,-11.4078206525479,31,31,0,2
196823,9to4,9,4,0.972498560512744,-8.85273758710149,32,32,0,3
196838,4to9,4,9,0.91748377665666,-11.4078206525479,31,31,0,2
196854,9to4,9,4,0.972498560512744,-8.85273758710149,31,31,0,3
196869,4to9,4,9,0.91748377665666,-11.4078206525479,31,31,0,2
196884,9to14,9,14,5.72073076475422E-05,-18.593679815081,285,285,0,3
196900,14to9,14,9,0.997841759854063,-5.13076416031772,31,31,0,3
196915,9to4,9,4,0.972498560512744,-8.85273758710149,61,61,0,3
196930,4to3,4,3,0.08251622334334,-13.816460629608,185,185,0,2
196945,3to4,3,4,0.979247382023731,-4.3200135082935,30,30,0,3
196960,4to9,4,9,0.91748377665666,-11.4078206525479,60,60,0,2
196976,9to4,9,4,0.972498560512744,-8.85273758710149,31,31,0,3
196993,4to9,4,9,0.91748377665666,-11.4078206525479,33,33,0,2
197009,9to4,9,4,0.972498560512744,-8.85273758710149,33,33,0,3
197026,4to9,4,9,0.91748377665666,-11.4078206525479,33,33,0,2
197041,9to4,9,4,0.972498560512744,-8.85273758710149,32,32,0,3
197057,4to9,4,9,0.91748377665666,-11.4078206525479,31,31,0,2
197074,9to4,9,4,0.972498560512744,-8.85273758710149,33,33,0,3
197090,4to9,4,9,0.91748377665666,-11.4078206525479,33,33,0,2
197106,9to14,9,14,5.72073076475422E-05,-18.593679815081,222,222,0,3
197121,14to9,14,9,0.997841759854063,-5.13076416031772,31,31,0,3
197138,9to4,9,4,0.972498560512744,-8.85273758710149,64,64,0,3
197155,4to3,4,3,0.08251622334334,-13.816460629608,225,225,0,2
197172,3to4,3,4,0.979247382023731,-4.3200135082935,34,34,0,3
197188,4to9,4,9,0.91748377665666,-11.4078206525479,67,67,0,2
197205,9to8,9,8,0.027444232179608,-12.4204501574849,639,639,0,3
197220,8to9,8,9,0.770591357558781,-2.89449932615566,32,32,0,4
197235,9to4,9,4,0.972498560512744,-8.85273758710149,63,63,0,3
197252,4to3,4,3,0.08251622334334,-13.816460629608,97,97,0,2
197268,3to4,3,4,0.979247382023731,-4.3200135082935,33,33,0,3
197284,4to9,4,9,0.91748377665666,-11.4078206525479,64,64,0,2
197302,9to14,9,14,5.72073076475422E-05,-18.593679815081,196,196,0,3
197316,14to9,14,9,0.997841759854063,-5.13076416031772,32,32,0,3
197332,9to4,9,4,0.972498560512744,-8.85273758710149,64,64,0,3
197348,4to9,4,9,0.91748377665666,-11.4078206525479,32,32,0,2
197364,9to4,9,4,0.972498560512744,-8.85273758710149,32,32,0,3
197378,4to9,4,9,0.91748377665666,-11.4078206525479,30,30,0,2
197394,9to4,9,4,0.972498560512744,-8.85273758710149,30,30,0,3
197409,4to9,4,9,0.91748377665666,-11.4078206525479,31,31,0,2
197424,9to4,9,4,0.972498560512744,-8.85273758710149,30,30,0,3
197439,4to3,4,3,0.08251622334334,-13.816460629608,187,187,0,2
197455,3to4,3,4,0.979247382023731,-4.3200135082935,31,31,0,3
197472,4to9,4,9,0.91748377665666,-11.4078206525479,63,63,0,2
197488,9to4,9,4,0.972498560512744,-8.85273758710149,33,33,0,3
197503,4to9,4,9,0.91748377665666,-11.4078206525479,31,31,0,2
197519,9to4,9,4,0.972498560512744,-8.85273758710149,31,31,0,3
197534,4to9,4,9,0.91748377665666,-11.4078206525479,31,31,0,2
197551,9to4,9,4,0.972498560512744,-8.85273758710149,32,32,0,3
197568,4to9,4,9,0.91748377665666,-11.4078206525479,34,34,0,2
197584,9to4,9,4,0.972498560512744,-8.85273758710149,33,33,0,3
197598,4to9,4,9,0.91748377665666,-11.4078206525479,30,30,0,2
197612,9to4,9,4,0.972498560512744,-8.85273758710149,28,28,0,3
197627,4to3,4,3,0.08251622334334,-13.816460629608,188,188,0,2
197642,3to4,3,4,0.979247382023731,-4.3200135082935,30,30,0,3
197658,4to9,4,9,0.91748377665666,-11.4078206525479,60,60,0,2
197674,9to4,9,4,0.972498560512744,-8.85273758710149,32,32,0,3
197690,4to9,4,9,0.91748377665666,-11.4078206525479,32,32,0,2
197706,9to4,9,4,0.972498560512744,-8.85273758710149,32,32,0,3
197722,4to9,4,9,0.91748377665666,-11.4078206525479,32,32,0,2
197738,9to4,9,4,0.972498560512744,-8.85273758710149,32,32,0,3
197753,4to9,4,9,0.91748377665666,-11.4078206525479,31,31,0,2
197769,9to8,9,8,0.027444232179608,-12.4204501574849,564,564,0,3
197784,8to3,8,3,0.227468397873597,-4.11464622477799,157,157,0,4
197801,3to4,3,4,0.979247382023731,-4.3200135082935,63,63,0,3
197817,4to3,4,3,0.08251622334334,-13.816460629608,33,33,0,2
197833,3to4,3,4,0.979247382023731,-4.3200135082935,32,32,0,3
197848,4to9,4,9,0.91748377665666,-11.4078206525479,95,95,0,2
197864,9to4,9,4,0.972498560512744,-8.85273758710149,31,31,0,3
197880,4to9,4,9,0.91748377665666,-11.4078206525479,32,32,0,2
197895,9to4,9,4,0.972498560512744,-8.85273758710149,31,31,0,3
197911,4to9,4,9,0.91748377665666,-11.4078206525479,31,31,0,2
197925,9to4,9,4,0.972498560512744,-8.85273758710149,30,30,0,3
197942,4to9,4,9,0.91748377665666,-11.4078206525479,31,31,0,2
197957,9to4,9,4,0.972498560512744,-8.85273758710149,32,32,0,3
197972,4to9,4,9,0.91748377665666,-11.4078206525479,30,30,0,2
197988,9to4,9,4,0.972498560512744,-8.85273758710149,31,31,0,3
198003,4to9,4,9,0.91748377665666,-11.4078206525479,31,31,0,2
198019,9to4,9,4,0.972498560512744,-8.85273758710149,31,31,0,3
198035,4to3,4,3,0.08251622334334,-13.816460629608,218,218,0,2
198051,3to4,3,4,0.979247382023731,-4.3200135082935,32,32,0,3
198068,4to9,4,9,0.91748377665666,-11.4078206525479,65,65,0,2
198085,9to4,9,4,0.972498560512744,-8.85273758710149,34,34,0,3
198100,4to9,4,9,0.91748377665666,-11.4078206525479,32,32,0,2
198115,9to4,9,4,0.972498560512744,-8.85273758710149,30,30,0,3
198130,4to9,4,9,0.91748377665666,-11.4078206525479,30,30,0,2
198146,9to4,9,4,0.972498560512744,-8.85273758710149,31,31,0,3
198161,4to9,4,9,0.91748377665666,-11.4078206525479,31,31,0,2
198176,9to4,9,4,0.972498560512744,-8.85273758710149,30,30,0,3
198191,4to9,4,9,0.91748377665666,-11.4078206525479,30,30,0,2
198207,9to4,9,4,0.972498560512744,-8.85273758710149,31,31,0,3
198223,4to9,4,9,0.91748377665666,-11.4078206525479,32,32,0,2
198238,9to4,9,4,0.972498560512744,-8.85273758710149,31,31,0,3
198254,4to3,4,3,0.08251622334334,-13.816460629608,219,219,0,2
198269,3to4,3,4,0.979247382023731,-4.3200135082935,31,31,0,3
198285,4to9,4,9,0.91748377665666,-11.4078206525479,62,62,0,2
198303,9to4,9,4,0.972498560512744,-8.85273758710149,34,34,0,3
198319,4to9,4,9,0.91748377665666,-11.4078206525479,34,34,0,2
198335,9to4,9,4,0.972498560512744,-8.85273758710149,32,32,0,3
198350,4to9,4,9,0.91748377665666,-11.4078206525479,31,31,0,2
198368,9to8,9,8,0.027444232179608,-12.4204501574849,599,599,0,3
198385,8to3,8,3,0.227468397873597,-4.11464622477799,131,131,0,4
198401,3to4,3,4,0.979247382023731,-4.3200135082935,66,66,0,3
198418,4to9,4,9,0.91748377665666,-11.4078206525479,68,68,0,2
198434,9to4,9,4,0.972498560512744,-8.85273758710149,33,33,0,3
198449,4to9,4,9,0.91748377665666,-11.4078206525479,31,31,0,2
198464,9to4,9,4,0.972498560512744,-8.85273758710149,30,30,0,3
198478,4to9,4,9,0.91748377665666,-11.4078206525479,29,29,0,2
198493,9to4,9,4,0.972498560512744,-8.85273758710149,29,29,0,3
198508,4to9,4,9,0.91748377665666,-11.4078206525479,30,30,0,2
198525,9to4,9,4,0.972498560512744,-8.85273758710149,32,32,0,3
198541,4to3,4,3,0.08251622334334,-13.816460629608,156,156,0,2
198556,3to4,3,4,0.979247382023731,-4.3200135082935,31,31,0,3
198572,4to9,4,9,0.91748377665666,-11.4078206525479,64,64,0,2
198588,9to4,9,4,0.972498560512744,-8.85273758710149,32,32,0,3
198604,4to9,4,9,0.91748377665666,-11.4078206525479,32,32,0,2
198620,9to4,9,4,0.972498560512744,-8.85273758710149,32,32,0,3
198637,4to9,4,9,0.91748377665666,-11.4078206525479,33,33,0,2
198652,9to4,9,4,0.972498560512744,-8.85273758710149,32,32,0,3
198668,4to9,4,9,0.91748377665666,-11.4078206525479,31,31,0,2
198683,9to4,9,4,0.972498560512744,-8.85273758710149,31,31,0,3
198700,4to9,4,9,0.91748377665666,-11.4078206525479,32,32,0,2
198717,9to4,9,4,0.972498560512744,-8.85273758710149,34,34,0,3
198732,4to9,4,9,0.91748377665666,-11.4078206525479,32,32,0,2
198748,9to4,9,4,0.972498560512744,-8.85273758710149,31,31,0,3
198763,4to3,4,3,0.08251622334334,-13.816460629608,222,222,0,2
198777,3to4,3,4,0.979247382023731,-4.3200135082935,29,29,0,3
198794,4to3,4,3,0.08251622334334,-13.816460629608,31,31,0,2
198810,3to4,3,4,0.979247382023731,-4.3200135082935,33,33,0,3
198825,4to9,4,9,0.91748377665666,-11.4078206525479,93,93,0,2
198840,9to4,9,4,0.972498560512744,-8.85273758710149,30,30,0,3
198856,4to9,4,9,0.91748377665666,-11.4078206525479,31,31,0,2
198871,9to4,9,4,0.972498560512744,-8.85273758710149,31,31,0,3
198886,4to9,4,9,0.91748377665666,-11.4078206525479,30,30,0,2
198903,9to4,9,4,0.972498560512744,-8.85273758710149,32,32,0,3
198918,4to9,4,9,0.91748377665666,-11.4078206525479,32,32,0,2
198934,9to8,9,8,0.010455634824888,-13.4027823129619,566,10,556,3
198949,8to9,8,9,0.770591357558781,-2.89449932615566,31,31,0,4
198965,9to8,9,8,0.010455634824888,-13.4027823129619,31,31,0,3
198980,8to3,8,3,0.118406459364685,-4.89959246133713,186,40,146,4
198997,3to4,3,4,0.964460372484844,-4.8732049976552,94,42,52,3
199012,4to9,4,9,0.886897369345,-11.7570270017542,63,41,22,2
199027,9to4,9,4,0.989486158570615,-8.85273758710149,30,30,0,3
199042,4to9,4,9,0.886897369345,-11.7570270017542,30,30,0,2
199057,9to4,9,4,0.989486158570615,-8.85273758710149,30,30,0,3
199073,4to9,4,9,0.886897369345,-11.7570270017542,31,31,0,2
199089,9to14,9,14,2.26716051551087E-05,-19.5366009118913,1787,102,1685,3
199106,14to9,14,9,0.997841759854063,-5.13076416031772,33,33,0,3
199124,9to4,9,4,0.989521322007353,-8.85273758710149,67,67,0,3
199141,4to3,4,3,0.113102630654999,-13.816460629608,161,161,0,2
199159,3to8,3,8,0.034373500004575,-8.20748782428216,194,194,0,3
199176,8to9,8,9,0.879379382569342,-2.89449932615566,70,70,0,4
199192,9to4,9,4,0.989521322007353,-8.85273758710149,68,68,0,3
199208,4to9,4,9,0.886897369345,-11.7570270017542,32,32,0,2
199223,9to4,9,4,0.989521322007353,-8.85273758710149,31,31,0,3
199239,4to9,4,9,0.886897369345,-11.7570270017542,31,31,0,2
199256,9to8,9,8,0.010456006387492,-13.4027823129619,97,97,0,3
199271,8to9,8,9,0.879379382569342,-2.89449932615566,32,32,0,4
199288,9to4,9,4,0.989521322007353,-8.85273758710149,65,65,0,3
199304,4to3,4,3,0.113102630654999,-13.816460629608,163,163,0,2
199319,3to4,3,4,0.964460372484844,-4.8732049976552,31,31,0,3
199334,4to9,4,9,0.886897369345,-11.7570270017542,63,63,0,2
199349,9to4,9,4,0.989521322007353,-8.85273758710149,30,30,0,3
199365,4to9,4,9,0.886897369345,-11.7570270017542,31,31,0,2
199380,9to4,9,4,0.989521322007353,-8.85273758710149,31,31,0,3
199396,4to9,4,9,0.886897369345,-11.7570270017542,31,31,0,2
199411,9to4,9,4,0.989521322007353,-8.85273758710149,31,31,0,3
199427,4to9,4,9,0.886897369345,-11.7570270017542,31,31,0,2
199443,9to4,9,4,0.989521322007353,-8.85273758710149,32,32,0,3
199459,4to3,4,3,0.113102630654999,-13.816460629608,155,155,0,2
199476,3to4,3,4,0.964460372484844,-4.8732049976552,33,33,0,3
199492,4to3,4,3,0.113102630654999,-13.816460629608,33,33,0,2
199508,3to4,3,4,0.964460372484844,-4.8732049976552,32,32,0,3
199525,4to9,4,9,0.886897369345,-11.7570270017542,98,98,0,2
199542,9to4,9,4,0.989521322007353,-8.85273758710149,34,34,0,3
199559,4to9,4,9,0.886897369345,-11.7570270017542,34,34,0,2
199574,9to4,9,4,0.989521322007353,-8.85273758710149,32,32,0,3
199591,4to9,4,9,0.886897369345,-11.7570270017542,32,32,0,2
199607,9to4,9,4,0.989521322007353,-8.85273758710149,33,33,0,3
199623,4to9,4,9,0.886897369345,-11.7570270017542,32,32,0,2
199640,9to4,9,4,0.989521322007353,-8.85273758710149,33,33,0,3
199656,4to3,4,3,0.113102630654999,-13.816460629608,164,164,0,2
199670,3to8,3,8,0.034373500004575,-8.20748782428216,414,414,0,3
199686,8to9,8,9,0.879379382569342,-2.89449932615566,63,63,0,4
199702,9to4,9,4,0.989521322007353,-8.85273758710149,62,62,0,3
199717,4to9,4,9,0.886897369345,-11.7570270017542,31,31,0,2
199733,9to4,9,4,0.989521322007353,-8.85273758710149,31,31,0,3
199748,4to9,4,9,0.886897369345,-11.7570270017542,31,31,0,2
199764,9to4,9,4,0.989521322007353,-8.85273758710149,31,31,0,3
199778,4to9,4,9,0.886897369345,-11.7570270017542,30,30,0,2
199794,9to8,9,8,0.010456006387492,-13.4027823129619,124,124,0,3
199810,8to3,8,3,0.118406459364685,-4.89959246133713,154,154,0,4
199826,3to4,3,4,0.964460372484844,-4.8732049976552,62,62,0,3
199842,4to9,4,9,0.886897369345,-11.7570270017542,64,64,0,2
199857,9to4,9,4,0.989521322007353,-8.85273758710149,31,31,0,3
199871,4to9,4,9,0.886897369345,-11.7570270017542,29,29,0,2
199888,9to4,9,4,0.989521322007353,-8.85273758710149,31,31,0,3
199903,4to9,4,9,0.886897369345,-11.7570270017542,32,32,0,2
199920,9to8,9,8,0.010456006387492,-13.4027823129619,126,126,0,3
199937,8to9,8,9,0.879379382569342,-2.89449932615566,34,34,0,4
199953,9to4,9,4,0.989521322007353,-8.85273758710149,65,65,0,3
199969,4to3,4,3,0.113102630654999,-13.816460629608,159,159,0,2
199985,3to4,3,4,0.964460372484844,-4.8732049976552,32,32,0,3
200002,4to9,4,9,0.886897369345,-11.7570270017542,65,65,0,2
